ano,idmun,municipality,province,inmigrations,emigrations,net_migration
1988,01036,Laudio/Llodio,Álava,130,312,-182
1988,01059,Vitoria-Gasteiz,Álava,2268,1751,517
1988,02003,Albacete,Albacete,1090,1227,-137
1988,02009,Almansa,Albacete,261,188,73
1988,02037,Hellín,Albacete,193,339,-146
1988,02069,La Roda,Albacete,75,91,-16
1988,02081,Villarrobledo,Albacete,104,191,-87
1988,03009,Alcoy/Alcoi,Alicante,243,359,-116
1988,03014,Alicante/Alacant,Alicante,2953,1768,1185
1988,03015,Almoradí,Alicante,92,62,30
1988,03018,Altea,Alicante,143,56,87
1988,03019,Aspe,Alicante,32,55,-23
1988,03031,Benidorm,Alicante,1327,466,861
1988,03047,Calp,Alicante,245,106,139
1988,03049,Callosa de Segura,Alicante,54,56,-2
1988,03050,El Campello,Alicante,141,89,52
1988,03056,Cocentaina,Alicante,63,50,13
1988,03059,Crevillent,Alicante,93,53,40
1988,03063,Dénia,Alicante,426,221,205
1988,03065,Elche/Elx,Alicante,853,588,265
1988,03066,Elda,Alicante,211,177,34
1988,03079,Ibi,Alicante,123,102,21
1988,03082,Jávea/Xàbia,Alicante,245,95,150
1988,03089,Monóvar/Monòver,Alicante,21,18,3
1988,03093,Novelda,Alicante,85,87,-2
1988,03099,Orihuela,Alicante,133,364,-231
1988,03104,Petrer,Alicante,74,76,-2
1988,03119,Sant Joan d'Alacant,Alicante,178,88,90
1988,03121,Santa Pola,Alicante,285,55,230
1988,03122,San Vicente del Raspeig/Sant Vicent del Raspeig,Alicante,194,145,49
1988,03133,Torrevieja,Alicante,981,203,778
1988,03139,Villajoyosa/La Vila Joiosa,Alicante,258,181,77
1988,03140,Villena,Alicante,129,134,-5
1988,04003,Adra,Almería,169,178,-9
1988,04006,Albox,Almería,27,61,-34
1988,04013,Almería,Almería,1254,1256,-2
1988,04029,Berja,Almería,93,58,35
1988,04053,Huércal-Overa,Almería,136,137,-1
1988,04066,Níjar,Almería,78,57,21
1988,04079,Roquetas de Mar,Almería,761,276,485
1988,04102,Vícar,Almería,239,84,155
1988,04902,El Ejido,Almería,626,254,372
1988,05019,Ávila,Ávila,523,528,-5
1988,06011,Almendralejo,Badajoz,130,306,-176
1988,06014,Azuaga,Badajoz,37,90,-53
1988,06015,Badajoz,Badajoz,829,1368,-539
1988,06044,Don Benito,Badajoz,233,271,-38
1988,06083,Mérida,Badajoz,502,618,-116
1988,06088,Montijo,Badajoz,108,120,-12
1988,06095,Olivenza,Badajoz,57,120,-63
1988,06149,Villafranca de los Barros,Badajoz,54,80,-26
1988,06153,Villanueva de la Serena,Badajoz,106,269,-163
1988,06158,Zafra,Badajoz,106,136,-30
1988,07011,Calvià,Baleares,950,297,653
1988,07015,Ciutadella de Menorca,Baleares,469,174,295
1988,07022,Felanitx,Baleares,344,48,296
1988,07026,Eivissa,Baleares,1202,572,630
1988,07027,Inca,Baleares,111,37,74
1988,07031,Llucmajor,Baleares,302,143,159
1988,07032,Maó-Mahón,Baleares,671,307,364
1988,07033,Manacor,Baleares,672,165,507
1988,07036,Marratxí,Baleares,77,33,44
1988,07040,Palma,Baleares,5676,2495,3181
1988,07042,Pollença,Baleares,240,87,153
1988,07044,Sa Pobla,Baleares,90,36,54
1988,07046,Sant Antoni de Portmany,Baleares,521,264,257
1988,07054,Santa Eulària des Riu,Baleares,565,227,338
1988,07061,Sóller,Baleares,53,38,15
1988,08006,Arenys de Mar,Barcelona,73,56,17
1988,08015,Badalona,Barcelona,1042,1114,-72
1988,08019,Barcelona,Barcelona,5477,9544,-4067
1988,08022,Berga,Barcelona,69,94,-25
1988,08033,Caldes de Montbui,Barcelona,41,36,5
1988,08035,Calella,Barcelona,139,91,48
1988,08041,Canovelles,Barcelona,107,47,60
1988,08051,Castellar del Vallès,Barcelona,65,37,28
1988,08056,Castelldefels,Barcelona,390,278,112
1988,08073,Cornellà de Llobregat,Barcelona,407,558,-151
1988,08076,Esparreguera,Barcelona,78,48,30
1988,08077,Esplugues de Llobregat,Barcelona,230,298,-68
1988,08089,Gavà,Barcelona,427,253,174
1988,08096,Granollers,Barcelona,318,228,90
1988,08101,L'Hospitalet de Llobregat,Barcelona,1093,1605,-512
1988,08102,Igualada,Barcelona,122,125,-3
1988,08105,La Llagosta,Barcelona,81,73,8
1988,08110,Malgrat de Mar,Barcelona,99,55,44
1988,08112,Manlleu,Barcelona,107,43,64
1988,08113,Manresa,Barcelona,201,284,-83
1988,08114,Martorell,Barcelona,78,136,-58
1988,08118,El Masnou,Barcelona,119,82,37
1988,08121,Mataró,Barcelona,492,423,69
1988,08123,Molins de Rei,Barcelona,45,103,-58
1988,08124,Mollet del Vallès,Barcelona,266,232,34
1988,08125,Montcada i Reixac,Barcelona,144,126,18
1988,08136,Montornès del Vallès,Barcelona,54,49,5
1988,08147,Olesa de Montserrat,Barcelona,70,86,-16
1988,08159,Parets del Vallès,Barcelona,77,40,37
1988,08163,Pineda de Mar,Barcelona,185,128,57
1988,08169,El Prat de Llobregat,Barcelona,382,557,-175
1988,08172,Premià de Mar,Barcelona,186,168,18
1988,08180,Ripollet,Barcelona,230,162,68
1988,08184,Rubí,Barcelona,370,323,47
1988,08187,Sabadell,Barcelona,749,790,-41
1988,08194,Sant Adrià de Besòs,Barcelona,141,206,-65
1988,08196,Sant Andreu de la Barca,Barcelona,99,123,-24
1988,08200,Sant Boi de Llobregat,Barcelona,317,470,-153
1988,08202,Sant Celoni,Barcelona,66,52,14
1988,08205,Sant Cugat del Vallès,Barcelona,266,252,14
1988,08211,Sant Feliu de Llobregat,Barcelona,153,222,-69
1988,08217,Sant Joan Despí,Barcelona,150,166,-16
1988,08219,Vilassar de Mar,Barcelona,64,69,-5
1988,08221,Sant Just Desvern,Barcelona,43,62,-19
1988,08231,Sant Pere de Ribes,Barcelona,136,50,86
1988,08245,Santa Coloma de Gramenet,Barcelona,666,855,-189
1988,08252,Barberà del Vallès,Barcelona,200,242,-42
1988,08260,Santa Perpètua de Mogoda,Barcelona,104,82,22
1988,08263,Sant Vicenç dels Horts,Barcelona,81,110,-29
1988,08266,Cerdanyola del Vallès,Barcelona,297,402,-105
1988,08270,Sitges,Barcelona,103,53,50
1988,08279,Terrassa,Barcelona,446,673,-227
1988,08285,Torelló,Barcelona,42,39,3
1988,08298,Vic,Barcelona,139,98,41
1988,08301,Viladecans,Barcelona,319,331,-12
1988,08305,Vilafranca del Penedès,Barcelona,141,177,-36
1988,08307,Vilanova i la Geltrú,Barcelona,244,315,-71
1988,09018,Aranda de Duero,Burgos,227,304,-77
1988,09059,Burgos,Burgos,1034,1411,-377
1988,09219,Miranda de Ebro,Burgos,363,496,-133
1988,10037,Cáceres,Cáceres,646,723,-77
1988,10067,Coria,Cáceres,92,169,-77
1988,10131,Navalmoral de la Mata,Cáceres,261,228,33
1988,10148,Plasencia,Cáceres,333,394,-61
1988,11004,Algeciras,Cádiz,951,868,83
1988,11006,Arcos de la Frontera,Cádiz,71,228,-157
1988,11007,Barbate,Cádiz,173,283,-110
1988,11008,Los Barrios,Cádiz,106,74,32
1988,11012,Cádiz,Cádiz,801,1102,-301
1988,11014,Conil de la Frontera,Cádiz,44,41,3
1988,11015,Chiclana de la Frontera,Cádiz,231,179,52
1988,11016,Chipiona,Cádiz,112,66,46
1988,11020,Jerez de la Frontera,Cádiz,857,1569,-712
1988,11022,La Línea de la Concepción,Cádiz,330,469,-139
1988,11023,Medina-Sidonia,Cádiz,70,106,-36
1988,11027,El Puerto de Santa María,Cádiz,663,500,163
1988,11028,Puerto Real,Cádiz,127,110,17
1988,11030,Rota,Cádiz,113,148,-35
1988,11031,San Fernando,Cádiz,550,752,-202
1988,11032,Sanlúcar de Barrameda,Cádiz,251,250,1
1988,11033,San Roque,Cádiz,157,211,-54
1988,11035,Tarifa,Cádiz,127,154,-27
1988,11038,Ubrique,Cádiz,64,86,-22
1988,11039,Vejer de la Frontera,Cádiz,34,84,-50
1988,11041,Villamartín,Cádiz,50,90,-40
1988,12009,Almassora,Castellón,54,54,0
1988,12027,Benicarló,Castellón,204,132,72
1988,12032,Borriana/Burriana,Castellón,144,116,28
1988,12040,Castellón de la Plana/Castelló de la Plana,Castellón,1673,770,903
1988,12082,Nules,Castellón,67,32,35
1988,12084,Onda,Castellón,69,38,31
1988,12126,La Vall d'Uixó,Castellón,148,94,54
1988,12135,Vila-real,Castellón,244,121,123
1988,12138,Vinaròs,Castellón,292,147,145
1988,13005,Alcázar de San Juan,Ciudad Real,234,345,-111
1988,13023,Bolaños de Calatrava,Ciudad Real,26,21,5
1988,13028,Campo de Criptana,Ciudad Real,80,80,0
1988,13034,Ciudad Real,Ciudad Real,644,649,-5
1988,13039,Daimiel,Ciudad Real,54,170,-116
1988,13053,Manzanares,Ciudad Real,222,227,-5
1988,13071,Puertollano,Ciudad Real,484,799,-315
1988,13078,Socuéllamos,Ciudad Real,84,161,-77
1988,13079,La Solana,Ciudad Real,26,63,-37
1988,13082,Tomelloso,Ciudad Real,148,181,-33
1988,13087,Valdepeñas,Ciudad Real,182,243,-61
1988,14002,Aguilar de la Frontera,Córdoba,39,81,-42
1988,14007,Baena,Córdoba,102,163,-61
1988,14013,Cabra,Córdoba,124,199,-75
1988,14021,Córdoba,Córdoba,2048,2727,-679
1988,14038,Lucena,Córdoba,237,205,32
1988,14042,Montilla,Córdoba,119,220,-101
1988,14049,Palma del Río,Córdoba,129,231,-102
1988,14052,Peñarroya-Pueblonuevo,Córdoba,95,137,-42
1988,14054,Pozoblanco,Córdoba,101,118,-17
1988,14055,Priego de Córdoba,Córdoba,161,210,-49
1988,14056,Puente Genil,Córdoba,184,284,-100
1988,14058,Rute,Córdoba,115,135,-20
1988,14069,Villanueva de Córdoba,Córdoba,120,77,43
1988,15005,Arteixo,A Coruña,73,82,-9
1988,15009,Betanzos,A Coruña,44,36,8
1988,15011,Boiro,A Coruña,50,98,-48
1988,15017,Cambre,A Coruña,108,56,52
1988,15019,Carballo,A Coruña,46,81,-35
1988,15029,Coristanco,A Coruña,19,41,-22
1988,15030,A Coruña,A Coruña,1793,1491,302
1988,15031,Culleredo,A Coruña,47,46,1
1988,15035,Fene,A Coruña,33,127,-94
1988,15036,Ferrol,A Coruña,422,934,-512
1988,15041,A Laracha,A Coruña,18,25,-7
1988,15053,Muros,A Coruña,13,91,-78
1988,15054,Narón,A Coruña,132,283,-151
1988,15057,Noia,A Coruña,49,74,-25
1988,15058,Oleiros,A Coruña,172,86,86
1988,15059,Ordes,A Coruña,29,51,-22
1988,15061,Ortigueira,A Coruña,22,57,-35
1988,15062,Outes,A Coruña,7,25,-18
1988,15065,Padrón,A Coruña,43,68,-25
1988,15067,A Pobra do Caramiñal,A Coruña,28,36,-8
1988,15070,As Pontes de García Rodríguez,A Coruña,105,133,-28
1988,15071,Porto do Son,A Coruña,22,57,-35
1988,15072,Rianxo,A Coruña,13,87,-74
1988,15073,Ribeira,A Coruña,126,101,25
1988,15077,Santa Comba,A Coruña,13,26,-13
1988,15078,Santiago de Compostela,A Coruña,681,644,37
1988,15082,Teo,A Coruña,85,41,44
1988,16078,Cuenca,Cuenca,458,493,-35
1988,16203,Tarancón,Cuenca,137,118,19
1988,17015,Banyoles,Girona,151,61,90
1988,17023,Blanes,Girona,596,273,323
1988,17066,Figueres,Girona,627,306,321
1988,17079,Girona,Girona,807,544,263
1988,17095,Lloret de Mar,Girona,685,325,360
1988,17114,Olot,Girona,293,154,139
1988,17117,Palafrugell,Girona,320,170,150
1988,17118,Palamós,Girona,159,77,82
1988,17147,Ripoll,Girona,102,158,-56
1988,17152,Roses,Girona,324,123,201
1988,17155,Salt,Girona,268,129,139
1988,17160,Sant Feliu de Guíxols,Girona,315,99,216
1988,18017,Almuñécar,Granada,129,137,-8
1988,18021,Armilla,Granada,76,74,2
1988,18023,Baza,Granada,130,270,-140
1988,18087,Granada,Granada,3024,2256,768
1988,18089,Guadix,Granada,162,274,-112
1988,18098,Huéscar,Granada,117,163,-46
1988,18102,Illora,Granada,94,70,24
1988,18122,Loja,Granada,160,139,21
1988,18127,Maracena,Granada,103,87,16
1988,18140,Motril,Granada,427,353,74
1988,18158,Pinos Puente,Granada,110,77,33
1988,18175,Santa Fe,Granada,86,81,5
1988,19046,Azuqueca de Henares,Guadalajara,202,179,23
1988,19130,Guadalajara,Guadalajara,815,938,-123
1988,20009,Andoain,Guipúzcoa,59,212,-153
1988,20017,Azkoitia,Guipúzcoa,19,57,-38
1988,20018,Azpeitia,Guipúzcoa,33,55,-22
1988,20019,Beasain,Guipúzcoa,44,96,-52
1988,20030,Eibar,Guipúzcoa,142,526,-384
1988,20032,Elgoibar,Guipúzcoa,35,121,-86
1988,20036,Hondarribia,Guipúzcoa,57,79,-22
1988,20040,Hernani,Guipúzcoa,40,222,-182
1988,20045,Irun,Guipúzcoa,328,633,-305
1988,20051,Legazpi,Guipúzcoa,29,118,-89
1988,20055,Arrasate/Mondragón,Guipúzcoa,127,309,-182
1988,20059,Oñati,Guipúzcoa,20,73,-53
1988,20064,Pasaia,Guipúzcoa,55,208,-153
1988,20067,Errenteria,Guipúzcoa,137,653,-516
1988,20069,Donostia/San Sebastián,Guipúzcoa,775,1863,-1088
1988,20071,Tolosa,Guipúzcoa,71,123,-52
1988,20074,Bergara,Guipúzcoa,46,110,-64
1988,20079,Zarautz,Guipúzcoa,75,143,-68
1988,20080,Zumarraga,Guipúzcoa,46,143,-97
1988,20902,Lasarte-Oria,Guipúzcoa,55,307,-252
1988,21005,Almonte,Huelva,339,87,252
1988,21010,Ayamonte,Huelva,156,116,40
1988,21013,Bollullos Par del Condado,Huelva,34,32,2
1988,21021,Cartaya,Huelva,119,72,47
1988,21041,Huelva,Huelva,720,844,-124
1988,21042,Isla Cristina,Huelva,151,84,67
1988,21044,Lepe,Huelva,135,65,70
1988,21050,Moguer,Huelva,144,58,86
1988,21072,Valverde del Camino,Huelva,46,40,6
1988,22048,Barbastro,Huesca,83,138,-55
1988,22112,Fraga,Huesca,140,127,13
1988,22125,Huesca,Huesca,443,469,-26
1988,22130,Jaca,Huesca,133,146,-13
1988,22158,Monzón,Huesca,126,116,10
1988,23002,Alcalá la Real,Jaén,218,298,-80
1988,23003,Alcaudete,Jaén,76,190,-114
1988,23005,Andújar,Jaén,238,468,-230
1988,23009,Baeza,Jaén,73,70,3
1988,23010,Bailén,Jaén,57,143,-86
1988,23024,La Carolina,Jaén,61,190,-129
1988,23050,Jaén,Jaén,514,829,-315
1988,23053,Jódar,Jaén,125,195,-70
1988,23055,Linares,Jaén,456,818,-362
1988,23060,Martos,Jaén,135,142,-7
1988,23086,Torredelcampo,Jaén,63,46,17
1988,23087,Torredonjimeno,Jaén,68,67,1
1988,23092,Úbeda,Jaén,240,317,-77
1988,23095,Villacarrillo,Jaén,115,153,-38
1988,24008,Astorga,León,100,169,-69
1988,24014,Bembibre,León,94,188,-94
1988,24089,León,León,902,1546,-644
1988,24115,Ponferrada,León,465,621,-156
1988,24142,San Andrés del Rabanedo,León,166,149,17
1988,24202,Villablino,León,81,153,-72
1988,25040,Balaguer,Lleida,92,79,13
1988,25120,Lleida,Lleida,865,1066,-201
1988,25203,La Seu d'Urgell,Lleida,262,140,122
1988,25217,Tàrrega,Lleida,112,109,3
1988,26018,Arnedo,La Rioja,36,58,-22
1988,26036,Calahorra,La Rioja,136,158,-22
1988,26089,Logroño,La Rioja,1641,1239,402
1988,27013,Cervo,Lugo,127,106,21
1988,27016,Chantada,Lugo,58,80,-22
1988,27028,Lugo,Lugo,529,461,68
1988,27031,Monforte de Lemos,Lugo,135,196,-61
1988,27057,Sarria,Lugo,63,58,5
1988,27065,Vilalba,Lugo,75,92,-17
1988,27066,Viveiro,Lugo,79,124,-45
1988,28005,Alcalá de Henares,Madrid,1683,1271,412
1988,28006,Alcobendas,Madrid,513,353,160
1988,28007,Alcorcón,Madrid,996,814,182
1988,28013,Aranjuez,Madrid,342,292,50
1988,28014,Arganda del Rey,Madrid,168,114,54
1988,28022,Boadilla del Monte,Madrid,106,53,53
1988,28040,Ciempozuelos,Madrid,73,46,27
1988,28045,Colmenar Viejo,Madrid,687,257,430
1988,28047,Collado Villalba,Madrid,532,193,339
1988,28049,Coslada,Madrid,388,384,4
1988,28058,Fuenlabrada,Madrid,2325,851,1474
1988,28065,Getafe,Madrid,1008,750,258
1988,28074,Leganés,Madrid,776,770,6
1988,28079,Madrid,Madrid,19786,17961,1825
1988,28080,Majadahonda,Madrid,532,274,258
1988,28084,Mejorada del Campo,Madrid,108,68,40
1988,28092,Móstoles,Madrid,1625,1388,237
1988,28106,Parla,Madrid,584,407,177
1988,28113,Pinto,Madrid,175,106,69
1988,28115,Pozuelo de Alarcón,Madrid,281,216,65
1988,28127,Las Rozas de Madrid,Madrid,716,213,503
1988,28130,San Fernando de Henares,Madrid,116,181,-65
1988,28134,San Sebastián de los Reyes,Madrid,335,305,30
1988,28148,Torrejón de Ardoz,Madrid,649,532,117
1988,28161,Valdemoro,Madrid,668,273,395
1988,28181,Villaviciosa de Odón,Madrid,93,52,41
1988,29007,Alhaurín de la Torre,Málaga,107,25,82
1988,29008,Alhaurín el Grande,Málaga,19,35,-16
1988,29012,Álora,Málaga,58,32,26
1988,29015,Antequera,Málaga,169,219,-50
1988,29017,Archidona,Málaga,57,70,-13
1988,29025,Benalmádena,Málaga,357,110,247
1988,29038,Cártama,Málaga,37,18,19
1988,29042,Coín,Málaga,59,42,17
1988,29051,Estepona,Málaga,649,210,439
1988,29054,Fuengirola,Málaga,875,302,573
1988,29067,Málaga,Málaga,3399,2331,1068
1988,29069,Marbella,Málaga,1476,553,923
1988,29070,Mijas,Málaga,245,78,167
1988,29075,Nerja,Málaga,134,55,79
1988,29082,Rincón de la Victoria,Málaga,212,34,178
1988,29084,Ronda,Málaga,211,384,-173
1988,29091,Torrox,Málaga,52,26,26
1988,29094,Vélez-Málaga,Málaga,474,237,237
1988,30002,Abarán,Murcia,14,35,-21
1988,30003,Águilas,Murcia,406,234,172
1988,30005,Alcantarilla,Murcia,193,128,65
1988,30008,Alhama de Murcia,Murcia,58,46,12
1988,30009,Archena,Murcia,56,62,-6
1988,30012,Bullas,Murcia,20,18,2
1988,30015,Caravaca de la Cruz,Murcia,82,123,-41
1988,30016,Cartagena,Murcia,1197,1345,-148
1988,30017,Cehegín,Murcia,54,68,-14
1988,30019,Cieza (Murcia),Murcia,78,98,-20
1988,30022,Jumilla,Murcia,109,136,-27
1988,30024,Lorca,Murcia,379,376,3
1988,30026,Mazarrón,Murcia,144,150,-6
1988,30027,Molina de Segura,Murcia,284,156,128
1988,30028,Moratalla,Murcia,47,57,-10
1988,30029,Mula,Murcia,35,28,7
1988,30030,Murcia,Murcia,1456,1338,118
1988,30035,San Javier,Murcia,376,258,118
1988,30036,San Pedro del Pinatar,Murcia,378,156,222
1988,30037,Torre-Pacheco,Murcia,160,69,91
1988,30038,Las Torres de Cotillas,Murcia,103,63,40
1988,30039,Totana,Murcia,72,49,23
1988,30041,La Unión,Murcia,79,62,17
1988,30043,Yecla,Murcia,158,159,-1
1988,31016,Ansoáin/Antsoain,Navarra,51,60,-9
1988,31060,Burlada/Burlata,Navarra,97,65,32
1988,31097,Estella-Lizarra,Navarra,74,81,-7
1988,31201,Pamplona/Iruña,Navarra,1447,1049,398
1988,31227,Tafalla,Navarra,35,64,-29
1988,31232,Tudela,Navarra,241,235,6
1988,31901,Barañain,Navarra,158,137,21
1988,32009,O Barco de Valdeorras,Ourense,118,82,36
1988,32019,O Carballiño,Ourense,49,90,-41
1988,32032,Xinzo de Limia,Ourense,38,60,-22
1988,32054,Ourense,Ourense,575,814,-239
1988,32085,Verín,Ourense,107,119,-12
1988,33002,Aller,Asturias,27,56,-29
1988,33004,Avilés,Asturias,283,487,-204
1988,33011,Cangas del Narcea,Asturias,61,87,-26
1988,33014,Carreño,Asturias,20,32,-12
1988,33016,Castrillón,Asturias,59,86,-27
1988,33020,Corvera de Asturias,Asturias,37,63,-26
1988,33024,Gijón,Asturias,1217,1342,-125
1988,33025,Gozón,Asturias,13,24,-11
1988,33026,Grado,Asturias,23,18,5
1988,33031,Langreo,Asturias,95,263,-168
1988,33032,Laviana,Asturias,22,16,6
1988,33033,Lena,Asturias,38,76,-38
1988,33034,Valdés,Asturias,36,80,-44
1988,33035,Llanera,Asturias,30,32,-2
1988,33036,Llanes,Asturias,59,80,-21
1988,33037,Mieres (Asturias),Asturias,55,222,-167
1988,33044,Oviedo,Asturias,1032,1159,-127
1988,33049,Piloña,Asturias,6,17,-11
1988,33051,Pravia,Asturias,14,41,-27
1988,33060,San Martín del Rey Aurelio,Asturias,27,90,-63
1988,33066,Siero,Asturias,139,80,59
1988,33073,Tineo,Asturias,24,26,-2
1988,33076,Villaviciosa,Asturias,39,25,14
1988,34120,Palencia,Palencia,717,836,-119
1988,35002,Agüimes,Las Palmas,114,60,54
1988,35004,Arrecife,Las Palmas,1512,744,768
1988,35006,Arucas,Las Palmas,72,44,28
1988,35009,Gáldar,Las Palmas,27,10,17
1988,35011,Ingenio,Las Palmas,50,24,26
1988,35016,Las Palmas de Gran Canaria,Las Palmas,4146,2626,1520
1988,35017,Puerto del Rosario,Las Palmas,764,240,524
1988,35019,San Bartolomé de Tirajana,Las Palmas,651,227,424
1988,35021,Santa Brígida,Las Palmas,59,28,31
1988,35022,Santa Lucía de Tirajana,Las Palmas,232,73,159
1988,35023,Santa María de Guía de Gran Canaria,Las Palmas,27,19,8
1988,35026,Telde,Las Palmas,318,196,122
1988,35027,Teror,Las Palmas,16,9,7
1988,36003,Baiona,Pontevedra,28,31,-3
1988,36004,Bueu,Pontevedra,29,29,0
1988,36006,Cambados,Pontevedra,38,71,-33
1988,36008,Cangas,Pontevedra,58,63,-5
1988,36017,A Estrada,Pontevedra,54,102,-48
1988,36021,Gondomar,Pontevedra,27,25,2
1988,36022,O Grove,Pontevedra,35,78,-43
1988,36023,A Guarda,Pontevedra,32,27,5
1988,36024,Lalín,Pontevedra,97,81,16
1988,36026,Marín,Pontevedra,117,160,-43
1988,36029,Moaña,Pontevedra,32,43,-11
1988,36033,Mos,Pontevedra,10,63,-53
1988,36035,Nigrán,Pontevedra,33,35,-2
1988,36038,Pontevedra,Pontevedra,543,538,5
1988,36039,O Porriño,Pontevedra,46,85,-39
1988,36041,Poio,Pontevedra,81,85,-4
1988,36042,Ponteareas,Pontevedra,74,165,-91
1988,36045,Redondela,Pontevedra,73,132,-59
1988,36051,Sanxenxo,Pontevedra,46,36,10
1988,36052,Silleda,Pontevedra,34,42,-8
1988,36054,Tomiño,Pontevedra,23,55,-32
1988,36055,Tui,Pontevedra,59,200,-141
1988,36057,Vigo,Pontevedra,1658,1583,75
1988,36060,Vilagarcía de Arousa,Pontevedra,228,240,-12
1988,36061,Vilanova de Arousa,Pontevedra,32,97,-65
1988,37046,Béjar,Salamanca,89,176,-87
1988,37107,Ciudad Rodrigo,Salamanca,111,173,-62
1988,37274,Salamanca,Salamanca,1526,1902,-376
1988,38006,Arona,Santa Cruz de Tenerife,1350,279,1071
1988,38017,Granadilla de Abona,Santa Cruz de Tenerife,525,216,309
1988,38019,Guía de Isora,Santa Cruz de Tenerife,201,63,138
1988,38020,Güímar,Santa Cruz de Tenerife,71,29,42
1988,38022,Icod de los Vinos,Santa Cruz de Tenerife,47,17,30
1988,38023,San Cristóbal de La Laguna,Santa Cruz de Tenerife,432,370,62
1988,38024,Los Llanos de Aridane,Santa Cruz de Tenerife,103,82,21
1988,38026,La Orotava,Santa Cruz de Tenerife,76,49,27
1988,38028,Puerto de la Cruz,Santa Cruz de Tenerife,237,124,113
1988,38031,Los Realejos,Santa Cruz de Tenerife,56,61,-5
1988,38037,Santa Cruz de la Palma,Santa Cruz de Tenerife,246,175,71
1988,38038,Santa Cruz de Tenerife,Santa Cruz de Tenerife,2203,1481,722
1988,38043,Tacoronte,Santa Cruz de Tenerife,36,27,9
1988,39008,El Astillero,Cantabria,49,49,0
1988,39016,Camargo,Cantabria,88,49,39
1988,39020,Castro-Urdiales,Cantabria,213,133,80
1988,39035,Laredo,Cantabria,97,123,-26
1988,39059,Reinosa,Cantabria,47,146,-99
1988,39075,Santander,Cantabria,1176,1159,17
1988,39079,Santoña,Cantabria,51,94,-43
1988,39087,Torrelavega,Cantabria,117,283,-166
1988,40194,Segovia,Segovia,580,468,112
1988,41004,Alcalá de Guadaíra,Sevilla,222,204,18
1988,41007,La Algaba,Sevilla,19,20,-1
1988,41011,Arahal,Sevilla,42,48,-6
1988,41018,Brenes,Sevilla,40,45,-5
1988,41020,Las Cabezas de San Juan,Sevilla,105,107,-2
1988,41021,Camas,Sevilla,128,83,45
1988,41024,Carmona,Sevilla,94,115,-21
1988,41029,Castilleja de la Cuesta,Sevilla,128,90,38
1988,41034,Coria del Río,Sevilla,69,98,-29
1988,41038,Dos Hermanas,Sevilla,809,391,418
1988,41039,Écija,Sevilla,236,219,17
1988,41041,Estepa,Sevilla,80,43,37
1988,41053,Lebrija,Sevilla,197,152,45
1988,41055,Lora del Río,Sevilla,93,140,-47
1988,41058,Mairena del Alcor,Sevilla,23,29,-6
1988,41059,Mairena del Aljarafe,Sevilla,294,94,200
1988,41060,Marchena,Sevilla,80,74,6
1988,41065,Morón de la Frontera,Sevilla,189,437,-248
1988,41068,Osuna,Sevilla,73,100,-27
1988,41069,Los Palacios y Villafranca,Sevilla,99,45,54
1988,41075,Pilas,Sevilla,35,21,14
1988,41077,La Puebla de Cazalla,Sevilla,99,165,-66
1988,41079,La Puebla del Río,Sevilla,59,71,-12
1988,41081,La Rinconada,Sevilla,104,106,-2
1988,41086,San Juan de Aznalfarache,Sevilla,148,141,7
1988,41091,Sevilla,Sevilla,3978,3292,686
1988,41093,Tomares,Sevilla,194,81,113
1988,41095,Utrera,Sevilla,222,217,5
1988,41102,El Viso del Alcor,Sevilla,26,16,10
1988,42173,Soria,Soria,364,456,-92
1988,43014,Amposta,Tarragona,87,99,-12
1988,43038,Cambrils,Tarragona,361,321,40
1988,43123,Reus,Tarragona,1074,627,447
1988,43136,Sant Carles de la Ràpita,Tarragona,94,67,27
1988,43148,Tarragona,Tarragona,1581,1164,417
1988,43155,Tortosa,Tarragona,222,234,-12
1988,43161,Valls,Tarragona,223,141,82
1988,43163,El Vendrell,Tarragona,437,234,203
1988,43171,Vila-seca,Tarragona,477,325,152
1988,43901,Deltebre,Tarragona,36,22,14
1988,44013,Alcañiz,Teruel,90,184,-94
1988,44216,Teruel,Teruel,309,461,-152
1988,45053,Consuegra,Toledo,73,95,-22
1988,45087,Madridejos,Toledo,46,128,-82
1988,45165,Talavera de la Reina,Toledo,559,658,-99
1988,45168,Toledo,Toledo,626,633,-7
1988,46005,Alaquàs,Valencia,85,85,0
1988,46013,Alboraya,Valencia,47,31,16
1988,46017,Alzira,Valencia,170,178,-8
1988,46019,L'Alcúdia,Valencia,35,20,15
1988,46021,Aldaia,Valencia,74,82,-8
1988,46022,Alfafar,Valencia,101,76,25
1988,46029,Algemesí,Valencia,69,139,-70
1988,46031,Alginet,Valencia,45,30,15
1988,46054,Benetússer,Valencia,54,57,-3
1988,46060,Benifaió,Valencia,7,43,-36
1988,46078,Burjassot,Valencia,143,193,-50
1988,46081,Canals,Valencia,12,23,-11
1988,46083,Carcaixent,Valencia,58,96,-38
1988,46085,Carlet,Valencia,58,51,7
1988,46094,Catarroja,Valencia,54,55,-1
1988,46102,Quart de Poblet,Valencia,110,140,-30
1988,46105,Cullera,Valencia,148,119,29
1988,46110,Xirivella,Valencia,195,140,55
1988,46131,Gandia,Valencia,484,381,103
1988,46145,Xátiva,Valencia,91,117,-26
1988,46147,Llíria,Valencia,74,68,6
1988,46159,Manises,Valencia,99,87,12
1988,46164,Massamagrell,Valencia,73,129,-56
1988,46169,Mislata,Valencia,180,199,-19
1988,46171,Moncada,Valencia,54,90,-36
1988,46181,Oliva,Valencia,109,106,3
1988,46184,Ontinyent,Valencia,114,70,44
1988,46186,Paiporta,Valencia,86,84,2
1988,46190,Paterna,Valencia,295,274,21
1988,46194,Picassent,Valencia,35,55,-20
1988,46205,Puçol,Valencia,59,97,-38
1988,46213,Requena,Valencia,52,161,-109
1988,46220,Sagunto/Sagunt,Valencia,378,404,-26
1988,46230,Silla,Valencia,66,78,-12
1988,46235,Sueca,Valencia,41,66,-25
1988,46238,Tavernes de la Valldigna,Valencia,35,46,-11
1988,46244,Torrent (Valencia),Valencia,244,272,-28
1988,46249,Utiel,Valencia,43,56,-13
1988,46250,València,Valencia,4360,4036,324
1988,47085,Medina del Campo,Valladolid,180,222,-42
1988,47186,Valladolid,Valladolid,3421,3119,302
1988,48003,Amorebieta-Etxano,Vizcaya,23,99,-76
1988,48013,Barakaldo,Vizcaya,331,1184,-853
1988,48015,Basauri,Vizcaya,174,478,-304
1988,48017,Bermeo,Vizcaya,18,86,-68
1988,48020,Bilbao,Vizcaya,1751,3847,-2096
1988,48027,Durango,Vizcaya,85,211,-126
1988,48034,Ermua,Vizcaya,134,317,-183
1988,48036,Galdakao,Vizcaya,77,254,-177
1988,48044,Getxo,Vizcaya,466,1014,-548
1988,48046,Gernika-Lumo,Vizcaya,38,96,-58
1988,48054,Leioa,Vizcaya,108,203,-95
1988,48069,Mungia,Vizcaya,29,63,-34
1988,48073,Ondarroa,Vizcaya,64,189,-125
1988,48078,Portugalete,Vizcaya,182,623,-441
1988,48080,Valle de Trápaga-Trapagaran,Vizcaya,29,82,-53
1988,48082,Santurtzi,Vizcaya,219,530,-311
1988,48084,Sestao,Vizcaya,110,363,-253
1988,48902,Erandio,Vizcaya,68,169,-101
1988,49021,Benavente,Zamora,155,233,-78
1988,49275,Zamora,Zamora,535,725,-190
1988,50067,Calatayud,Zaragoza,194,178,16
1988,50095,Ejea de los Caballeros,Zaragoza,67,77,-10
1988,50251,Tarazona,Zaragoza,46,72,-26
1988,50297,Zaragoza,Zaragoza,4768,3497,1271
1988,51001,Ceuta,Ceuta,1080,1092,-12
1988,52001,Melilla,Melilla,984,1049,-65
1989,01036,Laudio/Llodio,Álava,122,225,-103
1989,01059,Vitoria-Gasteiz,Álava,2648,1729,919
1989,02003,Albacete,Albacete,1371,1360,11
1989,02009,Almansa,Albacete,196,214,-18
1989,02037,Hellín,Albacete,217,357,-140
1989,02069,La Roda,Albacete,102,126,-24
1989,02081,Villarrobledo,Albacete,117,209,-92
1989,03009,Alcoy/Alcoi,Alicante,324,463,-139
1989,03014,Alicante/Alacant,Alicante,3281,2124,1157
1989,03015,Almoradí,Alicante,106,77,29
1989,03018,Altea,Alicante,196,109,87
1989,03019,Aspe,Alicante,39,39,0
1989,03031,Benidorm,Alicante,1438,679,759
1989,03047,Calp,Alicante,394,131,263
1989,03049,Callosa de Segura,Alicante,36,52,-16
1989,03050,El Campello,Alicante,158,88,70
1989,03056,Cocentaina,Alicante,55,69,-14
1989,03059,Crevillent,Alicante,46,73,-27
1989,03063,Dénia,Alicante,574,266,308
1989,03065,Elche/Elx,Alicante,911,800,111
1989,03066,Elda,Alicante,244,268,-24
1989,03079,Ibi,Alicante,141,93,48
1989,03082,Jávea/Xàbia,Alicante,287,142,145
1989,03089,Monóvar/Monòver,Alicante,49,44,5
1989,03093,Novelda,Alicante,141,80,61
1989,03099,Orihuela,Alicante,243,369,-126
1989,03104,Petrer,Alicante,102,92,10
1989,03119,Sant Joan d'Alacant,Alicante,135,112,23
1989,03121,Santa Pola,Alicante,283,97,186
1989,03122,San Vicente del Raspeig/Sant Vicent del Raspeig,Alicante,279,168,111
1989,03133,Torrevieja,Alicante,1331,299,1032
1989,03139,Villajoyosa/La Vila Joiosa,Alicante,257,193,64
1989,03140,Villena,Alicante,162,188,-26
1989,04003,Adra,Almería,129,183,-54
1989,04006,Albox,Almería,45,81,-36
1989,04013,Almería,Almería,1419,1411,8
1989,04029,Berja,Almería,93,92,1
1989,04053,Huércal-Overa,Almería,166,161,5
1989,04066,Níjar,Almería,100,53,47
1989,04079,Roquetas de Mar,Almería,878,359,519
1989,04102,Vícar,Almería,171,96,75
1989,04902,El Ejido,Almería,657,338,319
1989,05019,Ávila,Ávila,562,821,-259
1989,06011,Almendralejo,Badajoz,183,255,-72
1989,06014,Azuaga,Badajoz,77,129,-52
1989,06015,Badajoz,Badajoz,917,1428,-511
1989,06044,Don Benito,Badajoz,226,429,-203
1989,06083,Mérida,Badajoz,499,582,-83
1989,06088,Montijo,Badajoz,122,160,-38
1989,06095,Olivenza,Badajoz,47,133,-86
1989,06149,Villafranca de los Barros,Badajoz,64,158,-94
1989,06153,Villanueva de la Serena,Badajoz,119,318,-199
1989,06158,Zafra,Badajoz,109,116,-7
1989,07011,Calvià,Baleares,1141,322,819
1989,07015,Ciutadella de Menorca,Baleares,500,252,248
1989,07022,Felanitx,Baleares,326,84,242
1989,07026,Eivissa,Baleares,1037,821,216
1989,07027,Inca,Baleares,137,100,37
1989,07031,Llucmajor,Baleares,300,109,191
1989,07032,Maó-Mahón,Baleares,684,403,281
1989,07033,Manacor,Baleares,571,239,332
1989,07036,Marratxí,Baleares,84,37,47
1989,07040,Palma,Baleares,5915,3372,2543
1989,07042,Pollença,Baleares,271,124,147
1989,07044,Sa Pobla,Baleares,61,72,-11
1989,07046,Sant Antoni de Portmany,Baleares,479,335,144
1989,07048,Sant Josep de sa Talaia,Baleares,311,135,176
1989,07054,Santa Eulària des Riu,Baleares,530,323,207
1989,07061,Sóller,Baleares,70,65,5
1989,08006,Arenys de Mar,Barcelona,63,61,2
1989,08015,Badalona,Barcelona,867,1394,-527
1989,08019,Barcelona,Barcelona,6267,10580,-4313
1989,08022,Berga,Barcelona,71,62,9
1989,08033,Caldes de Montbui,Barcelona,65,56,9
1989,08035,Calella,Barcelona,149,110,39
1989,08041,Canovelles,Barcelona,139,78,61
1989,08051,Castellar del Vallès,Barcelona,78,75,3
1989,08056,Castelldefels,Barcelona,423,417,6
1989,08073,Cornellà de Llobregat,Barcelona,420,576,-156
1989,08076,Esparreguera,Barcelona,77,87,-10
1989,08077,Esplugues de Llobregat,Barcelona,226,367,-141
1989,08089,Gavà,Barcelona,231,284,-53
1989,08096,Granollers,Barcelona,344,273,71
1989,08101,L'Hospitalet de Llobregat,Barcelona,1308,1690,-382
1989,08102,Igualada,Barcelona,115,146,-31
1989,08105,La Llagosta,Barcelona,60,106,-46
1989,08110,Malgrat de Mar,Barcelona,108,91,17
1989,08112,Manlleu,Barcelona,89,74,15
1989,08113,Manresa,Barcelona,254,207,47
1989,08114,Martorell,Barcelona,97,88,9
1989,08118,El Masnou,Barcelona,122,148,-26
1989,08121,Mataró,Barcelona,546,497,49
1989,08123,Molins de Rei,Barcelona,49,105,-56
1989,08124,Mollet del Vallès,Barcelona,344,244,100
1989,08125,Montcada i Reixac,Barcelona,169,183,-14
1989,08136,Montornès del Vallès,Barcelona,112,65,47
1989,08147,Olesa de Montserrat,Barcelona,56,65,-9
1989,08159,Parets del Vallès,Barcelona,75,50,25
1989,08163,Pineda de Mar,Barcelona,233,195,38
1989,08169,El Prat de Llobregat,Barcelona,451,535,-84
1989,08172,Premià de Mar,Barcelona,188,220,-32
1989,08180,Ripollet,Barcelona,211,174,37
1989,08184,Rubí,Barcelona,356,338,18
1989,08187,Sabadell,Barcelona,629,879,-250
1989,08194,Sant Adrià de Besòs,Barcelona,177,192,-15
1989,08196,Sant Andreu de la Barca,Barcelona,103,146,-43
1989,08200,Sant Boi de Llobregat,Barcelona,410,449,-39
1989,08202,Sant Celoni,Barcelona,107,72,35
1989,08205,Sant Cugat del Vallès,Barcelona,294,280,14
1989,08211,Sant Feliu de Llobregat,Barcelona,198,252,-54
1989,08217,Sant Joan Despí,Barcelona,130,140,-10
1989,08219,Vilassar de Mar,Barcelona,82,82,0
1989,08221,Sant Just Desvern,Barcelona,40,83,-43
1989,08231,Sant Pere de Ribes,Barcelona,183,95,88
1989,08245,Santa Coloma de Gramenet,Barcelona,617,893,-276
1989,08252,Barberà del Vallès,Barcelona,196,259,-63
1989,08260,Santa Perpètua de Mogoda,Barcelona,103,72,31
1989,08263,Sant Vicenç dels Horts,Barcelona,109,165,-56
1989,08266,Cerdanyola del Vallès,Barcelona,393,411,-18
1989,08270,Sitges,Barcelona,114,76,38
1989,08279,Terrassa,Barcelona,606,769,-163
1989,08285,Torelló,Barcelona,53,45,8
1989,08298,Vic,Barcelona,159,110,49
1989,08301,Viladecans,Barcelona,312,359,-47
1989,08305,Vilafranca del Penedès,Barcelona,138,105,33
1989,08307,Vilanova i la Geltrú,Barcelona,329,242,87
1989,09018,Aranda de Duero,Burgos,268,410,-142
1989,09059,Burgos,Burgos,1199,1665,-466
1989,09219,Miranda de Ebro,Burgos,462,473,-11
1989,10037,Cáceres,Cáceres,813,782,31
1989,10067,Coria,Cáceres,119,200,-81
1989,10131,Navalmoral de la Mata,Cáceres,221,313,-92
1989,10148,Plasencia,Cáceres,307,438,-131
1989,11004,Algeciras,Cádiz,1099,1014,85
1989,11006,Arcos de la Frontera,Cádiz,4,271,-267
1989,11007,Barbate,Cádiz,108,345,-237
1989,11008,Los Barrios,Cádiz,85,51,34
1989,11012,Cádiz,Cádiz,701,1247,-546
1989,11014,Conil de la Frontera,Cádiz,65,60,5
1989,11015,Chiclana de la Frontera,Cádiz,277,231,46
1989,11016,Chipiona,Cádiz,108,77,31
1989,11020,Jerez de la Frontera,Cádiz,1183,1652,-469
1989,11022,La Línea de la Concepción,Cádiz,388,520,-132
1989,11023,Medina-Sidonia,Cádiz,72,96,-24
1989,11027,El Puerto de Santa María,Cádiz,644,548,96
1989,11028,Puerto Real,Cádiz,170,119,51
1989,11030,Rota,Cádiz,179,191,-12
1989,11031,San Fernando,Cádiz,716,785,-69
1989,11032,Sanlúcar de Barrameda,Cádiz,243,238,5
1989,11033,San Roque,Cádiz,229,191,38
1989,11035,Tarifa,Cádiz,134,125,9
1989,11038,Ubrique,Cádiz,39,70,-31
1989,11039,Vejer de la Frontera,Cádiz,33,94,-61
1989,11041,Villamartín,Cádiz,89,144,-55
1989,12009,Almassora,Castellón,110,48,62
1989,12027,Benicarló,Castellón,294,133,161
1989,12032,Borriana/Burriana,Castellón,109,99,10
1989,12040,Castellón de la Plana/Castelló de la Plana,Castellón,1586,971,615
1989,12082,Nules,Castellón,63,42,21
1989,12084,Onda,Castellón,72,42,30
1989,12126,La Vall d'Uixó,Castellón,141,106,35
1989,12135,Vila-real,Castellón,387,136,251
1989,12138,Vinaròs,Castellón,337,167,170
1989,13005,Alcázar de San Juan,Ciudad Real,227,422,-195
1989,13023,Bolaños de Calatrava,Ciudad Real,18,42,-24
1989,13028,Campo de Criptana,Ciudad Real,53,119,-66
1989,13034,Ciudad Real,Ciudad Real,612,679,-67
1989,13039,Daimiel,Ciudad Real,108,128,-20
1989,13053,Manzanares,Ciudad Real,194,265,-71
1989,13071,Puertollano,Ciudad Real,385,856,-471
1989,13078,Socuéllamos,Ciudad Real,59,195,-136
1989,13079,La Solana,Ciudad Real,37,87,-50
1989,13082,Tomelloso,Ciudad Real,145,168,-23
1989,13087,Valdepeñas,Ciudad Real,191,293,-102
1989,14002,Aguilar de la Frontera,Córdoba,71,85,-14
1989,14007,Baena,Córdoba,92,197,-105
1989,14013,Cabra,Córdoba,171,232,-61
1989,14021,Córdoba,Córdoba,2104,2833,-729
1989,14038,Lucena,Córdoba,224,190,34
1989,14042,Montilla,Córdoba,116,190,-74
1989,14049,Palma del Río,Córdoba,204,238,-34
1989,14052,Peñarroya-Pueblonuevo,Córdoba,107,148,-41
1989,14054,Pozoblanco,Córdoba,122,162,-40
1989,14055,Priego de Córdoba,Córdoba,190,278,-88
1989,14056,Puente Genil,Córdoba,167,285,-118
1989,14058,Rute,Córdoba,40,159,-119
1989,14069,Villanueva de Córdoba,Córdoba,26,68,-42
1989,15005,Arteixo,A Coruña,100,52,48
1989,15009,Betanzos,A Coruña,60,44,16
1989,15011,Boiro,A Coruña,84,137,-53
1989,15017,Cambre,A Coruña,69,75,-6
1989,15019,Carballo,A Coruña,60,89,-29
1989,15029,Coristanco,A Coruña,19,29,-10
1989,15030,A Coruña,A Coruña,1912,1588,324
1989,15031,Culleredo,A Coruña,68,41,27
1989,15035,Fene,A Coruña,63,111,-48
1989,15036,Ferrol,A Coruña,606,911,-305
1989,15041,A Laracha,A Coruña,19,29,-10
1989,15053,Muros,A Coruña,47,108,-61
1989,15054,Narón,A Coruña,159,205,-46
1989,15057,Noia,A Coruña,80,76,4
1989,15058,Oleiros,A Coruña,193,103,90
1989,15059,Ordes,A Coruña,40,45,-5
1989,15061,Ortigueira,A Coruña,26,61,-35
1989,15062,Outes,A Coruña,17,48,-31
1989,15065,Padrón,A Coruña,103,69,34
1989,15067,A Pobra do Caramiñal,A Coruña,47,46,1
1989,15070,As Pontes de García Rodríguez,A Coruña,121,155,-34
1989,15071,Porto do Son,A Coruña,51,116,-65
1989,15072,Rianxo,A Coruña,40,114,-74
1989,15073,Ribeira,A Coruña,107,104,3
1989,15077,Santa Comba,A Coruña,7,24,-17
1989,15078,Santiago de Compostela,A Coruña,1093,564,529
1989,15082,Teo,A Coruña,125,79,46
1989,16078,Cuenca,Cuenca,461,645,-184
1989,16203,Tarancón,Cuenca,85,150,-65
1989,17015,Banyoles,Girona,151,78,73
1989,17023,Blanes,Girona,790,266,524
1989,17066,Figueres,Girona,605,303,302
1989,17079,Girona,Girona,1075,692,383
1989,17095,Lloret de Mar,Girona,770,455,315
1989,17114,Olot,Girona,273,157,116
1989,17117,Palafrugell,Girona,322,129,193
1989,17118,Palamós,Girona,254,91,163
1989,17147,Ripoll,Girona,122,118,4
1989,17152,Roses,Girona,366,168,198
1989,17155,Salt,Girona,383,158,225
1989,17160,Sant Feliu de Guíxols,Girona,417,136,281
1989,18017,Almuñécar,Granada,186,118,68
1989,18021,Armilla,Granada,124,91,33
1989,18022,Atarfe,Granada,86,80,6
1989,18023,Baza,Granada,181,288,-107
1989,18087,Granada,Granada,3497,2450,1047
1989,18089,Guadix,Granada,212,256,-44
1989,18098,Huéscar,Granada,95,168,-73
1989,18102,Illora,Granada,103,78,25
1989,18122,Loja,Granada,156,176,-20
1989,18127,Maracena,Granada,148,51,97
1989,18140,Motril,Granada,435,396,39
1989,18158,Pinos Puente,Granada,51,95,-44
1989,18175,Santa Fe,Granada,94,95,-1
1989,19046,Azuqueca de Henares,Guadalajara,285,123,162
1989,19130,Guadalajara,Guadalajara,1032,858,174
1989,20009,Andoain,Guipúzcoa,60,206,-146
1989,20017,Azkoitia,Guipúzcoa,26,39,-13
1989,20018,Azpeitia,Guipúzcoa,26,53,-27
1989,20019,Beasain,Guipúzcoa,54,151,-97
1989,20030,Eibar,Guipúzcoa,174,471,-297
1989,20032,Elgoibar,Guipúzcoa,60,143,-83
1989,20036,Hondarribia,Guipúzcoa,76,81,-5
1989,20040,Hernani,Guipúzcoa,89,235,-146
1989,20045,Irun,Guipúzcoa,350,643,-293
1989,20051,Legazpi,Guipúzcoa,51,104,-53
1989,20055,Arrasate/Mondragón,Guipúzcoa,131,381,-250
1989,20059,Oñati,Guipúzcoa,26,66,-40
1989,20064,Pasaia,Guipúzcoa,65,172,-107
1989,20067,Errenteria,Guipúzcoa,194,630,-436
1989,20069,Donostia/San Sebastián,Guipúzcoa,1058,1734,-676
1989,20071,Tolosa,Guipúzcoa,45,115,-70
1989,20074,Bergara,Guipúzcoa,65,134,-69
1989,20079,Zarautz,Guipúzcoa,122,134,-12
1989,20080,Zumarraga,Guipúzcoa,52,125,-73
1989,20902,Lasarte-Oria,Guipúzcoa,87,321,-234
1989,21005,Almonte,Huelva,432,166,266
1989,21010,Ayamonte,Huelva,137,132,5
1989,21013,Bollullos Par del Condado,Huelva,34,29,5
1989,21021,Cartaya,Huelva,70,77,-7
1989,21041,Huelva,Huelva,717,888,-171
1989,21042,Isla Cristina,Huelva,113,115,-2
1989,21044,Lepe,Huelva,100,88,12
1989,21050,Moguer,Huelva,113,58,55
1989,21060,Punta Umbría,Huelva,80,105,-25
1989,21072,Valverde del Camino,Huelva,47,49,-2
1989,22048,Barbastro,Huesca,171,175,-4
1989,22112,Fraga,Huesca,138,102,36
1989,22125,Huesca,Huesca,498,484,14
1989,22130,Jaca,Huesca,203,173,30
1989,22158,Monzón,Huesca,157,164,-7
1989,23002,Alcalá la Real,Jaén,326,336,-10
1989,23003,Alcaudete,Jaén,96,182,-86
1989,23005,Andújar,Jaén,260,575,-315
1989,23009,Baeza,Jaén,124,138,-14
1989,23010,Bailén,Jaén,107,94,13
1989,23024,La Carolina,Jaén,57,212,-155
1989,23050,Jaén,Jaén,821,1110,-289
1989,23053,Jódar,Jaén,233,315,-82
1989,23055,Linares,Jaén,472,920,-448
1989,23060,Martos,Jaén,148,159,-11
1989,23086,Torredelcampo,Jaén,54,41,13
1989,23087,Torredonjimeno,Jaén,43,58,-15
1989,23092,Úbeda,Jaén,268,442,-174
1989,23095,Villacarrillo,Jaén,85,318,-233
1989,24008,Astorga,León,124,175,-51
1989,24014,Bembibre,León,128,170,-42
1989,24089,León,León,1019,1457,-438
1989,24115,Ponferrada,León,429,734,-305
1989,24142,San Andrés del Rabanedo,León,177,153,24
1989,24202,Villablino,León,108,128,-20
1989,25040,Balaguer,Lleida,57,75,-18
1989,25120,Lleida,Lleida,872,1010,-138
1989,25203,La Seu d'Urgell,Lleida,314,191,123
1989,25217,Tàrrega,Lleida,134,84,50
1989,26018,Arnedo,La Rioja,42,58,-16
1989,26036,Calahorra,La Rioja,206,185,21
1989,26089,Logroño,La Rioja,1387,1385,2
1989,27013,Cervo,Lugo,186,127,59
1989,27016,Chantada,Lugo,63,128,-65
1989,27028,Lugo,Lugo,642,696,-54
1989,27031,Monforte de Lemos,Lugo,185,228,-43
1989,27057,Sarria,Lugo,81,75,6
1989,27065,Vilalba,Lugo,60,130,-70
1989,27066,Viveiro,Lugo,106,127,-21
1989,28005,Alcalá de Henares,Madrid,2143,1612,531
1989,28006,Alcobendas,Madrid,788,429,359
1989,28007,Alcorcón,Madrid,984,1008,-24
1989,28013,Aranjuez,Madrid,376,261,115
1989,28014,Arganda del Rey,Madrid,194,126,68
1989,28022,Boadilla del Monte,Madrid,109,60,49
1989,28040,Ciempozuelos,Madrid,84,50,34
1989,28045,Colmenar Viejo,Madrid,615,408,207
1989,28047,Collado Villalba,Madrid,553,259,294
1989,28049,Coslada,Madrid,507,376,131
1989,28058,Fuenlabrada,Madrid,1918,1312,606
1989,28065,Getafe,Madrid,1068,817,251
1989,28074,Leganés,Madrid,1174,766,408
1989,28079,Madrid,Madrid,23688,20269,3419
1989,28080,Majadahonda,Madrid,489,280,209
1989,28084,Mejorada del Campo,Madrid,106,98,8
1989,28092,Móstoles,Madrid,1786,1515,271
1989,28106,Parla,Madrid,769,593,176
1989,28113,Pinto,Madrid,217,193,24
1989,28115,Pozuelo de Alarcón,Madrid,405,264,141
1989,28127,Las Rozas de Madrid,Madrid,554,231,323
1989,28130,San Fernando de Henares,Madrid,240,170,70
1989,28134,San Sebastián de los Reyes,Madrid,388,322,66
1989,28148,Torrejón de Ardoz,Madrid,657,574,83
1989,28161,Valdemoro,Madrid,308,422,-114
1989,28181,Villaviciosa de Odón,Madrid,111,76,35
1989,29007,Alhaurín de la Torre,Málaga,131,55,76
1989,29008,Alhaurín el Grande,Málaga,40,21,19
1989,29012,Álora,Málaga,41,38,3
1989,29015,Antequera,Málaga,239,196,43
1989,29017,Archidona,Málaga,47,60,-13
1989,29025,Benalmádena,Málaga,580,115,465
1989,29038,Cártama,Málaga,21,25,-4
1989,29042,Coín,Málaga,60,40,20
1989,29051,Estepona,Málaga,704,263,441
1989,29054,Fuengirola,Málaga,1169,363,806
1989,29067,Málaga,Málaga,3551,2336,1215
1989,29069,Marbella,Málaga,1600,695,905
1989,29070,Mijas,Málaga,294,97,197
1989,29075,Nerja,Málaga,157,70,87
1989,29082,Rincón de la Victoria,Málaga,224,58,166
1989,29084,Ronda,Málaga,313,368,-55
1989,29091,Torrox,Málaga,72,32,40
1989,29094,Vélez-Málaga,Málaga,392,292,100
1989,29901,Torremolinos,Málaga,349,21,328
1989,30002,Abarán,Murcia,31,44,-13
1989,30003,Águilas,Murcia,543,394,149
1989,30005,Alcantarilla,Murcia,252,197,55
1989,30008,Alhama de Murcia,Murcia,68,64,4
1989,30009,Archena,Murcia,78,61,17
1989,30012,Bullas,Murcia,51,22,29
1989,30015,Caravaca de la Cruz,Murcia,160,158,2
1989,30016,Cartagena,Murcia,1568,1596,-28
1989,30017,Cehegín,Murcia,56,71,-15
1989,30019,Cieza (Murcia),Murcia,99,104,-5
1989,30022,Jumilla,Murcia,117,121,-4
1989,30024,Lorca,Murcia,386,368,18
1989,30026,Mazarrón,Murcia,164,101,63
1989,30027,Molina de Segura,Murcia,257,218,39
1989,30028,Moratalla,Murcia,22,38,-16
1989,30029,Mula,Murcia,47,40,7
1989,30030,Murcia,Murcia,2228,1434,794
1989,30035,San Javier,Murcia,572,259,313
1989,30036,San Pedro del Pinatar,Murcia,310,140,170
1989,30037,Torre-Pacheco,Murcia,181,101,80
1989,30038,Las Torres de Cotillas,Murcia,159,72,87
1989,30039,Totana,Murcia,60,42,18
1989,30041,La Unión,Murcia,88,67,21
1989,30043,Yecla,Murcia,212,165,47
1989,31016,Ansoáin/Antsoain,Navarra,52,62,-10
1989,31060,Burlada/Burlata,Navarra,125,113,12
1989,31097,Estella-Lizarra,Navarra,141,117,24
1989,31201,Pamplona/Iruña,Navarra,1542,1174,368
1989,31227,Tafalla,Navarra,48,49,-1
1989,31232,Tudela,Navarra,281,268,13
1989,31901,Barañain,Navarra,230,189,41
1989,32009,O Barco de Valdeorras,Ourense,120,106,14
1989,32019,O Carballiño,Ourense,89,67,22
1989,32032,Xinzo de Limia,Ourense,64,75,-11
1989,32054,Ourense,Ourense,684,977,-293
1989,32085,Verín,Ourense,110,95,15
1989,33002,Aller,Asturias,19,81,-62
1989,33004,Avilés,Asturias,463,567,-104
1989,33011,Cangas del Narcea,Asturias,78,114,-36
1989,33014,Carreño,Asturias,40,23,17
1989,33016,Castrillón,Asturias,122,135,-13
1989,33020,Corvera de Asturias,Asturias,76,112,-36
1989,33024,Gijón,Asturias,1549,1546,3
1989,33025,Gozón,Asturias,19,27,-8
1989,33026,Grado,Asturias,36,44,-8
1989,33031,Langreo,Asturias,91,271,-180
1989,33032,Laviana,Asturias,14,30,-16
1989,33033,Lena,Asturias,80,88,-8
1989,33034,Valdés,Asturias,57,62,-5
1989,33035,Llanera,Asturias,23,25,-2
1989,33036,Llanes,Asturias,58,95,-37
1989,33037,Mieres (Asturias),Asturias,139,240,-101
1989,33044,Oviedo,Asturias,1228,1211,17
1989,33049,Piloña,Asturias,18,21,-3
1989,33051,Pravia,Asturias,18,37,-19
1989,33060,San Martín del Rey Aurelio,Asturias,40,98,-58
1989,33066,Siero,Asturias,188,177,11
1989,33073,Tineo,Asturias,23,48,-25
1989,33076,Villaviciosa,Asturias,46,43,3
1989,34120,Palencia,Palencia,663,876,-213
1989,35002,Agüimes,Las Palmas,77,45,32
1989,35004,Arrecife,Las Palmas,1452,938,514
1989,35006,Arucas,Las Palmas,87,68,19
1989,35009,Gáldar,Las Palmas,17,22,-5
1989,35011,Ingenio,Las Palmas,48,41,7
1989,35016,Las Palmas de Gran Canaria,Las Palmas,4108,3425,683
1989,35017,Puerto del Rosario,Las Palmas,707,410,297
1989,35019,San Bartolomé de Tirajana,Las Palmas,518,395,123
1989,35021,Santa Brígida,Las Palmas,65,65,0
1989,35022,Santa Lucía de Tirajana,Las Palmas,145,110,35
1989,35023,Santa María de Guía de Gran Canaria,Las Palmas,28,26,2
1989,35026,Telde,Las Palmas,325,240,85
1989,35027,Teror,Las Palmas,17,11,6
1989,36003,Baiona,Pontevedra,1,37,-36
1989,36004,Bueu,Pontevedra,20,31,-11
1989,36006,Cambados,Pontevedra,47,87,-40
1989,36008,Cangas,Pontevedra,30,49,-19
1989,36017,A Estrada,Pontevedra,98,199,-101
1989,36021,Gondomar,Pontevedra,28,51,-23
1989,36022,O Grove,Pontevedra,61,72,-11
1989,36023,A Guarda,Pontevedra,26,48,-22
1989,36024,Lalín,Pontevedra,87,124,-37
1989,36026,Marín,Pontevedra,139,192,-53
1989,36029,Moaña,Pontevedra,30,51,-21
1989,36033,Mos,Pontevedra,20,45,-25
1989,36035,Nigrán,Pontevedra,46,44,2
1989,36038,Pontevedra,Pontevedra,684,527,157
1989,36039,O Porriño,Pontevedra,70,86,-16
1989,36041,Poio,Pontevedra,62,64,-2
1989,36042,Ponteareas,Pontevedra,75,115,-40
1989,36045,Redondela,Pontevedra,84,132,-48
1989,36051,Sanxenxo,Pontevedra,46,75,-29
1989,36052,Silleda,Pontevedra,21,63,-42
1989,36054,Tomiño,Pontevedra,38,65,-27
1989,36055,Tui,Pontevedra,109,144,-35
1989,36057,Vigo,Pontevedra,1684,1597,87
1989,36060,Vilagarcía de Arousa,Pontevedra,327,268,59
1989,36061,Vilanova de Arousa,Pontevedra,49,115,-66
1989,37046,Béjar,Salamanca,95,214,-119
1989,37107,Ciudad Rodrigo,Salamanca,138,168,-30
1989,37274,Salamanca,Salamanca,1946,1860,86
1989,38006,Arona,Santa Cruz de Tenerife,1074,583,491
1989,38017,Granadilla de Abona,Santa Cruz de Tenerife,397,349,48
1989,38019,Guía de Isora,Santa Cruz de Tenerife,130,104,26
1989,38020,Güímar,Santa Cruz de Tenerife,58,36,22
1989,38022,Icod de los Vinos,Santa Cruz de Tenerife,60,28,32
1989,38023,San Cristóbal de La Laguna,Santa Cruz de Tenerife,728,411,317
1989,38024,Los Llanos de Aridane,Santa Cruz de Tenerife,91,133,-42
1989,38026,La Orotava,Santa Cruz de Tenerife,91,46,45
1989,38028,Puerto de la Cruz,Santa Cruz de Tenerife,269,143,126
1989,38031,Los Realejos,Santa Cruz de Tenerife,52,46,6
1989,38037,Santa Cruz de la Palma,Santa Cruz de Tenerife,241,282,-41
1989,38038,Santa Cruz de Tenerife,Santa Cruz de Tenerife,2538,1786,752
1989,38043,Tacoronte,Santa Cruz de Tenerife,45,30,15
1989,39008,El Astillero,Cantabria,91,70,21
1989,39016,Camargo,Cantabria,137,85,52
1989,39020,Castro-Urdiales,Cantabria,259,120,139
1989,39035,Laredo,Cantabria,184,137,47
1989,39059,Reinosa,Cantabria,73,125,-52
1989,39075,Santander,Cantabria,1370,1414,-44
1989,39079,Santoña,Cantabria,79,82,-3
1989,39087,Torrelavega,Cantabria,264,372,-108
1989,40194,Segovia,Segovia,556,689,-133
1989,41004,Alcalá de Guadaíra,Sevilla,227,231,-4
1989,41007,La Algaba,Sevilla,26,19,7
1989,41011,Arahal,Sevilla,64,61,3
1989,41018,Brenes,Sevilla,45,56,-11
1989,41020,Las Cabezas de San Juan,Sevilla,60,110,-50
1989,41021,Camas,Sevilla,164,128,36
1989,41024,Carmona,Sevilla,129,90,39
1989,41029,Castilleja de la Cuesta,Sevilla,128,123,5
1989,41034,Coria del Río,Sevilla,103,71,32
1989,41038,Dos Hermanas,Sevilla,910,428,482
1989,41039,Écija,Sevilla,264,199,65
1989,41041,Estepa,Sevilla,80,66,14
1989,41053,Lebrija,Sevilla,200,242,-42
1989,41055,Lora del Río,Sevilla,105,147,-42
1989,41058,Mairena del Alcor,Sevilla,65,14,51
1989,41059,Mairena del Aljarafe,Sevilla,462,113,349
1989,41060,Marchena,Sevilla,75,63,12
1989,41065,Morón de la Frontera,Sevilla,238,357,-119
1989,41068,Osuna,Sevilla,64,113,-49
1989,41069,Los Palacios y Villafranca,Sevilla,99,81,18
1989,41075,Pilas,Sevilla,54,20,34
1989,41077,La Puebla de Cazalla,Sevilla,89,182,-93
1989,41079,La Puebla del Río,Sevilla,76,83,-7
1989,41081,La Rinconada,Sevilla,114,93,21
1989,41086,San Juan de Aznalfarache,Sevilla,208,129,79
1989,41091,Sevilla,Sevilla,4999,3720,1279
1989,41093,Tomares,Sevilla,224,68,156
1989,41095,Utrera,Sevilla,283,232,51
1989,41102,El Viso del Alcor,Sevilla,19,20,-1
1989,42173,Soria,Soria,333,436,-103
1989,43014,Amposta,Tarragona,104,109,-5
1989,43038,Cambrils,Tarragona,424,203,221
1989,43123,Reus,Tarragona,1152,621,531
1989,43136,Sant Carles de la Ràpita,Tarragona,128,92,36
1989,43148,Tarragona,Tarragona,1136,1179,-43
1989,43155,Tortosa,Tarragona,257,191,66
1989,43161,Valls,Tarragona,184,150,34
1989,43163,El Vendrell,Tarragona,472,276,196
1989,43171,Vila-seca,Tarragona,684,259,425
1989,43901,Deltebre,Tarragona,21,19,2
1989,44013,Alcañiz,Teruel,76,171,-95
1989,44216,Teruel,Teruel,327,415,-88
1989,45053,Consuegra,Toledo,38,69,-31
1989,45087,Madridejos,Toledo,65,56,9
1989,45165,Talavera de la Reina,Toledo,687,778,-91
1989,45168,Toledo,Toledo,669,671,-2
1989,46005,Alaquàs,Valencia,108,112,-4
1989,46013,Alboraya,Valencia,91,35,56
1989,46017,Alzira,Valencia,143,215,-72
1989,46019,L'Alcúdia,Valencia,29,31,-2
1989,46021,Aldaia,Valencia,172,81,91
1989,46022,Alfafar,Valencia,116,52,64
1989,46029,Algemesí,Valencia,131,130,1
1989,46031,Alginet,Valencia,31,27,4
1989,46054,Benetússer,Valencia,56,83,-27
1989,46060,Benifaió,Valencia,18,52,-34
1989,46078,Burjassot,Valencia,145,169,-24
1989,46081,Canals,Valencia,47,37,10
1989,46083,Carcaixent,Valencia,79,67,12
1989,46085,Carlet,Valencia,55,45,10
1989,46094,Catarroja,Valencia,64,51,13
1989,46102,Quart de Poblet,Valencia,151,127,24
1989,46105,Cullera,Valencia,104,103,1
1989,46110,Xirivella,Valencia,166,108,58
1989,46131,Gandia,Valencia,520,284,236
1989,46145,Xátiva,Valencia,138,124,14
1989,46147,Llíria,Valencia,84,70,14
1989,46159,Manises,Valencia,155,98,57
1989,46164,Massamagrell,Valencia,101,89,12
1989,46169,Mislata,Valencia,237,146,91
1989,46171,Moncada,Valencia,93,70,23
1989,46181,Oliva,Valencia,120,109,11
1989,46184,Ontinyent,Valencia,168,98,70
1989,46186,Paiporta,Valencia,113,65,48
1989,46190,Paterna,Valencia,395,294,101
1989,46194,Picassent,Valencia,50,60,-10
1989,46205,Puçol,Valencia,80,48,32
1989,46213,Requena,Valencia,77,152,-75
1989,46220,Sagunto/Sagunt,Valencia,416,397,19
1989,46230,Silla,Valencia,110,99,11
1989,46235,Sueca,Valencia,96,125,-29
1989,46238,Tavernes de la Valldigna,Valencia,53,34,19
1989,46244,Torrent (Valencia),Valencia,282,228,54
1989,46249,Utiel,Valencia,52,64,-12
1989,46250,València,Valencia,5812,4534,1278
1989,47076,Laguna de Duero,Valladolid,279,173,106
1989,47085,Medina del Campo,Valladolid,187,234,-47
1989,47186,Valladolid,Valladolid,2914,3405,-491
1989,48003,Amorebieta-Etxano,Vizcaya,45,108,-63
1989,48013,Barakaldo,Vizcaya,432,1283,-851
1989,48015,Basauri,Vizcaya,147,491,-344
1989,48017,Bermeo,Vizcaya,40,127,-87
1989,48020,Bilbao,Vizcaya,2130,4101,-1971
1989,48027,Durango,Vizcaya,89,222,-133
1989,48034,Ermua,Vizcaya,156,397,-241
1989,48036,Galdakao,Vizcaya,105,253,-148
1989,48044,Getxo,Vizcaya,552,928,-376
1989,48046,Gernika-Lumo,Vizcaya,69,91,-22
1989,48054,Leioa,Vizcaya,95,186,-91
1989,48069,Mungia,Vizcaya,43,48,-5
1989,48073,Ondarroa,Vizcaya,71,191,-120
1989,48078,Portugalete,Vizcaya,236,660,-424
1989,48080,Valle de Trápaga-Trapagaran,Vizcaya,51,113,-62
1989,48082,Santurtzi,Vizcaya,243,628,-385
1989,48084,Sestao,Vizcaya,141,379,-238
1989,48902,Erandio,Vizcaya,85,213,-128
1989,49021,Benavente,Zamora,179,245,-66
1989,49275,Zamora,Zamora,626,805,-179
1989,50067,Calatayud,Zaragoza,175,217,-42
1989,50095,Ejea de los Caballeros,Zaragoza,78,69,9
1989,50251,Tarazona,Zaragoza,193,87,106
1989,50297,Zaragoza,Zaragoza,4483,3705,778
1989,51001,Ceuta,Ceuta,992,1243,-251
1989,52001,Melilla,Melilla,724,1156,-432
1990,01036,Laudio/Llodio,Álava,155,274,-119
1990,01059,Vitoria-Gasteiz,Álava,2436,1762,674
1990,02003,Albacete,Albacete,1757,1208,549
1990,02009,Almansa,Albacete,233,199,34
1990,02037,Hellín,Albacete,310,282,28
1990,02069,La Roda,Albacete,164,115,49
1990,02081,Villarrobledo,Albacete,120,189,-69
1990,03009,Alcoy/Alcoi,Alicante,317,393,-76
1990,03014,Alicante/Alacant,Alicante,3137,2105,1032
1990,03015,Almoradí,Alicante,90,96,-6
1990,03018,Altea,Alicante,169,110,59
1990,03019,Aspe,Alicante,32,43,-11
1990,03031,Benidorm,Alicante,1340,722,618
1990,03047,Calp,Alicante,258,198,60
1990,03049,Callosa de Segura,Alicante,49,67,-18
1990,03050,El Campello,Alicante,238,78,160
1990,03056,Cocentaina,Alicante,50,66,-16
1990,03059,Crevillent,Alicante,131,66,65
1990,03063,Dénia,Alicante,497,308,189
1990,03065,Elche/Elx,Alicante,1016,733,283
1990,03066,Elda,Alicante,264,310,-46
1990,03079,Ibi,Alicante,125,101,24
1990,03082,Jávea/Xàbia,Alicante,231,164,67
1990,03089,Monóvar/Monòver,Alicante,31,27,4
1990,03093,Novelda,Alicante,85,91,-6
1990,03099,Orihuela,Alicante,313,437,-124
1990,03104,Petrer,Alicante,93,85,8
1990,03119,Sant Joan d'Alacant,Alicante,186,113,73
1990,03121,Santa Pola,Alicante,302,120,182
1990,03122,San Vicente del Raspeig/Sant Vicent del Raspeig,Alicante,285,165,120
1990,03133,Torrevieja,Alicante,1050,444,606
1990,03139,Villajoyosa/La Vila Joiosa,Alicante,316,154,162
1990,03140,Villena,Alicante,163,172,-9
1990,04003,Adra,Almería,126,182,-56
1990,04006,Albox,Almería,64,66,-2
1990,04013,Almería,Almería,1689,1274,415
1990,04029,Berja,Almería,104,82,22
1990,04053,Huércal-Overa,Almería,142,137,5
1990,04066,Níjar,Almería,108,45,63
1990,04079,Roquetas de Mar,Almería,840,423,417
1990,04102,Vícar,Almería,186,108,78
1990,04902,El Ejido,Almería,595,403,192
1990,05019,Ávila,Ávila,501,728,-227
1990,06011,Almendralejo,Badajoz,201,191,10
1990,06014,Azuaga,Badajoz,75,109,-34
1990,06015,Badajoz,Badajoz,1307,1325,-18
1990,06044,Don Benito,Badajoz,272,445,-173
1990,06083,Mérida,Badajoz,559,564,-5
1990,06088,Montijo,Badajoz,106,149,-43
1990,06095,Olivenza,Badajoz,69,142,-73
1990,06149,Villafranca de los Barros,Badajoz,85,97,-12
1990,06153,Villanueva de la Serena,Badajoz,241,255,-14
1990,06158,Zafra,Badajoz,134,148,-14
1990,07011,Calvià,Baleares,834,400,434
1990,07015,Ciutadella de Menorca,Baleares,338,327,11
1990,07022,Felanitx,Baleares,183,192,-9
1990,07026,Eivissa,Baleares,958,936,22
1990,07027,Inca,Baleares,100,99,1
1990,07031,Llucmajor,Baleares,228,139,89
1990,07032,Maó-Mahón,Baleares,556,574,-18
1990,07033,Manacor,Baleares,323,317,6
1990,07036,Marratxí,Baleares,59,41,18
1990,07040,Palma,Baleares,3947,3856,91
1990,07042,Pollença,Baleares,159,131,28
1990,07044,Sa Pobla,Baleares,51,78,-27
1990,07046,Sant Antoni de Portmany,Baleares,433,435,-2
1990,07048,Sant Josep de sa Talaia,Baleares,189,172,17
1990,07054,Santa Eulària des Riu,Baleares,579,372,207
1990,07061,Sóller,Baleares,49,36,13
1990,08006,Arenys de Mar,Barcelona,66,71,-5
1990,08015,Badalona,Barcelona,872,1158,-286
1990,08019,Barcelona,Barcelona,7177,10834,-3657
1990,08022,Berga,Barcelona,82,77,5
1990,08033,Caldes de Montbui,Barcelona,69,20,49
1990,08035,Calella,Barcelona,136,135,1
1990,08041,Canovelles,Barcelona,178,107,71
1990,08051,Castellar del Vallès,Barcelona,80,75,5
1990,08056,Castelldefels,Barcelona,490,402,88
1990,08073,Cornellà de Llobregat,Barcelona,520,543,-23
1990,08076,Esparreguera,Barcelona,106,70,36
1990,08077,Esplugues de Llobregat,Barcelona,249,349,-100
1990,08086,Les Franqueses del Vallès,Barcelona,93,54,39
1990,08089,Gavà,Barcelona,283,239,44
1990,08096,Granollers,Barcelona,306,278,28
1990,08101,L'Hospitalet de Llobregat,Barcelona,1344,1612,-268
1990,08102,Igualada,Barcelona,141,120,21
1990,08105,La Llagosta,Barcelona,78,106,-28
1990,08110,Malgrat de Mar,Barcelona,134,104,30
1990,08112,Manlleu,Barcelona,83,73,10
1990,08113,Manresa,Barcelona,178,264,-86
1990,08114,Martorell,Barcelona,108,97,11
1990,08118,El Masnou,Barcelona,154,153,1
1990,08121,Mataró,Barcelona,549,561,-12
1990,08123,Molins de Rei,Barcelona,72,74,-2
1990,08124,Mollet del Vallès,Barcelona,267,262,5
1990,08125,Montcada i Reixac,Barcelona,130,156,-26
1990,08136,Montornès del Vallès,Barcelona,98,49,49
1990,08147,Olesa de Montserrat,Barcelona,63,73,-10
1990,08159,Parets del Vallès,Barcelona,106,37,69
1990,08163,Pineda de Mar,Barcelona,264,207,57
1990,08169,El Prat de Llobregat,Barcelona,393,442,-49
1990,08172,Premià de Mar,Barcelona,159,193,-34
1990,08180,Ripollet,Barcelona,189,200,-11
1990,08184,Rubí,Barcelona,327,285,42
1990,08187,Sabadell,Barcelona,884,946,-62
1990,08194,Sant Adrià de Besòs,Barcelona,147,188,-41
1990,08196,Sant Andreu de la Barca,Barcelona,110,125,-15
1990,08200,Sant Boi de Llobregat,Barcelona,380,481,-101
1990,08202,Sant Celoni,Barcelona,121,85,36
1990,08205,Sant Cugat del Vallès,Barcelona,297,249,48
1990,08211,Sant Feliu de Llobregat,Barcelona,238,249,-11
1990,08217,Sant Joan Despí,Barcelona,150,160,-10
1990,08219,Vilassar de Mar,Barcelona,68,94,-26
1990,08221,Sant Just Desvern,Barcelona,58,73,-15
1990,08231,Sant Pere de Ribes,Barcelona,153,102,51
1990,08245,Santa Coloma de Gramenet,Barcelona,587,898,-311
1990,08252,Barberà del Vallès,Barcelona,205,263,-58
1990,08260,Santa Perpètua de Mogoda,Barcelona,120,86,34
1990,08263,Sant Vicenç dels Horts,Barcelona,96,129,-33
1990,08266,Cerdanyola del Vallès,Barcelona,383,434,-51
1990,08270,Sitges,Barcelona,133,95,38
1990,08279,Terrassa,Barcelona,599,687,-88
1990,08285,Torelló,Barcelona,45,36,9
1990,08298,Vic,Barcelona,124,113,11
1990,08301,Viladecans,Barcelona,321,379,-58
1990,08305,Vilafranca del Penedès,Barcelona,167,159,8
1990,08307,Vilanova i la Geltrú,Barcelona,343,294,49
1990,09018,Aranda de Duero,Burgos,247,420,-173
1990,09059,Burgos,Burgos,1200,1638,-438
1990,09219,Miranda de Ebro,Burgos,516,451,65
1990,10037,Cáceres,Cáceres,832,896,-64
1990,10067,Coria,Cáceres,136,215,-79
1990,10131,Navalmoral de la Mata,Cáceres,219,275,-56
1990,10148,Plasencia,Cáceres,329,466,-137
1990,11004,Algeciras,Cádiz,1012,1081,-69
1990,11006,Arcos de la Frontera,Cádiz,111,296,-185
1990,11007,Barbate,Cádiz,159,463,-304
1990,11008,Los Barrios,Cádiz,154,109,45
1990,11012,Cádiz,Cádiz,792,1166,-374
1990,11014,Conil de la Frontera,Cádiz,57,59,-2
1990,11015,Chiclana de la Frontera,Cádiz,295,190,105
1990,11016,Chipiona,Cádiz,95,80,15
1990,11020,Jerez de la Frontera,Cádiz,1152,1533,-381
1990,11022,La Línea de la Concepción,Cádiz,411,559,-148
1990,11023,Medina-Sidonia,Cádiz,56,83,-27
1990,11027,El Puerto de Santa María,Cádiz,762,578,184
1990,11028,Puerto Real,Cádiz,167,112,55
1990,11030,Rota,Cádiz,225,160,65
1990,11031,San Fernando,Cádiz,673,844,-171
1990,11032,Sanlúcar de Barrameda,Cádiz,257,195,62
1990,11033,San Roque,Cádiz,213,269,-56
1990,11035,Tarifa,Cádiz,194,148,46
1990,11038,Ubrique,Cádiz,81,87,-6
1990,11039,Vejer de la Frontera,Cádiz,44,85,-41
1990,11041,Villamartín,Cádiz,76,139,-63
1990,12009,Almassora,Castellón,108,73,35
1990,12027,Benicarló,Castellón,247,173,74
1990,12032,Borriana/Burriana,Castellón,159,113,46
1990,12040,Castellón de la Plana/Castelló de la Plana,Castellón,1834,1115,719
1990,12082,Nules,Castellón,48,47,1
1990,12084,Onda,Castellón,75,39,36
1990,12126,La Vall d'Uixó,Castellón,116,97,19
1990,12135,Vila-real,Castellón,284,189,95
1990,12138,Vinaròs,Castellón,376,199,177
1990,13005,Alcázar de San Juan,Ciudad Real,307,292,15
1990,13023,Bolaños de Calatrava,Ciudad Real,20,52,-32
1990,13028,Campo de Criptana,Ciudad Real,116,98,18
1990,13034,Ciudad Real,Ciudad Real,732,749,-17
1990,13039,Daimiel,Ciudad Real,92,156,-64
1990,13053,Manzanares,Ciudad Real,185,243,-58
1990,13071,Puertollano,Ciudad Real,404,881,-477
1990,13078,Socuéllamos,Ciudad Real,94,169,-75
1990,13079,La Solana,Ciudad Real,43,76,-33
1990,13082,Tomelloso,Ciudad Real,112,176,-64
1990,13087,Valdepeñas,Ciudad Real,192,286,-94
1990,14002,Aguilar de la Frontera,Córdoba,80,79,1
1990,14007,Baena,Córdoba,137,206,-69
1990,14013,Cabra,Córdoba,149,252,-103
1990,14021,Córdoba,Córdoba,2367,2814,-447
1990,14038,Lucena,Córdoba,246,199,47
1990,14042,Montilla,Córdoba,120,174,-54
1990,14049,Palma del Río,Córdoba,190,231,-41
1990,14052,Peñarroya-Pueblonuevo,Córdoba,98,130,-32
1990,14054,Pozoblanco,Córdoba,111,136,-25
1990,14055,Priego de Córdoba,Córdoba,151,225,-74
1990,14056,Puente Genil,Córdoba,207,298,-91
1990,14069,Villanueva de Córdoba,Córdoba,51,120,-69
1990,15002,Ames,A Coruña,80,36,44
1990,15005,Arteixo,A Coruña,106,64,42
1990,15009,Betanzos,A Coruña,25,56,-31
1990,15011,Boiro,A Coruña,114,73,41
1990,15017,Cambre,A Coruña,99,67,32
1990,15019,Carballo,A Coruña,80,94,-14
1990,15029,Coristanco,A Coruña,11,18,-7
1990,15030,A Coruña,A Coruña,1996,1620,376
1990,15031,Culleredo,A Coruña,69,41,28
1990,15035,Fene,A Coruña,45,74,-29
1990,15036,Ferrol,A Coruña,637,920,-283
1990,15041,A Laracha,A Coruña,31,24,7
1990,15053,Muros,A Coruña,81,82,-1
1990,15054,Narón,A Coruña,134,151,-17
1990,15057,Noia,A Coruña,56,93,-37
1990,15058,Oleiros,A Coruña,233,132,101
1990,15059,Ordes,A Coruña,52,37,15
1990,15061,Ortigueira,A Coruña,12,37,-25
1990,15062,Outes,A Coruña,23,24,-1
1990,15065,Padrón,A Coruña,52,86,-34
1990,15067,A Pobra do Caramiñal,A Coruña,18,40,-22
1990,15070,As Pontes de García Rodríguez,A Coruña,142,151,-9
1990,15071,Porto do Son,A Coruña,51,70,-19
1990,15072,Rianxo,A Coruña,63,106,-43
1990,15073,Ribeira,A Coruña,128,126,2
1990,15077,Santa Comba,A Coruña,16,28,-12
1990,15078,Santiago de Compostela,A Coruña,829,570,259
1990,15082,Teo,A Coruña,93,54,39
1990,16078,Cuenca,Cuenca,478,591,-113
1990,16203,Tarancón,Cuenca,155,113,42
1990,17015,Banyoles,Girona,129,79,50
1990,17023,Blanes,Girona,647,311,336
1990,17066,Figueres,Girona,470,397,73
1990,17079,Girona,Girona,1007,702,305
1990,17095,Lloret de Mar,Girona,712,439,273
1990,17114,Olot,Girona,263,212,51
1990,17117,Palafrugell,Girona,274,181,93
1990,17118,Palamós,Girona,212,96,116
1990,17147,Ripoll,Girona,91,129,-38
1990,17152,Roses,Girona,297,202,95
1990,17155,Salt,Girona,336,170,166
1990,17160,Sant Feliu de Guíxols,Girona,216,132,84
1990,18017,Almuñécar,Granada,171,141,30
1990,18021,Armilla,Granada,126,73,53
1990,18022,Atarfe,Granada,88,62,26
1990,18023,Baza,Granada,167,261,-94
1990,18087,Granada,Granada,3486,2682,804
1990,18089,Guadix,Granada,223,267,-44
1990,18098,Huéscar,Granada,95,181,-86
1990,18102,Illora,Granada,76,114,-38
1990,18122,Loja,Granada,177,217,-40
1990,18127,Maracena,Granada,111,59,52
1990,18140,Motril,Granada,428,377,51
1990,18158,Pinos Puente,Granada,62,97,-35
1990,18175,Santa Fe,Granada,99,98,1
1990,19046,Azuqueca de Henares,Guadalajara,388,176,212
1990,19130,Guadalajara,Guadalajara,1100,815,285
1990,20009,Andoain,Guipúzcoa,78,135,-57
1990,20017,Azkoitia,Guipúzcoa,35,36,-1
1990,20018,Azpeitia,Guipúzcoa,49,45,4
1990,20019,Beasain,Guipúzcoa,57,112,-55
1990,20030,Eibar,Guipúzcoa,184,470,-286
1990,20032,Elgoibar,Guipúzcoa,40,152,-112
1990,20036,Hondarribia,Guipúzcoa,50,74,-24
1990,20040,Hernani,Guipúzcoa,59,132,-73
1990,20045,Irun,Guipúzcoa,423,676,-253
1990,20051,Legazpi,Guipúzcoa,38,158,-120
1990,20055,Arrasate/Mondragón,Guipúzcoa,121,294,-173
1990,20059,Oñati,Guipúzcoa,37,96,-59
1990,20064,Pasaia,Guipúzcoa,43,212,-169
1990,20067,Errenteria,Guipúzcoa,196,369,-173
1990,20069,Donostia/San Sebastián,Guipúzcoa,1291,1505,-214
1990,20071,Tolosa,Guipúzcoa,68,98,-30
1990,20074,Bergara,Guipúzcoa,63,97,-34
1990,20079,Zarautz,Guipúzcoa,127,121,6
1990,20080,Zumarraga,Guipúzcoa,55,154,-99
1990,20902,Lasarte-Oria,Guipúzcoa,97,213,-116
1990,21005,Almonte,Huelva,250,153,97
1990,21010,Ayamonte,Huelva,116,134,-18
1990,21013,Bollullos Par del Condado,Huelva,64,32,32
1990,21021,Cartaya,Huelva,114,72,42
1990,21041,Huelva,Huelva,1001,935,66
1990,21042,Isla Cristina,Huelva,131,107,24
1990,21044,Lepe,Huelva,104,105,-1
1990,21050,Moguer,Huelva,124,88,36
1990,21060,Punta Umbría,Huelva,99,49,50
1990,21072,Valverde del Camino,Huelva,70,56,14
1990,22048,Barbastro,Huesca,161,148,13
1990,22112,Fraga,Huesca,135,130,5
1990,22125,Huesca,Huesca,560,501,59
1990,22130,Jaca,Huesca,258,183,75
1990,22158,Monzón,Huesca,190,155,35
1990,23002,Alcalá la Real,Jaén,288,385,-97
1990,23003,Alcaudete,Jaén,92,153,-61
1990,23005,Andújar,Jaén,357,486,-129
1990,23009,Baeza,Jaén,115,109,6
1990,23010,Bailén,Jaén,74,141,-67
1990,23024,La Carolina,Jaén,128,166,-38
1990,23050,Jaén,Jaén,745,1068,-323
1990,23053,Jódar,Jaén,290,289,1
1990,23055,Linares,Jaén,537,838,-301
1990,23060,Martos,Jaén,130,138,-8
1990,23086,Torredelcampo,Jaén,48,38,10
1990,23087,Torredonjimeno,Jaén,88,54,34
1990,23092,Úbeda,Jaén,250,350,-100
1990,23095,Villacarrillo,Jaén,114,228,-114
1990,24008,Astorga,León,141,202,-61
1990,24014,Bembibre,León,130,186,-56
1990,24089,León,León,1197,1383,-186
1990,24115,Ponferrada,León,392,688,-296
1990,24142,San Andrés del Rabanedo,León,186,148,38
1990,24202,Villablino,León,90,193,-103
1990,25040,Balaguer,Lleida,90,74,16
1990,25120,Lleida,Lleida,980,1092,-112
1990,25203,La Seu d'Urgell,Lleida,294,229,65
1990,25217,Tàrrega,Lleida,134,93,41
1990,26018,Arnedo,La Rioja,71,62,9
1990,26036,Calahorra,La Rioja,205,185,20
1990,26089,Logroño,La Rioja,1495,1233,262
1990,27013,Cervo,Lugo,157,158,-1
1990,27016,Chantada,Lugo,89,103,-14
1990,27028,Lugo,Lugo,634,623,11
1990,27031,Monforte de Lemos,Lugo,174,209,-35
1990,27057,Sarria,Lugo,67,80,-13
1990,27065,Vilalba,Lugo,109,123,-14
1990,27066,Viveiro,Lugo,131,78,53
1990,28005,Alcalá de Henares,Madrid,2050,1828,222
1990,28006,Alcobendas,Madrid,672,450,222
1990,28007,Alcorcón,Madrid,1018,919,99
1990,28013,Aranjuez,Madrid,319,341,-22
1990,28014,Arganda del Rey,Madrid,194,99,95
1990,28022,Boadilla del Monte,Madrid,144,98,46
1990,28040,Ciempozuelos,Madrid,71,46,25
1990,28045,Colmenar Viejo,Madrid,614,276,338
1990,28047,Collado Villalba,Madrid,579,262,317
1990,28049,Coslada,Madrid,388,398,-10
1990,28058,Fuenlabrada,Madrid,1770,1434,336
1990,28065,Getafe,Madrid,919,805,114
1990,28074,Leganés,Madrid,1152,941,211
1990,28079,Madrid,Madrid,26340,21419,4921
1990,28080,Majadahonda,Madrid,433,336,97
1990,28084,Mejorada del Campo,Madrid,153,107,46
1990,28092,Móstoles,Madrid,1669,1564,105
1990,28106,Parla,Madrid,630,544,86
1990,28113,Pinto,Madrid,221,131,90
1990,28115,Pozuelo de Alarcón,Madrid,483,267,216
1990,28123,Rivas-Vaciamadrid,Madrid,97,49,48
1990,28127,Las Rozas de Madrid,Madrid,632,286,346
1990,28130,San Fernando de Henares,Madrid,189,167,22
1990,28134,San Sebastián de los Reyes,Madrid,389,286,103
1990,28148,Torrejón de Ardoz,Madrid,668,708,-40
1990,28161,Valdemoro,Madrid,315,398,-83
1990,28181,Villaviciosa de Odón,Madrid,86,49,37
1990,29007,Alhaurín de la Torre,Málaga,158,47,111
1990,29008,Alhaurín el Grande,Málaga,29,26,3
1990,29012,Álora,Málaga,58,20,38
1990,29015,Antequera,Málaga,234,227,7
1990,29017,Archidona,Málaga,44,52,-8
1990,29025,Benalmádena,Málaga,460,198,262
1990,29038,Cártama,Málaga,60,30,30
1990,29042,Coín,Málaga,67,30,37
1990,29051,Estepona,Málaga,777,323,454
1990,29054,Fuengirola,Málaga,950,441,509
1990,29067,Málaga,Málaga,3593,2517,1076
1990,29069,Marbella,Málaga,1399,972,427
1990,29070,Mijas,Málaga,384,128,256
1990,29075,Nerja,Málaga,130,90,40
1990,29082,Rincón de la Victoria,Málaga,235,61,174
1990,29084,Ronda,Málaga,371,368,3
1990,29091,Torrox,Málaga,56,24,32
1990,29094,Vélez-Málaga,Málaga,439,289,150
1990,29901,Torremolinos,Málaga,533,139,394
1990,30002,Abarán,Murcia,20,34,-14
1990,30003,Águilas,Murcia,465,365,100
1990,30005,Alcantarilla,Murcia,265,208,57
1990,30008,Alhama de Murcia,Murcia,67,49,18
1990,30009,Archena,Murcia,69,45,24
1990,30012,Bullas,Murcia,58,31,27
1990,30015,Caravaca de la Cruz,Murcia,155,151,4
1990,30016,Cartagena,Murcia,1523,1741,-218
1990,30017,Cehegín,Murcia,53,36,17
1990,30019,Cieza (Murcia),Murcia,67,112,-45
1990,30022,Jumilla,Murcia,111,103,8
1990,30024,Lorca,Murcia,353,359,-6
1990,30026,Mazarrón,Murcia,190,151,39
1990,30027,Molina de Segura,Murcia,315,187,128
1990,30028,Moratalla,Murcia,31,44,-13
1990,30029,Mula,Murcia,54,64,-10
1990,30030,Murcia,Murcia,2241,1662,579
1990,30035,San Javier,Murcia,457,393,64
1990,30036,San Pedro del Pinatar,Murcia,285,249,36
1990,30037,Torre-Pacheco,Murcia,158,95,63
1990,30038,Las Torres de Cotillas,Murcia,100,86,14
1990,30039,Totana,Murcia,70,39,31
1990,30041,La Unión,Murcia,71,98,-27
1990,30043,Yecla,Murcia,176,190,-14
1990,31016,Ansoáin/Antsoain,Navarra,82,39,43
1990,31060,Burlada/Burlata,Navarra,110,84,26
1990,31097,Estella-Lizarra,Navarra,153,144,9
1990,31201,Pamplona/Iruña,Navarra,1632,1158,474
1990,31227,Tafalla,Navarra,53,63,-10
1990,31232,Tudela,Navarra,286,297,-11
1990,31901,Barañain,Navarra,162,112,50
1990,32009,O Barco de Valdeorras,Ourense,127,127,0
1990,32019,O Carballiño,Ourense,108,126,-18
1990,32032,Xinzo de Limia,Ourense,78,92,-14
1990,32054,Ourense,Ourense,693,1284,-591
1990,32085,Verín,Ourense,140,99,41
1990,33002,Aller,Asturias,17,59,-42
1990,33004,Avilés,Asturias,502,545,-43
1990,33011,Cangas del Narcea,Asturias,61,153,-92
1990,33014,Carreño,Asturias,46,48,-2
1990,33016,Castrillón,Asturias,113,105,8
1990,33020,Corvera de Asturias,Asturias,65,106,-41
1990,33024,Gijón,Asturias,1634,1431,203
1990,33025,Gozón,Asturias,44,38,6
1990,33026,Grado,Asturias,21,29,-8
1990,33031,Langreo,Asturias,111,206,-95
1990,33032,Laviana,Asturias,35,29,6
1990,33033,Lena,Asturias,71,83,-12
1990,33034,Valdés,Asturias,45,79,-34
1990,33035,Llanera,Asturias,30,40,-10
1990,33036,Llanes,Asturias,60,79,-19
1990,33037,Mieres (Asturias),Asturias,104,269,-165
1990,33044,Oviedo,Asturias,1216,1234,-18
1990,33049,Piloña,Asturias,28,27,1
1990,33051,Pravia,Asturias,41,37,4
1990,33060,San Martín del Rey Aurelio,Asturias,65,67,-2
1990,33066,Siero,Asturias,176,136,40
1990,33073,Tineo,Asturias,32,42,-10
1990,33076,Villaviciosa,Asturias,31,30,1
1990,34120,Palencia,Palencia,742,982,-240
1990,35002,Agüimes,Las Palmas,60,78,-18
1990,35004,Arrecife,Las Palmas,695,1346,-651
1990,35006,Arucas,Las Palmas,66,73,-7
1990,35009,Gáldar,Las Palmas,30,45,-15
1990,35011,Ingenio,Las Palmas,55,23,32
1990,35012,Mogán,Las Palmas,130,121,9
1990,35016,Las Palmas de Gran Canaria,Las Palmas,3298,3854,-556
1990,35017,Puerto del Rosario,Las Palmas,464,520,-56
1990,35019,San Bartolomé de Tirajana,Las Palmas,420,488,-68
1990,35021,Santa Brígida,Las Palmas,84,77,7
1990,35022,Santa Lucía de Tirajana,Las Palmas,154,152,2
1990,35023,Santa María de Guía de Gran Canaria,Las Palmas,25,16,9
1990,35026,Telde,Las Palmas,308,274,34
1990,35027,Teror,Las Palmas,13,15,-2
1990,36003,Baiona,Pontevedra,15,35,-20
1990,36004,Bueu,Pontevedra,25,25,0
1990,36006,Cambados,Pontevedra,53,81,-28
1990,36008,Cangas,Pontevedra,53,63,-10
1990,36017,A Estrada,Pontevedra,99,133,-34
1990,36021,Gondomar,Pontevedra,14,17,-3
1990,36022,O Grove,Pontevedra,54,93,-39
1990,36023,A Guarda,Pontevedra,42,66,-24
1990,36024,Lalín,Pontevedra,128,114,14
1990,36026,Marín,Pontevedra,198,172,26
1990,36029,Moaña,Pontevedra,30,72,-42
1990,36033,Mos,Pontevedra,33,51,-18
1990,36035,Nigrán,Pontevedra,42,28,14
1990,36038,Pontevedra,Pontevedra,708,620,88
1990,36039,O Porriño,Pontevedra,72,60,12
1990,36041,Poio,Pontevedra,82,56,26
1990,36042,Ponteareas,Pontevedra,118,114,4
1990,36045,Redondela,Pontevedra,92,135,-43
1990,36051,Sanxenxo,Pontevedra,58,81,-23
1990,36052,Silleda,Pontevedra,29,61,-32
1990,36054,Tomiño,Pontevedra,46,63,-17
1990,36055,Tui,Pontevedra,133,96,37
1990,36057,Vigo,Pontevedra,2339,1629,710
1990,36060,Vilagarcía de Arousa,Pontevedra,280,195,85
1990,36061,Vilanova de Arousa,Pontevedra,87,54,33
1990,37046,Béjar,Salamanca,110,197,-87
1990,37107,Ciudad Rodrigo,Salamanca,181,192,-11
1990,37274,Salamanca,Salamanca,1969,1904,65
1990,38001,Adeje,Santa Cruz de Tenerife,206,257,-51
1990,38006,Arona,Santa Cruz de Tenerife,628,720,-92
1990,38017,Granadilla de Abona,Santa Cruz de Tenerife,311,378,-67
1990,38019,Guía de Isora,Santa Cruz de Tenerife,52,122,-70
1990,38020,Güímar,Santa Cruz de Tenerife,58,29,29
1990,38022,Icod de los Vinos,Santa Cruz de Tenerife,58,30,28
1990,38023,San Cristóbal de La Laguna,Santa Cruz de Tenerife,629,399,230
1990,38024,Los Llanos de Aridane,Santa Cruz de Tenerife,123,110,13
1990,38026,La Orotava,Santa Cruz de Tenerife,86,75,11
1990,38028,Puerto de la Cruz,Santa Cruz de Tenerife,257,193,64
1990,38031,Los Realejos,Santa Cruz de Tenerife,46,58,-12
1990,38037,Santa Cruz de la Palma,Santa Cruz de Tenerife,195,226,-31
1990,38038,Santa Cruz de Tenerife,Santa Cruz de Tenerife,2146,1960,186
1990,38043,Tacoronte,Santa Cruz de Tenerife,38,30,8
1990,39008,El Astillero,Cantabria,61,82,-21
1990,39016,Camargo,Cantabria,79,53,26
1990,39020,Castro-Urdiales,Cantabria,211,158,53
1990,39035,Laredo,Cantabria,157,126,31
1990,39059,Reinosa,Cantabria,70,125,-55
1990,39075,Santander,Cantabria,1405,1343,62
1990,39079,Santoña,Cantabria,105,99,6
1990,39087,Torrelavega,Cantabria,234,322,-88
1990,40194,Segovia,Segovia,618,681,-63
1990,41004,Alcalá de Guadaíra,Sevilla,367,241,126
1990,41007,La Algaba,Sevilla,18,9,9
1990,41011,Arahal,Sevilla,66,36,30
1990,41018,Brenes,Sevilla,98,55,43
1990,41020,Las Cabezas de San Juan,Sevilla,79,115,-36
1990,41021,Camas,Sevilla,145,126,19
1990,41024,Carmona,Sevilla,104,134,-30
1990,41029,Castilleja de la Cuesta,Sevilla,114,59,55
1990,41034,Coria del Río,Sevilla,118,95,23
1990,41038,Dos Hermanas,Sevilla,916,428,488
1990,41039,Écija,Sevilla,215,280,-65
1990,41041,Estepa,Sevilla,65,57,8
1990,41053,Lebrija,Sevilla,324,153,171
1990,41055,Lora del Río,Sevilla,117,179,-62
1990,41058,Mairena del Alcor,Sevilla,60,10,50
1990,41059,Mairena del Aljarafe,Sevilla,420,97,323
1990,41060,Marchena,Sevilla,49,81,-32
1990,41065,Morón de la Frontera,Sevilla,203,324,-121
1990,41068,Osuna,Sevilla,85,88,-3
1990,41069,Los Palacios y Villafranca,Sevilla,106,56,50
1990,41075,Pilas,Sevilla,45,23,22
1990,41077,La Puebla de Cazalla,Sevilla,116,179,-63
1990,41079,La Puebla del Río,Sevilla,56,54,2
1990,41081,La Rinconada,Sevilla,154,109,45
1990,41086,San Juan de Aznalfarache,Sevilla,201,126,75
1990,41091,Sevilla,Sevilla,5023,3533,1490
1990,41093,Tomares,Sevilla,135,66,69
1990,41095,Utrera,Sevilla,243,217,26
1990,41102,El Viso del Alcor,Sevilla,27,10,17
1990,42173,Soria,Soria,374,519,-145
1990,43014,Amposta,Tarragona,101,91,10
1990,43038,Cambrils,Tarragona,333,158,175
1990,43123,Reus,Tarragona,927,587,340
1990,43136,Sant Carles de la Ràpita,Tarragona,112,74,38
1990,43148,Tarragona,Tarragona,1415,1047,368
1990,43155,Tortosa,Tarragona,231,231,0
1990,43161,Valls,Tarragona,176,136,40
1990,43163,El Vendrell,Tarragona,475,274,201
1990,43171,Vila-seca,Tarragona,223,237,-14
1990,43901,Deltebre,Tarragona,37,28,9
1990,44013,Alcañiz,Teruel,122,190,-68
1990,44216,Teruel,Teruel,462,449,13
1990,45053,Consuegra,Toledo,77,79,-2
1990,45087,Madridejos,Toledo,61,80,-19
1990,45165,Talavera de la Reina,Toledo,697,724,-27
1990,45168,Toledo,Toledo,883,744,139
1990,46005,Alaquàs,Valencia,100,70,30
1990,46013,Alboraya,Valencia,101,57,44
1990,46017,Alzira,Valencia,221,147,74
1990,46019,L'Alcúdia,Valencia,17,16,1
1990,46021,Aldaia,Valencia,113,69,44
1990,46022,Alfafar,Valencia,111,99,12
1990,46029,Algemesí,Valencia,97,103,-6
1990,46031,Alginet,Valencia,35,33,2
1990,46054,Benetússer,Valencia,97,55,42
1990,46060,Benifaió,Valencia,41,19,22
1990,46078,Burjassot,Valencia,221,234,-13
1990,46081,Canals,Valencia,26,22,4
1990,46083,Carcaixent,Valencia,56,73,-17
1990,46085,Carlet,Valencia,61,54,7
1990,46094,Catarroja,Valencia,58,42,16
1990,46102,Quart de Poblet,Valencia,124,110,14
1990,46105,Cullera,Valencia,159,112,47
1990,46110,Xirivella,Valencia,200,107,93
1990,46131,Gandia,Valencia,525,352,173
1990,46145,Xátiva,Valencia,100,113,-13
1990,46147,Llíria,Valencia,99,76,23
1990,46159,Manises,Valencia,118,86,32
1990,46164,Massamagrell,Valencia,114,62,52
1990,46169,Mislata,Valencia,278,192,86
1990,46171,Moncada,Valencia,99,97,2
1990,46181,Oliva,Valencia,126,100,26
1990,46184,Ontinyent,Valencia,121,112,9
1990,46186,Paiporta,Valencia,109,66,43
1990,46190,Paterna,Valencia,338,253,85
1990,46194,Picassent,Valencia,61,25,36
1990,46205,Puçol,Valencia,103,58,45
1990,46213,Requena,Valencia,79,182,-103
1990,46220,Sagunto/Sagunt,Valencia,434,385,49
1990,46230,Silla,Valencia,88,92,-4
1990,46235,Sueca,Valencia,72,70,2
1990,46238,Tavernes de la Valldigna,Valencia,36,44,-8
1990,46244,Torrent (Valencia),Valencia,268,259,9
1990,46249,Utiel,Valencia,84,54,30
1990,46250,València,Valencia,5830,4622,1208
1990,47076,Laguna de Duero,Valladolid,224,130,94
1990,47085,Medina del Campo,Valladolid,205,276,-71
1990,47186,Valladolid,Valladolid,3137,3286,-149
1990,48003,Amorebieta-Etxano,Vizcaya,46,95,-49
1990,48013,Barakaldo,Vizcaya,476,1083,-607
1990,48015,Basauri,Vizcaya,234,483,-249
1990,48017,Bermeo,Vizcaya,49,90,-41
1990,48020,Bilbao,Vizcaya,2301,3733,-1432
1990,48027,Durango,Vizcaya,122,188,-66
1990,48034,Ermua,Vizcaya,134,423,-289
1990,48036,Galdakao,Vizcaya,144,255,-111
1990,48044,Getxo,Vizcaya,609,751,-142
1990,48046,Gernika-Lumo,Vizcaya,50,65,-15
1990,48054,Leioa,Vizcaya,119,200,-81
1990,48069,Mungia,Vizcaya,55,62,-7
1990,48073,Ondarroa,Vizcaya,56,143,-87
1990,48078,Portugalete,Vizcaya,240,481,-241
1990,48080,Valle de Trápaga-Trapagaran,Vizcaya,59,84,-25
1990,48082,Santurtzi,Vizcaya,254,555,-301
1990,48084,Sestao,Vizcaya,113,355,-242
1990,48902,Erandio,Vizcaya,118,179,-61
1990,49021,Benavente,Zamora,230,236,-6
1990,49275,Zamora,Zamora,561,823,-262
1990,50067,Calatayud,Zaragoza,145,187,-42
1990,50095,Ejea de los Caballeros,Zaragoza,65,82,-17
1990,50251,Tarazona,Zaragoza,54,133,-79
1990,50297,Zaragoza,Zaragoza,5052,3879,1173
1990,51001,Ceuta,Ceuta,1030,1148,-118
1990,52001,Melilla,Melilla,1207,1140,67
1991,01036,Laudio/Llodio,Álava,95,149,-54
1991,01059,Vitoria-Gasteiz,Álava,1564,1135,429
1991,02003,Albacete,Albacete,1160,828,332
1991,02009,Almansa,Albacete,96,171,-75
1991,02037,Hellín,Albacete,244,239,5
1991,02069,La Roda,Albacete,67,113,-46
1991,02081,Villarrobledo,Albacete,135,91,44
1991,03009,Alcoy/Alcoi,Alicante,169,332,-163
1991,03014,Alicante/Alacant,Alicante,1420,1413,7
1991,03015,Almoradí,Alicante,38,66,-28
1991,03018,Altea,Alicante,71,88,-17
1991,03019,Aspe,Alicante,41,45,-4
1991,03031,Benidorm,Alicante,568,629,-61
1991,03047,Calp,Alicante,110,162,-52
1991,03049,Callosa de Segura,Alicante,35,92,-57
1991,03050,El Campello,Alicante,92,46,46
1991,03056,Cocentaina,Alicante,51,48,3
1991,03059,Crevillent,Alicante,36,45,-9
1991,03063,Dénia,Alicante,290,270,20
1991,03065,Elche/Elx,Alicante,567,475,92
1991,03066,Elda,Alicante,115,165,-50
1991,03079,Ibi,Alicante,75,113,-38
1991,03082,Jávea/Xàbia,Alicante,80,189,-109
1991,03089,Monóvar/Monòver,Alicante,43,32,11
1991,03090,Mutxamel,Alicante,62,25,37
1991,03093,Novelda,Alicante,71,62,9
1991,03099,Orihuela,Alicante,196,383,-187
1991,03104,Petrer,Alicante,51,67,-16
1991,03119,Sant Joan d'Alacant,Alicante,97,94,3
1991,03121,Santa Pola,Alicante,179,87,92
1991,03122,San Vicente del Raspeig/Sant Vicent del Raspeig,Alicante,155,94,61
1991,03133,Torrevieja,Alicante,790,393,397
1991,03139,Villajoyosa/La Vila Joiosa,Alicante,152,173,-21
1991,03140,Villena,Alicante,115,108,7
1991,04003,Adra,Almería,101,96,5
1991,04006,Albox,Almería,17,50,-33
1991,04013,Almería,Almería,949,856,93
1991,04029,Berja,Almería,43,28,15
1991,04053,Huércal-Overa,Almería,91,93,-2
1991,04066,Níjar,Almería,36,35,1
1991,04079,Roquetas de Mar,Almería,416,201,215
1991,04102,Vícar,Almería,107,75,32
1991,04902,El Ejido,Almería,251,265,-14
1991,05019,Ávila,Ávila,324,405,-81
1991,06011,Almendralejo,Badajoz,127,116,11
1991,06015,Badajoz,Badajoz,961,760,201
1991,06044,Don Benito,Badajoz,208,233,-25
1991,06070,Jerez de los Caballeros,Badajoz,56,27,29
1991,06083,Mérida,Badajoz,282,338,-56
1991,06088,Montijo,Badajoz,112,79,33
1991,06095,Olivenza,Badajoz,59,67,-8
1991,06149,Villafranca de los Barros,Badajoz,49,42,7
1991,06153,Villanueva de la Serena,Badajoz,202,94,108
1991,06158,Zafra,Badajoz,93,78,15
1991,07011,Calvià,Baleares,602,421,181
1991,07015,Ciutadella de Menorca,Baleares,156,292,-136
1991,07022,Felanitx,Baleares,109,140,-31
1991,07026,Eivissa,Baleares,438,535,-97
1991,07027,Inca,Baleares,70,108,-38
1991,07031,Llucmajor,Baleares,197,130,67
1991,07032,Maó-Mahón,Baleares,457,441,16
1991,07033,Manacor,Baleares,188,228,-40
1991,07036,Marratxí,Baleares,40,26,14
1991,07040,Palma,Baleares,3062,2601,461
1991,07042,Pollença,Baleares,68,100,-32
1991,07044,Sa Pobla,Baleares,15,22,-7
1991,07046,Sant Antoni de Portmany,Baleares,33,228,-195
1991,07054,Santa Eulària des Riu,Baleares,819,259,560
1991,07061,Sóller,Baleares,17,14,3
1991,08006,Arenys de Mar,Barcelona,53,44,9
1991,08015,Badalona,Barcelona,502,942,-440
1991,08019,Barcelona,Barcelona,3691,7433,-3742
1991,08022,Berga,Barcelona,79,45,34
1991,08033,Caldes de Montbui,Barcelona,26,26,0
1991,08035,Calella,Barcelona,99,84,15
1991,08041,Canovelles,Barcelona,40,61,-21
1991,08051,Castellar del Vallès,Barcelona,60,56,4
1991,08056,Castelldefels,Barcelona,209,258,-49
1991,08073,Cornellà de Llobregat,Barcelona,241,419,-178
1991,08076,Esparreguera,Barcelona,57,57,0
1991,08077,Esplugues de Llobregat,Barcelona,190,225,-35
1991,08086,Les Franqueses del Vallès,Barcelona,46,46,0
1991,08089,Gavà,Barcelona,153,229,-76
1991,08096,Granollers,Barcelona,258,200,58
1991,08101,L'Hospitalet de Llobregat,Barcelona,666,1264,-598
1991,08102,Igualada,Barcelona,47,82,-35
1991,08105,La Llagosta,Barcelona,35,62,-27
1991,08110,Malgrat de Mar,Barcelona,92,72,20
1991,08112,Manlleu,Barcelona,58,46,12
1991,08113,Manresa,Barcelona,150,199,-49
1991,08114,Martorell,Barcelona,61,73,-12
1991,08118,El Masnou,Barcelona,85,80,5
1991,08121,Mataró,Barcelona,258,493,-235
1991,08123,Molins de Rei,Barcelona,39,50,-11
1991,08124,Mollet del Vallès,Barcelona,173,173,0
1991,08125,Montcada i Reixac,Barcelona,33,147,-114
1991,08136,Montornès del Vallès,Barcelona,49,58,-9
1991,08147,Olesa de Montserrat,Barcelona,12,44,-32
1991,08159,Parets del Vallès,Barcelona,56,47,9
1991,08163,Pineda de Mar,Barcelona,186,138,48
1991,08169,El Prat de Llobregat,Barcelona,279,303,-24
1991,08172,Premià de Mar,Barcelona,87,124,-37
1991,08180,Ripollet,Barcelona,82,110,-28
1991,08184,Rubí,Barcelona,179,296,-117
1991,08187,Sabadell,Barcelona,798,750,48
1991,08194,Sant Adrià de Besòs,Barcelona,98,136,-38
1991,08196,Sant Andreu de la Barca,Barcelona,80,115,-35
1991,08200,Sant Boi de Llobregat,Barcelona,222,459,-237
1991,08202,Sant Celoni,Barcelona,46,51,-5
1991,08205,Sant Cugat del Vallès,Barcelona,148,187,-39
1991,08211,Sant Feliu de Llobregat,Barcelona,147,234,-87
1991,08217,Sant Joan Despí,Barcelona,92,140,-48
1991,08219,Vilassar de Mar,Barcelona,76,74,2
1991,08221,Sant Just Desvern,Barcelona,42,57,-15
1991,08231,Sant Pere de Ribes,Barcelona,100,91,9
1991,08245,Santa Coloma de Gramenet,Barcelona,314,656,-342
1991,08252,Barberà del Vallès,Barcelona,143,175,-32
1991,08260,Santa Perpètua de Mogoda,Barcelona,45,77,-32
1991,08263,Sant Vicenç dels Horts,Barcelona,56,69,-13
1991,08266,Cerdanyola del Vallès,Barcelona,247,364,-117
1991,08270,Sitges,Barcelona,90,60,30
1991,08279,Terrassa,Barcelona,339,462,-123
1991,08285,Torelló,Barcelona,12,19,-7
1991,08298,Vic,Barcelona,76,100,-24
1991,08301,Viladecans,Barcelona,187,255,-68
1991,08305,Vilafranca del Penedès,Barcelona,89,117,-28
1991,08307,Vilanova i la Geltrú,Barcelona,198,238,-40
1991,09018,Aranda de Duero,Burgos,141,216,-75
1991,09059,Burgos,Burgos,588,1085,-497
1991,09219,Miranda de Ebro,Burgos,280,341,-61
1991,10037,Cáceres,Cáceres,527,522,5
1991,10067,Coria,Cáceres,84,105,-21
1991,10131,Navalmoral de la Mata,Cáceres,106,186,-80
1991,10148,Plasencia,Cáceres,191,274,-83
1991,11004,Algeciras,Cádiz,656,732,-76
1991,11006,Arcos de la Frontera,Cádiz,116,204,-88
1991,11007,Barbate,Cádiz,119,235,-116
1991,11008,Los Barrios,Cádiz,93,99,-6
1991,11012,Cádiz,Cádiz,389,717,-328
1991,11014,Conil de la Frontera,Cádiz,68,36,32
1991,11015,Chiclana de la Frontera,Cádiz,178,139,39
1991,11016,Chipiona,Cádiz,64,79,-15
1991,11020,Jerez de la Frontera,Cádiz,994,957,37
1991,11022,La Línea de la Concepción,Cádiz,311,392,-81
1991,11023,Medina-Sidonia,Cádiz,61,40,21
1991,11027,El Puerto de Santa María,Cádiz,444,451,-7
1991,11028,Puerto Real,Cádiz,81,86,-5
1991,11030,Rota,Cádiz,126,126,0
1991,11031,San Fernando,Cádiz,330,517,-187
1991,11032,Sanlúcar de Barrameda,Cádiz,182,159,23
1991,11033,San Roque,Cádiz,138,181,-43
1991,11035,Tarifa,Cádiz,85,158,-73
1991,11038,Ubrique,Cádiz,39,56,-17
1991,11039,Vejer de la Frontera,Cádiz,40,36,4
1991,11041,Villamartín,Cádiz,51,71,-20
1991,12009,Almassora,Castellón,83,47,36
1991,12027,Benicarló,Castellón,142,137,5
1991,12032,Borriana/Burriana,Castellón,95,61,34
1991,12040,Castellón de la Plana/Castelló de la Plana,Castellón,1028,685,343
1991,12082,Nules,Castellón,30,35,-5
1991,12084,Onda,Castellón,50,33,17
1991,12126,La Vall d'Uixó,Castellón,92,85,7
1991,12135,Vila-real,Castellón,162,98,64
1991,12138,Vinaròs,Castellón,223,134,89
1991,13005,Alcázar de San Juan,Ciudad Real,176,213,-37
1991,13023,Bolaños de Calatrava,Ciudad Real,28,14,14
1991,13028,Campo de Criptana,Ciudad Real,51,44,7
1991,13034,Ciudad Real,Ciudad Real,565,358,207
1991,13039,Daimiel,Ciudad Real,106,57,49
1991,13053,Manzanares,Ciudad Real,171,136,35
1991,13071,Puertollano,Ciudad Real,332,411,-79
1991,13078,Socuéllamos,Ciudad Real,75,62,13
1991,13079,La Solana,Ciudad Real,39,29,10
1991,13082,Tomelloso,Ciudad Real,79,108,-29
1991,13087,Valdepeñas,Ciudad Real,125,158,-33
1991,14002,Aguilar de la Frontera,Córdoba,68,68,0
1991,14007,Baena,Córdoba,57,135,-78
1991,14013,Cabra,Córdoba,131,122,9
1991,14021,Córdoba,Córdoba,1919,1672,247
1991,14038,Lucena,Córdoba,266,147,119
1991,14042,Montilla,Córdoba,113,81,32
1991,14049,Palma del Río,Córdoba,162,171,-9
1991,14052,Peñarroya-Pueblonuevo,Córdoba,23,101,-78
1991,14054,Pozoblanco,Córdoba,77,65,12
1991,14055,Priego de Córdoba,Córdoba,207,193,14
1991,14056,Puente Genil,Córdoba,215,151,64
1991,14058,Rute,Córdoba,74,95,-21
1991,14069,Villanueva de Córdoba,Córdoba,27,41,-14
1991,15002,Ames,A Coruña,81,29,52
1991,15005,Arteixo,A Coruña,59,30,29
1991,15009,Betanzos,A Coruña,36,19,17
1991,15011,Boiro,A Coruña,35,31,4
1991,15017,Cambre,A Coruña,61,29,32
1991,15019,Carballo,A Coruña,43,57,-14
1991,15030,A Coruña,A Coruña,1098,887,211
1991,15031,Culleredo,A Coruña,80,18,62
1991,15035,Fene,A Coruña,23,46,-23
1991,15036,Ferrol,A Coruña,352,473,-121
1991,15041,A Laracha,A Coruña,13,4,9
1991,15053,Muros,A Coruña,58,55,3
1991,15054,Narón,A Coruña,76,101,-25
1991,15057,Noia,A Coruña,58,39,19
1991,15058,Oleiros,A Coruña,71,54,17
1991,15059,Ordes,A Coruña,20,28,-8
1991,15065,Padrón,A Coruña,67,54,13
1991,15067,A Pobra do Caramiñal,A Coruña,15,23,-8
1991,15070,As Pontes de García Rodríguez,A Coruña,79,89,-10
1991,15071,Porto do Son,A Coruña,38,47,-9
1991,15072,Rianxo,A Coruña,31,31,0
1991,15073,Ribeira,A Coruña,85,72,13
1991,15077,Santa Comba,A Coruña,12,9,3
1991,15078,Santiago de Compostela,A Coruña,493,279,214
1991,15082,Teo,A Coruña,37,30,7
1991,16078,Cuenca,Cuenca,268,248,20
1991,16203,Tarancón,Cuenca,87,71,16
1991,17015,Banyoles,Girona,52,52,0
1991,17023,Blanes,Girona,363,281,82
1991,17066,Figueres,Girona,260,208,52
1991,17079,Girona,Girona,474,512,-38
1991,17095,Lloret de Mar,Girona,272,205,67
1991,17114,Olot,Girona,115,100,15
1991,17117,Palafrugell,Girona,125,138,-13
1991,17118,Palamós,Girona,70,76,-6
1991,17147,Ripoll,Girona,71,94,-23
1991,17152,Roses,Girona,142,121,21
1991,17155,Salt,Girona,127,111,16
1991,17160,Sant Feliu de Guíxols,Girona,64,114,-50
1991,18003,Albolote,Granada,109,42,67
1991,18017,Almuñécar,Granada,102,82,20
1991,18021,Armilla,Granada,88,58,30
1991,18022,Atarfe,Granada,42,44,-2
1991,18023,Baza,Granada,101,118,-17
1991,18087,Granada,Granada,2696,1590,1106
1991,18089,Guadix,Granada,37,115,-78
1991,18098,Huéscar,Granada,84,96,-12
1991,18102,Illora,Granada,62,46,16
1991,18122,Loja,Granada,139,93,46
1991,18127,Maracena,Granada,44,30,14
1991,18140,Motril,Granada,229,241,-12
1991,18158,Pinos Puente,Granada,22,35,-13
1991,18175,Santa Fe,Granada,53,40,13
1991,19046,Azuqueca de Henares,Guadalajara,308,89,219
1991,19130,Guadalajara,Guadalajara,714,467,247
1991,20009,Andoain,Guipúzcoa,20,85,-65
1991,20017,Azkoitia,Guipúzcoa,12,32,-20
1991,20018,Azpeitia,Guipúzcoa,13,62,-49
1991,20019,Beasain,Guipúzcoa,19,73,-54
1991,20030,Eibar,Guipúzcoa,161,316,-155
1991,20032,Elgoibar,Guipúzcoa,15,90,-75
1991,20036,Hondarribia,Guipúzcoa,35,62,-27
1991,20040,Hernani,Guipúzcoa,21,81,-60
1991,20045,Irun,Guipúzcoa,237,373,-136
1991,20055,Arrasate/Mondragón,Guipúzcoa,59,175,-116
1991,20059,Oñati,Guipúzcoa,16,49,-33
1991,20064,Pasaia,Guipúzcoa,28,167,-139
1991,20067,Errenteria,Guipúzcoa,103,209,-106
1991,20069,Donostia/San Sebastián,Guipúzcoa,515,899,-384
1991,20071,Tolosa,Guipúzcoa,45,75,-30
1991,20074,Bergara,Guipúzcoa,27,88,-61
1991,20079,Zarautz,Guipúzcoa,6,98,-92
1991,20080,Zumarraga,Guipúzcoa,22,109,-87
1991,20902,Lasarte-Oria,Guipúzcoa,38,90,-52
1991,21005,Almonte,Huelva,150,150,0
1991,21010,Ayamonte,Huelva,78,79,-1
1991,21013,Bollullos Par del Condado,Huelva,32,27,5
1991,21021,Cartaya,Huelva,75,35,40
1991,21035,Gibraleón,Huelva,41,24,17
1991,21041,Huelva,Huelva,337,490,-153
1991,21042,Isla Cristina,Huelva,87,85,2
1991,21044,Lepe,Huelva,47,78,-31
1991,21050,Moguer,Huelva,36,32,4
1991,21060,Punta Umbría,Huelva,46,35,11
1991,21072,Valverde del Camino,Huelva,28,12,16
1991,22048,Barbastro,Huesca,102,124,-22
1991,22112,Fraga,Huesca,80,88,-8
1991,22125,Huesca,Huesca,411,331,80
1991,22130,Jaca,Huesca,194,118,76
1991,22158,Monzón,Huesca,85,62,23
1991,23002,Alcalá la Real,Jaén,186,229,-43
1991,23003,Alcaudete,Jaén,86,98,-12
1991,23005,Andújar,Jaén,263,261,2
1991,23009,Baeza,Jaén,59,48,11
1991,23010,Bailén,Jaén,86,59,27
1991,23024,La Carolina,Jaén,87,150,-63
1991,23050,Jaén,Jaén,524,590,-66
1991,23053,Jódar,Jaén,108,150,-42
1991,23055,Linares,Jaén,405,444,-39
1991,23060,Martos,Jaén,135,50,85
1991,23086,Torredelcampo,Jaén,30,33,-3
1991,23087,Torredonjimeno,Jaén,50,44,6
1991,23092,Úbeda,Jaén,224,206,18
1991,23095,Villacarrillo,Jaén,77,130,-53
1991,24008,Astorga,León,42,84,-42
1991,24010,La Bañeza,León,56,65,-9
1991,24014,Bembibre,León,71,79,-8
1991,24089,León,León,302,746,-444
1991,24115,Ponferrada,León,270,515,-245
1991,24142,San Andrés del Rabanedo,León,77,111,-34
1991,24202,Villablino,León,62,112,-50
1991,25040,Balaguer,Lleida,28,50,-22
1991,25120,Lleida,Lleida,533,679,-146
1991,25203,La Seu d'Urgell,Lleida,134,130,4
1991,25217,Tàrrega,Lleida,44,53,-9
1991,26018,Arnedo,La Rioja,26,49,-23
1991,26036,Calahorra,La Rioja,151,127,24
1991,26089,Logroño,La Rioja,766,728,38
1991,27013,Cervo,Lugo,79,87,-8
1991,27016,Chantada,Lugo,50,54,-4
1991,27028,Lugo,Lugo,424,351,73
1991,27031,Monforte de Lemos,Lugo,123,142,-19
1991,27057,Sarria,Lugo,62,46,16
1991,27065,Vilalba,Lugo,70,77,-7
1991,27066,Viveiro,Lugo,72,77,-5
1991,28005,Alcalá de Henares,Madrid,1071,1088,-17
1991,28006,Alcobendas,Madrid,410,282,128
1991,28007,Alcorcón,Madrid,501,539,-38
1991,28009,Algete,Madrid,38,70,-32
1991,28013,Aranjuez,Madrid,184,184,0
1991,28014,Arganda del Rey,Madrid,85,66,19
1991,28022,Boadilla del Monte,Madrid,84,45,39
1991,28040,Ciempozuelos,Madrid,43,38,5
1991,28045,Colmenar Viejo,Madrid,246,142,104
1991,28047,Collado Villalba,Madrid,295,172,123
1991,28049,Coslada,Madrid,293,206,87
1991,28058,Fuenlabrada,Madrid,1056,900,156
1991,28065,Getafe,Madrid,479,536,-57
1991,28074,Leganés,Madrid,479,546,-67
1991,28079,Madrid,Madrid,10983,12400,-1417
1991,28080,Majadahonda,Madrid,234,171,63
1991,28084,Mejorada del Campo,Madrid,65,72,-7
1991,28092,Móstoles,Madrid,935,997,-62
1991,28096,Navalcarnero,Madrid,72,32,40
1991,28106,Parla,Madrid,252,375,-123
1991,28113,Pinto,Madrid,134,98,36
1991,28115,Pozuelo de Alarcón,Madrid,275,143,132
1991,28123,Rivas-Vaciamadrid,Madrid,48,28,20
1991,28127,Las Rozas de Madrid,Madrid,450,174,276
1991,28130,San Fernando de Henares,Madrid,142,82,60
1991,28134,San Sebastián de los Reyes,Madrid,147,234,-87
1991,28148,Torrejón de Ardoz,Madrid,336,409,-73
1991,28161,Valdemoro,Madrid,214,199,15
1991,28181,Villaviciosa de Odón,Madrid,78,48,30
1991,29007,Alhaurín de la Torre,Málaga,86,44,42
1991,29008,Alhaurín el Grande,Málaga,18,33,-15
1991,29012,Álora,Málaga,37,31,6
1991,29015,Antequera,Málaga,177,179,-2
1991,29017,Archidona,Málaga,27,29,-2
1991,29025,Benalmádena,Málaga,207,156,51
1991,29038,Cártama,Málaga,20,23,-3
1991,29042,Coín,Málaga,23,33,-10
1991,29051,Estepona,Málaga,245,367,-122
1991,29054,Fuengirola,Málaga,586,411,175
1991,29067,Málaga,Málaga,2491,1644,847
1991,29069,Marbella,Málaga,877,597,280
1991,29070,Mijas,Málaga,165,133,32
1991,29075,Nerja,Málaga,54,84,-30
1991,29082,Rincón de la Victoria,Málaga,185,73,112
1991,29084,Ronda,Málaga,213,279,-66
1991,29091,Torrox,Málaga,45,13,32
1991,29094,Vélez-Málaga,Málaga,217,212,5
1991,29901,Torremolinos,Málaga,347,109,238
1991,30002,Abarán,Murcia,28,33,-5
1991,30003,Águilas,Murcia,319,218,101
1991,30005,Alcantarilla,Murcia,185,102,83
1991,30008,Alhama de Murcia,Murcia,43,27,16
1991,30009,Archena,Murcia,40,23,17
1991,30012,Bullas,Murcia,28,26,2
1991,30015,Caravaca de la Cruz,Murcia,151,87,64
1991,30016,Cartagena,Murcia,967,950,17
1991,30017,Cehegín,Murcia,61,27,34
1991,30019,Cieza (Murcia),Murcia,86,95,-9
1991,30022,Jumilla,Murcia,83,83,0
1991,30024,Lorca,Murcia,330,234,96
1991,30026,Mazarrón,Murcia,106,62,44
1991,30027,Molina de Segura,Murcia,190,128,62
1991,30029,Mula,Murcia,53,21,32
1991,30030,Murcia,Murcia,1700,1097,603
1991,30035,San Javier,Murcia,236,249,-13
1991,30036,San Pedro del Pinatar,Murcia,181,165,16
1991,30037,Torre-Pacheco,Murcia,112,66,46
1991,30038,Las Torres de Cotillas,Murcia,81,37,44
1991,30039,Totana,Murcia,75,47,28
1991,30041,La Unión,Murcia,49,44,5
1991,30043,Yecla,Murcia,114,194,-80
1991,31016,Ansoáin/Antsoain,Navarra,16,30,-14
1991,31060,Burlada/Burlata,Navarra,68,71,-3
1991,31097,Estella-Lizarra,Navarra,58,43,15
1991,31201,Pamplona/Iruña,Navarra,979,608,371
1991,31227,Tafalla,Navarra,36,19,17
1991,31232,Tudela,Navarra,193,151,42
1991,31901,Barañain,Navarra,106,95,11
1991,32009,O Barco de Valdeorras,Ourense,61,78,-17
1991,32019,O Carballiño,Ourense,63,59,4
1991,32054,Ourense,Ourense,456,525,-69
1991,32085,Verín,Ourense,59,75,-16
1991,33002,Aller,Asturias,18,33,-15
1991,33004,Avilés,Asturias,332,278,54
1991,33011,Cangas del Narcea,Asturias,36,75,-39
1991,33014,Carreño,Asturias,22,7,15
1991,33016,Castrillón,Asturias,75,69,6
1991,33020,Corvera de Asturias,Asturias,30,48,-18
1991,33024,Gijón,Asturias,796,773,23
1991,33025,Gozón,Asturias,30,22,8
1991,33026,Grado,Asturias,16,11,5
1991,33031,Langreo,Asturias,86,103,-17
1991,33032,Laviana,Asturias,10,10,0
1991,33033,Lena,Asturias,29,56,-27
1991,33034,Valdés,Asturias,53,23,30
1991,33035,Llanera,Asturias,40,15,25
1991,33036,Llanes,Asturias,34,34,0
1991,33037,Mieres (Asturias),Asturias,88,131,-43
1991,33044,Oviedo,Asturias,744,663,81
1991,33051,Pravia,Asturias,29,17,12
1991,33060,San Martín del Rey Aurelio,Asturias,36,29,7
1991,33066,Siero,Asturias,80,84,-4
1991,33073,Tineo,Asturias,5,30,-25
1991,33076,Villaviciosa,Asturias,21,25,-4
1991,34120,Palencia,Palencia,477,560,-83
1991,35002,Agüimes,Las Palmas,35,41,-6
1991,35004,Arrecife,Las Palmas,540,669,-129
1991,35006,Arucas,Las Palmas,36,50,-14
1991,35009,Gáldar,Las Palmas,43,19,24
1991,35011,Ingenio,Las Palmas,28,44,-16
1991,35016,Las Palmas de Gran Canaria,Las Palmas,2865,2473,392
1991,35017,Puerto del Rosario,Las Palmas,190,296,-106
1991,35019,San Bartolomé de Tirajana,Las Palmas,423,365,58
1991,35021,Santa Brígida,Las Palmas,55,48,7
1991,35022,Santa Lucía de Tirajana,Las Palmas,69,91,-22
1991,35023,Santa María de Guía de Gran Canaria,Las Palmas,18,23,-5
1991,35026,Telde,Las Palmas,294,223,71
1991,35027,Teror,Las Palmas,9,11,-2
1991,36003,Baiona,Pontevedra,8,11,-3
1991,36004,Bueu,Pontevedra,16,15,1
1991,36006,Cambados,Pontevedra,25,39,-14
1991,36008,Cangas,Pontevedra,49,35,14
1991,36017,A Estrada,Pontevedra,60,71,-11
1991,36021,Gondomar,Pontevedra,10,7,3
1991,36022,O Grove,Pontevedra,22,59,-37
1991,36023,A Guarda,Pontevedra,19,30,-11
1991,36024,Lalín,Pontevedra,43,71,-28
1991,36026,Marín,Pontevedra,63,120,-57
1991,36029,Moaña,Pontevedra,16,37,-21
1991,36033,Mos,Pontevedra,31,31,0
1991,36035,Nigrán,Pontevedra,39,13,26
1991,36038,Pontevedra,Pontevedra,331,346,-15
1991,36039,O Porriño,Pontevedra,40,47,-7
1991,36041,Poio,Pontevedra,35,45,-10
1991,36042,Ponteareas,Pontevedra,49,32,17
1991,36045,Redondela,Pontevedra,55,42,13
1991,36051,Sanxenxo,Pontevedra,18,25,-7
1991,36052,Silleda,Pontevedra,24,35,-11
1991,36054,Tomiño,Pontevedra,43,21,22
1991,36055,Tui,Pontevedra,10,48,-38
1991,36057,Vigo,Pontevedra,1027,837,190
1991,36060,Vilagarcía de Arousa,Pontevedra,152,101,51
1991,36061,Vilanova de Arousa,Pontevedra,19,35,-16
1991,37046,Béjar,Salamanca,102,111,-9
1991,37107,Ciudad Rodrigo,Salamanca,96,105,-9
1991,37274,Salamanca,Salamanca,1406,1204,202
1991,38006,Arona,Santa Cruz de Tenerife,480,355,125
1991,38011,Candelaria,Santa Cruz de Tenerife,114,102,12
1991,38017,Granadilla de Abona,Santa Cruz de Tenerife,199,218,-19
1991,38019,Guía de Isora,Santa Cruz de Tenerife,39,46,-7
1991,38020,Güímar,Santa Cruz de Tenerife,26,27,-1
1991,38022,Icod de los Vinos,Santa Cruz de Tenerife,36,33,3
1991,38023,San Cristóbal de La Laguna,Santa Cruz de Tenerife,430,371,59
1991,38024,Los Llanos de Aridane,Santa Cruz de Tenerife,74,40,34
1991,38026,La Orotava,Santa Cruz de Tenerife,53,51,2
1991,38028,Puerto de la Cruz,Santa Cruz de Tenerife,207,162,45
1991,38031,Los Realejos,Santa Cruz de Tenerife,42,29,13
1991,38037,Santa Cruz de la Palma,Santa Cruz de Tenerife,150,131,19
1991,38038,Santa Cruz de Tenerife,Santa Cruz de Tenerife,1624,1365,259
1991,38043,Tacoronte,Santa Cruz de Tenerife,27,23,4
1991,39008,El Astillero,Cantabria,8,18,-10
1991,39016,Camargo,Cantabria,42,45,-3
1991,39020,Castro-Urdiales,Cantabria,205,99,106
1991,39035,Laredo,Cantabria,125,96,29
1991,39059,Reinosa,Cantabria,20,42,-22
1991,39075,Santander,Cantabria,817,749,68
1991,39079,Santoña,Cantabria,29,49,-20
1991,39087,Torrelavega,Cantabria,107,179,-72
1991,40194,Segovia,Segovia,371,461,-90
1991,41004,Alcalá de Guadaíra,Sevilla,208,115,93
1991,41007,La Algaba,Sevilla,23,13,10
1991,41011,Arahal,Sevilla,47,25,22
1991,41018,Brenes,Sevilla,34,30,4
1991,41020,Las Cabezas de San Juan,Sevilla,103,69,34
1991,41021,Camas,Sevilla,108,78,30
1991,41024,Carmona,Sevilla,87,71,16
1991,41029,Castilleja de la Cuesta,Sevilla,91,38,53
1991,41034,Coria del Río,Sevilla,63,58,5
1991,41038,Dos Hermanas,Sevilla,390,237,153
1991,41039,Écija,Sevilla,175,187,-12
1991,41041,Estepa,Sevilla,61,39,22
1991,41053,Lebrija,Sevilla,192,210,-18
1991,41055,Lora del Río,Sevilla,83,111,-28
1991,41058,Mairena del Alcor,Sevilla,84,31,53
1991,41059,Mairena del Aljarafe,Sevilla,170,82,88
1991,41060,Marchena,Sevilla,32,36,-4
1991,41065,Morón de la Frontera,Sevilla,190,179,11
1991,41068,Osuna,Sevilla,65,67,-2
1991,41069,Los Palacios y Villafranca,Sevilla,82,40,42
1991,41075,Pilas,Sevilla,30,22,8
1991,41077,La Puebla de Cazalla,Sevilla,124,76,48
1991,41079,La Puebla del Río,Sevilla,74,46,28
1991,41081,La Rinconada,Sevilla,97,51,46
1991,41086,San Juan de Aznalfarache,Sevilla,139,67,72
1991,41091,Sevilla,Sevilla,3450,2023,1427
1991,41093,Tomares,Sevilla,100,39,61
1991,41095,Utrera,Sevilla,172,132,40
1991,41102,El Viso del Alcor,Sevilla,20,13,7
1991,42173,Soria,Soria,223,291,-68
1991,43014,Amposta,Tarragona,59,71,-12
1991,43038,Cambrils,Tarragona,283,106,177
1991,43123,Reus,Tarragona,659,358,301
1991,43136,Sant Carles de la Ràpita,Tarragona,54,40,14
1991,43148,Tarragona,Tarragona,903,613,290
1991,43155,Tortosa,Tarragona,149,154,-5
1991,43161,Valls,Tarragona,69,104,-35
1991,43163,El Vendrell,Tarragona,430,173,257
1991,43171,Vila-seca,Tarragona,134,88,46
1991,43901,Deltebre,Tarragona,9,12,-3
1991,44013,Alcañiz,Teruel,64,85,-21
1991,44216,Teruel,Teruel,211,298,-87
1991,45087,Madridejos,Toledo,46,55,-9
1991,45165,Talavera de la Reina,Toledo,459,376,83
1991,45168,Toledo,Toledo,529,422,107
1991,46005,Alaquàs,Valencia,58,68,-10
1991,46013,Alboraya,Valencia,56,42,14
1991,46017,Alzira,Valencia,151,61,90
1991,46019,L'Alcúdia,Valencia,33,28,5
1991,46021,Aldaia,Valencia,56,51,5
1991,46022,Alfafar,Valencia,93,68,25
1991,46029,Algemesí,Valencia,88,44,44
1991,46031,Alginet,Valencia,28,21,7
1991,46054,Benetússer,Valencia,29,14,15
1991,46060,Benifaió,Valencia,45,27,18
1991,46081,Canals,Valencia,25,7,18
1991,46083,Carcaixent,Valencia,35,48,-13
1991,46085,Carlet,Valencia,35,31,4
1991,46094,Catarroja,Valencia,42,37,5
1991,46102,Quart de Poblet,Valencia,84,102,-18
1991,46105,Cullera,Valencia,101,59,42
1991,46110,Xirivella,Valencia,85,103,-18
1991,46131,Gandia,Valencia,351,211,140
1991,46145,Xátiva,Valencia,71,82,-11
1991,46147,Llíria,Valencia,52,38,14
1991,46159,Manises,Valencia,72,83,-11
1991,46164,Massamagrell,Valencia,94,23,71
1991,46169,Mislata,Valencia,171,105,66
1991,46171,Moncada,Valencia,26,36,-10
1991,46181,Oliva,Valencia,87,78,9
1991,46184,Ontinyent,Valencia,92,60,32
1991,46186,Paiporta,Valencia,51,41,10
1991,46190,Paterna,Valencia,193,186,7
1991,46194,Picassent,Valencia,36,34,2
1991,46205,Puçol,Valencia,50,26,24
1991,46213,Requena,Valencia,70,60,10
1991,46220,Sagunto/Sagunt,Valencia,269,208,61
1991,46230,Silla,Valencia,63,57,6
1991,46235,Sueca,Valencia,66,42,24
1991,46238,Tavernes de la Valldigna,Valencia,35,18,17
1991,46244,Torrent (Valencia),Valencia,197,143,54
1991,46249,Utiel,Valencia,21,33,-12
1991,46250,València,Valencia,3722,2809,913
1991,47076,Laguna de Duero,Valladolid,198,106,92
1991,47085,Medina del Campo,Valladolid,104,130,-26
1991,47186,Valladolid,Valladolid,2172,1714,458
1991,48003,Amorebieta-Etxano,Vizcaya,19,46,-27
1991,48013,Barakaldo,Vizcaya,219,643,-424
1991,48015,Basauri,Vizcaya,109,312,-203
1991,48017,Bermeo,Vizcaya,19,89,-70
1991,48020,Bilbao,Vizcaya,1421,2124,-703
1991,48027,Durango,Vizcaya,54,86,-32
1991,48034,Ermua,Vizcaya,115,288,-173
1991,48036,Galdakao,Vizcaya,63,130,-67
1991,48044,Getxo,Vizcaya,389,472,-83
1991,48046,Gernika-Lumo,Vizcaya,22,50,-28
1991,48054,Leioa,Vizcaya,45,89,-44
1991,48069,Mungia,Vizcaya,19,46,-27
1991,48073,Ondarroa,Vizcaya,42,98,-56
1991,48078,Portugalete,Vizcaya,90,263,-173
1991,48080,Valle de Trápaga-Trapagaran,Vizcaya,40,39,1
1991,48082,Santurtzi,Vizcaya,113,294,-181
1991,48084,Sestao,Vizcaya,84,258,-174
1991,48902,Erandio,Vizcaya,52,130,-78
1991,49021,Benavente,Zamora,102,64,38
1991,49275,Zamora,Zamora,345,396,-51
1991,50067,Calatayud,Zaragoza,90,116,-26
1991,50095,Ejea de los Caballeros,Zaragoza,51,40,11
1991,50251,Tarazona,Zaragoza,62,56,6
1991,50297,Zaragoza,Zaragoza,3009,2400,609
1991,51001,Ceuta,Ceuta,1039,981,58
1991,52001,Melilla,Melilla,1026,905,121
1992,01036,Laudio/Llodio,Álava,76,251,-175
1992,01059,Vitoria-Gasteiz,Álava,2002,1544,458
1992,02003,Albacete,Albacete,1500,959,541
1992,02009,Almansa,Albacete,190,207,-17
1992,02037,Hellín,Albacete,261,260,1
1992,02069,La Roda,Albacete,154,94,60
1992,02081,Villarrobledo,Albacete,169,118,51
1992,03009,Alcoy/Alcoi,Alicante,215,408,-193
1992,03014,Alicante/Alacant,Alicante,2090,1851,239
1992,03015,Almoradí,Alicante,87,72,15
1992,03018,Altea,Alicante,113,142,-29
1992,03019,Aspe,Alicante,50,57,-7
1992,03031,Benidorm,Alicante,940,734,206
1992,03047,Calp,Alicante,131,201,-70
1992,03049,Callosa de Segura,Alicante,61,85,-24
1992,03050,El Campello,Alicante,181,114,67
1992,03056,Cocentaina,Alicante,51,56,-5
1992,03059,Crevillent,Alicante,84,72,12
1992,03063,Dénia,Alicante,287,341,-54
1992,03065,Elche/Elx,Alicante,671,686,-15
1992,03066,Elda,Alicante,219,266,-47
1992,03079,Ibi,Alicante,107,86,21
1992,03082,Jávea/Xàbia,Alicante,53,220,-167
1992,03089,Monóvar/Monòver,Alicante,39,24,15
1992,03090,Mutxamel,Alicante,61,54,7
1992,03093,Novelda,Alicante,82,67,15
1992,03099,Orihuela,Alicante,272,572,-300
1992,03104,Petrer,Alicante,61,98,-37
1992,03119,Sant Joan d'Alacant,Alicante,168,126,42
1992,03121,Santa Pola,Alicante,254,124,130
1992,03122,San Vicente del Raspeig/Sant Vicent del Raspeig,Alicante,188,144,44
1992,03133,Torrevieja,Alicante,1364,545,819
1992,03139,Villajoyosa/La Vila Joiosa,Alicante,148,224,-76
1992,03140,Villena,Alicante,124,173,-49
1992,04003,Adra,Almería,99,124,-25
1992,04006,Albox,Almería,44,58,-14
1992,04013,Almería,Almería,1357,1298,59
1992,04029,Berja,Almería,80,66,14
1992,04053,Huércal-Overa,Almería,141,143,-2
1992,04066,Níjar,Almería,111,55,56
1992,04079,Roquetas de Mar,Almería,700,297,403
1992,04102,Vícar,Almería,140,97,43
1992,04902,El Ejido,Almería,405,377,28
1992,05019,Ávila,Ávila,418,472,-54
1992,06011,Almendralejo,Badajoz,236,131,105
1992,06015,Badajoz,Badajoz,1168,1041,127
1992,06044,Don Benito,Badajoz,233,254,-21
1992,06070,Jerez de los Caballeros,Badajoz,81,24,57
1992,06083,Mérida,Badajoz,572,497,75
1992,06088,Montijo,Badajoz,160,125,35
1992,06095,Olivenza,Badajoz,115,81,34
1992,06149,Villafranca de los Barros,Badajoz,42,41,1
1992,06153,Villanueva de la Serena,Badajoz,160,206,-46
1992,06158,Zafra,Badajoz,122,125,-3
1992,07011,Calvià,Baleares,608,433,175
1992,07015,Ciutadella de Menorca,Baleares,211,315,-104
1992,07022,Felanitx,Baleares,83,199,-116
1992,07026,Eivissa,Baleares,519,826,-307
1992,07027,Inca,Baleares,81,85,-4
1992,07031,Llucmajor,Baleares,188,160,28
1992,07032,Maó-Mahón,Baleares,338,487,-149
1992,07033,Manacor,Baleares,169,321,-152
1992,07036,Marratxí,Baleares,68,40,28
1992,07040,Palma,Baleares,4191,3110,1081
1992,07042,Pollença,Baleares,107,107,0
1992,07044,Sa Pobla,Baleares,38,36,2
1992,07046,Sant Antoni de Portmany,Baleares,275,314,-39
1992,07048,Sant Josep de sa Talaia,Baleares,330,158,172
1992,07054,Santa Eulària des Riu,Baleares,504,420,84
1992,07061,Sóller,Baleares,27,41,-14
1992,08006,Arenys de Mar,Barcelona,56,70,-14
1992,08015,Badalona,Barcelona,628,1161,-533
1992,08019,Barcelona,Barcelona,4931,10355,-5424
1992,08022,Berga,Barcelona,70,67,3
1992,08033,Caldes de Montbui,Barcelona,40,54,-14
1992,08035,Calella,Barcelona,109,137,-28
1992,08041,Canovelles,Barcelona,114,89,25
1992,08051,Castellar del Vallès,Barcelona,63,92,-29
1992,08056,Castelldefels,Barcelona,342,466,-124
1992,08073,Cornellà de Llobregat,Barcelona,441,600,-159
1992,08076,Esparreguera,Barcelona,67,69,-2
1992,08077,Esplugues de Llobregat,Barcelona,205,332,-127
1992,08086,Les Franqueses del Vallès,Barcelona,36,56,-20
1992,08089,Gavà,Barcelona,160,289,-129
1992,08096,Granollers,Barcelona,221,267,-46
1992,08101,L'Hospitalet de Llobregat,Barcelona,1015,1656,-641
1992,08102,Igualada,Barcelona,97,150,-53
1992,08105,La Llagosta,Barcelona,37,75,-38
1992,08110,Malgrat de Mar,Barcelona,78,92,-14
1992,08112,Manlleu,Barcelona,74,57,17
1992,08113,Manresa,Barcelona,189,202,-13
1992,08114,Martorell,Barcelona,93,93,0
1992,08118,El Masnou,Barcelona,124,141,-17
1992,08121,Mataró,Barcelona,415,659,-244
1992,08123,Molins de Rei,Barcelona,47,81,-34
1992,08124,Mollet del Vallès,Barcelona,239,217,22
1992,08125,Montcada i Reixac,Barcelona,137,91,46
1992,08136,Montornès del Vallès,Barcelona,55,67,-12
1992,08147,Olesa de Montserrat,Barcelona,52,54,-2
1992,08159,Parets del Vallès,Barcelona,54,56,-2
1992,08163,Pineda de Mar,Barcelona,210,183,27
1992,08169,El Prat de Llobregat,Barcelona,294,471,-177
1992,08172,Premià de Mar,Barcelona,99,201,-102
1992,08180,Ripollet,Barcelona,133,202,-69
1992,08184,Rubí,Barcelona,245,316,-71
1992,08187,Sabadell,Barcelona,695,969,-274
1992,08194,Sant Adrià de Besòs,Barcelona,93,202,-109
1992,08196,Sant Andreu de la Barca,Barcelona,135,104,31
1992,08200,Sant Boi de Llobregat,Barcelona,288,501,-213
1992,08202,Sant Celoni,Barcelona,92,112,-20
1992,08205,Sant Cugat del Vallès,Barcelona,290,241,49
1992,08211,Sant Feliu de Llobregat,Barcelona,139,234,-95
1992,08217,Sant Joan Despí,Barcelona,137,172,-35
1992,08219,Vilassar de Mar,Barcelona,81,82,-1
1992,08221,Sant Just Desvern,Barcelona,40,39,1
1992,08231,Sant Pere de Ribes,Barcelona,135,121,14
1992,08245,Santa Coloma de Gramenet,Barcelona,438,810,-372
1992,08252,Barberà del Vallès,Barcelona,153,251,-98
1992,08260,Santa Perpètua de Mogoda,Barcelona,77,130,-53
1992,08263,Sant Vicenç dels Horts,Barcelona,113,130,-17
1992,08266,Cerdanyola del Vallès,Barcelona,379,384,-5
1992,08270,Sitges,Barcelona,163,69,94
1992,08279,Terrassa,Barcelona,492,709,-217
1992,08285,Torelló,Barcelona,19,37,-18
1992,08298,Vic,Barcelona,79,120,-41
1992,08301,Viladecans,Barcelona,233,446,-213
1992,08305,Vilafranca del Penedès,Barcelona,147,146,1
1992,08307,Vilanova i la Geltrú,Barcelona,269,294,-25
1992,09018,Aranda de Duero,Burgos,282,280,2
1992,09059,Burgos,Burgos,938,1228,-290
1992,09219,Miranda de Ebro,Burgos,372,470,-98
1992,10037,Cáceres,Cáceres,817,678,139
1992,10067,Coria,Cáceres,148,145,3
1992,10131,Navalmoral de la Mata,Cáceres,186,203,-17
1992,10148,Plasencia,Cáceres,365,354,11
1992,11004,Algeciras,Cádiz,715,927,-212
1992,11006,Arcos de la Frontera,Cádiz,116,229,-113
1992,11007,Barbate,Cádiz,144,351,-207
1992,11008,Los Barrios,Cádiz,133,101,32
1992,11012,Cádiz,Cádiz,524,867,-343
1992,11014,Conil de la Frontera,Cádiz,34,53,-19
1992,11015,Chiclana de la Frontera,Cádiz,373,189,184
1992,11016,Chipiona,Cádiz,67,51,16
1992,11020,Jerez de la Frontera,Cádiz,1061,1107,-46
1992,11022,La Línea de la Concepción,Cádiz,332,478,-146
1992,11023,Medina-Sidonia,Cádiz,20,49,-29
1992,11027,El Puerto de Santa María,Cádiz,553,576,-23
1992,11028,Puerto Real,Cádiz,108,77,31
1992,11030,Rota,Cádiz,161,142,19
1992,11031,San Fernando,Cádiz,550,669,-119
1992,11032,Sanlúcar de Barrameda,Cádiz,217,217,0
1992,11033,San Roque,Cádiz,177,228,-51
1992,11035,Tarifa,Cádiz,156,139,17
1992,11038,Ubrique,Cádiz,56,72,-16
1992,11039,Vejer de la Frontera,Cádiz,49,58,-9
1992,11041,Villamartín,Cádiz,51,101,-50
1992,12009,Almassora,Castellón,55,52,3
1992,12027,Benicarló,Castellón,216,228,-12
1992,12032,Borriana/Burriana,Castellón,120,113,7
1992,12040,Castellón de la Plana/Castelló de la Plana,Castellón,1286,977,309
1992,12082,Nules,Castellón,48,37,11
1992,12084,Onda,Castellón,60,37,23
1992,12126,La Vall d'Uixó,Castellón,115,91,24
1992,12135,Vila-real,Castellón,215,152,63
1992,12138,Vinaròs,Castellón,349,224,125
1992,13005,Alcázar de San Juan,Ciudad Real,208,279,-71
1992,13023,Bolaños de Calatrava,Ciudad Real,30,42,-12
1992,13028,Campo de Criptana,Ciudad Real,82,83,-1
1992,13034,Ciudad Real,Ciudad Real,635,486,149
1992,13039,Daimiel,Ciudad Real,104,67,37
1992,13053,Manzanares,Ciudad Real,173,214,-41
1992,13071,Puertollano,Ciudad Real,478,483,-5
1992,13078,Socuéllamos,Ciudad Real,48,116,-68
1992,13079,La Solana,Ciudad Real,74,41,33
1992,13082,Tomelloso,Ciudad Real,137,108,29
1992,13087,Valdepeñas,Ciudad Real,229,226,3
1992,14002,Aguilar de la Frontera,Córdoba,73,77,-4
1992,14007,Baena,Córdoba,84,151,-67
1992,14013,Cabra,Córdoba,140,173,-33
1992,14021,Córdoba,Córdoba,1938,2078,-140
1992,14038,Lucena,Córdoba,218,195,23
1992,14042,Montilla,Córdoba,130,107,23
1992,14049,Palma del Río,Córdoba,169,210,-41
1992,14052,Peñarroya-Pueblonuevo,Córdoba,113,111,2
1992,14054,Pozoblanco,Córdoba,75,93,-18
1992,14055,Priego de Córdoba,Córdoba,146,248,-102
1992,14056,Puente Genil,Córdoba,212,142,70
1992,14058,Rute,Córdoba,93,97,-4
1992,14069,Villanueva de Córdoba,Córdoba,71,89,-18
1992,15002,Ames,A Coruña,125,48,77
1992,15005,Arteixo,A Coruña,86,63,23
1992,15009,Betanzos,A Coruña,78,49,29
1992,15011,Boiro,A Coruña,58,67,-9
1992,15017,Cambre,A Coruña,79,46,33
1992,15019,Carballo,A Coruña,71,50,21
1992,15030,A Coruña,A Coruña,1737,1174,563
1992,15031,Culleredo,A Coruña,122,51,71
1992,15035,Fene,A Coruña,72,45,27
1992,15036,Ferrol,A Coruña,519,582,-63
1992,15041,A Laracha,A Coruña,30,14,16
1992,15053,Muros,A Coruña,37,62,-25
1992,15054,Narón,A Coruña,160,163,-3
1992,15057,Noia,A Coruña,42,75,-33
1992,15058,Oleiros,A Coruña,249,73,176
1992,15059,Ordes,A Coruña,44,12,32
1992,15065,Padrón,A Coruña,66,48,18
1992,15067,A Pobra do Caramiñal,A Coruña,21,44,-23
1992,15070,As Pontes de García Rodríguez,A Coruña,81,63,18
1992,15071,Porto do Son,A Coruña,50,32,18
1992,15072,Rianxo,A Coruña,29,56,-27
1992,15073,Ribeira,A Coruña,114,84,30
1992,15077,Santa Comba,A Coruña,12,16,-4
1992,15078,Santiago de Compostela,A Coruña,613,412,201
1992,15082,Teo,A Coruña,62,33,29
1992,16078,Cuenca,Cuenca,327,412,-85
1992,16203,Tarancón,Cuenca,87,167,-80
1992,17015,Banyoles,Girona,74,102,-28
1992,17023,Blanes,Girona,469,419,50
1992,17066,Figueres,Girona,274,429,-155
1992,17079,Girona,Girona,617,665,-48
1992,17095,Lloret de Mar,Girona,543,473,70
1992,17114,Olot,Girona,137,171,-34
1992,17117,Palafrugell,Girona,191,219,-28
1992,17118,Palamós,Girona,135,166,-31
1992,17147,Ripoll,Girona,101,151,-50
1992,17152,Roses,Girona,215,203,12
1992,17155,Salt,Girona,205,146,59
1992,17160,Sant Feliu de Guíxols,Girona,173,151,22
1992,18003,Albolote,Granada,137,62,75
1992,18017,Almuñécar,Granada,99,168,-69
1992,18021,Armilla,Granada,138,77,61
1992,18022,Atarfe,Granada,107,53,54
1992,18023,Baza,Granada,199,182,17
1992,18087,Granada,Granada,2026,1836,190
1992,18089,Guadix,Granada,202,218,-16
1992,18098,Huéscar,Granada,81,110,-29
1992,18102,Illora,Granada,69,57,12
1992,18122,Loja,Granada,160,119,41
1992,18127,Maracena,Granada,94,54,40
1992,18140,Motril,Granada,335,324,11
1992,18158,Pinos Puente,Granada,63,52,11
1992,18175,Santa Fe,Granada,122,81,41
1992,19046,Azuqueca de Henares,Guadalajara,640,147,493
1992,19130,Guadalajara,Guadalajara,975,614,361
1992,20009,Andoain,Guipúzcoa,53,127,-74
1992,20017,Azkoitia,Guipúzcoa,13,57,-44
1992,20018,Azpeitia,Guipúzcoa,39,69,-30
1992,20019,Beasain,Guipúzcoa,47,112,-65
1992,20030,Eibar,Guipúzcoa,187,422,-235
1992,20032,Elgoibar,Guipúzcoa,49,110,-61
1992,20036,Hondarribia,Guipúzcoa,66,81,-15
1992,20040,Hernani,Guipúzcoa,73,129,-56
1992,20045,Irun,Guipúzcoa,405,512,-107
1992,20055,Arrasate/Mondragón,Guipúzcoa,97,245,-148
1992,20059,Oñati,Guipúzcoa,25,67,-42
1992,20064,Pasaia,Guipúzcoa,70,146,-76
1992,20067,Errenteria,Guipúzcoa,152,289,-137
1992,20069,Donostia/San Sebastián,Guipúzcoa,807,1234,-427
1992,20071,Tolosa,Guipúzcoa,57,113,-56
1992,20074,Bergara,Guipúzcoa,76,124,-48
1992,20079,Zarautz,Guipúzcoa,108,122,-14
1992,20080,Zumarraga,Guipúzcoa,48,122,-74
1992,20902,Lasarte-Oria,Guipúzcoa,84,139,-55
1992,21005,Almonte,Huelva,102,142,-40
1992,21010,Ayamonte,Huelva,90,91,-1
1992,21013,Bollullos Par del Condado,Huelva,25,23,2
1992,21021,Cartaya,Huelva,59,33,26
1992,21035,Gibraleón,Huelva,69,17,52
1992,21041,Huelva,Huelva,573,654,-81
1992,21042,Isla Cristina,Huelva,83,129,-46
1992,21044,Lepe,Huelva,83,89,-6
1992,21050,Moguer,Huelva,46,86,-40
1992,21060,Punta Umbría,Huelva,40,48,-8
1992,21072,Valverde del Camino,Huelva,50,57,-7
1992,22048,Barbastro,Huesca,89,121,-32
1992,22112,Fraga,Huesca,112,121,-9
1992,22125,Huesca,Huesca,596,506,90
1992,22130,Jaca,Huesca,220,224,-4
1992,22158,Monzón,Huesca,115,124,-9
1992,23002,Alcalá la Real,Jaén,210,258,-48
1992,23003,Alcaudete,Jaén,130,118,12
1992,23005,Andújar,Jaén,338,364,-26
1992,23009,Baeza,Jaén,150,96,54
1992,23010,Bailén,Jaén,82,75,7
1992,23024,La Carolina,Jaén,67,220,-153
1992,23050,Jaén,Jaén,563,633,-70
1992,23053,Jódar,Jaén,276,128,148
1992,23055,Linares,Jaén,422,523,-101
1992,23060,Martos,Jaén,146,111,35
1992,23086,Torredelcampo,Jaén,62,30,32
1992,23087,Torredonjimeno,Jaén,65,65,0
1992,23092,Úbeda,Jaén,252,240,12
1992,23095,Villacarrillo,Jaén,87,114,-27
1992,24008,Astorga,León,129,165,-36
1992,24010,La Bañeza,León,66,100,-34
1992,24014,Bembibre,León,74,153,-79
1992,24089,León,León,1053,1205,-152
1992,24115,Ponferrada,León,296,658,-362
1992,24142,San Andrés del Rabanedo,León,117,131,-14
1992,24202,Villablino,León,68,254,-186
1992,25040,Balaguer,Lleida,63,77,-14
1992,25120,Lleida,Lleida,926,985,-59
1992,25203,La Seu d'Urgell,Lleida,191,176,15
1992,25217,Tàrrega,Lleida,97,70,27
1992,26018,Arnedo,La Rioja,43,60,-17
1992,26036,Calahorra,La Rioja,145,175,-30
1992,26089,Logroño,La Rioja,1017,1224,-207
1992,27013,Cervo,Lugo,75,121,-46
1992,27016,Chantada,Lugo,69,62,7
1992,27028,Lugo,Lugo,535,538,-3
1992,27031,Monforte de Lemos,Lugo,121,171,-50
1992,27057,Sarria,Lugo,54,50,4
1992,27065,Vilalba,Lugo,81,73,8
1992,27066,Viveiro,Lugo,81,89,-8
1992,28005,Alcalá de Henares,Madrid,1324,1780,-456
1992,28006,Alcobendas,Madrid,497,477,20
1992,28007,Alcorcón,Madrid,798,693,105
1992,28009,Algete,Madrid,102,104,-2
1992,28013,Aranjuez,Madrid,287,171,116
1992,28014,Arganda del Rey,Madrid,133,103,30
1992,28022,Boadilla del Monte,Madrid,100,87,13
1992,28040,Ciempozuelos,Madrid,111,48,63
1992,28045,Colmenar Viejo,Madrid,255,208,47
1992,28047,Collado Villalba,Madrid,522,308,214
1992,28049,Coslada,Madrid,337,397,-60
1992,28058,Fuenlabrada,Madrid,1313,1410,-97
1992,28065,Getafe,Madrid,708,775,-67
1992,28074,Leganés,Madrid,961,917,44
1992,28079,Madrid,Madrid,16865,18074,-1209
1992,28080,Majadahonda,Madrid,364,195,169
1992,28084,Mejorada del Campo,Madrid,83,96,-13
1992,28092,Móstoles,Madrid,1028,1578,-550
1992,28096,Navalcarnero,Madrid,80,77,3
1992,28106,Parla,Madrid,363,664,-301
1992,28113,Pinto,Madrid,223,145,78
1992,28115,Pozuelo de Alarcón,Madrid,362,292,70
1992,28123,Rivas-Vaciamadrid,Madrid,107,67,40
1992,28127,Las Rozas de Madrid,Madrid,516,310,206
1992,28130,San Fernando de Henares,Madrid,184,144,40
1992,28134,San Sebastián de los Reyes,Madrid,315,305,10
1992,28148,Torrejón de Ardoz,Madrid,570,645,-75
1992,28161,Valdemoro,Madrid,259,244,15
1992,28181,Villaviciosa de Odón,Madrid,100,60,40
1992,28903,Tres Cantos,Madrid,354,50,304
1992,29007,Alhaurín de la Torre,Málaga,126,53,73
1992,29008,Alhaurín el Grande,Málaga,31,29,2
1992,29012,Álora,Málaga,39,52,-13
1992,29015,Antequera,Málaga,146,220,-74
1992,29017,Archidona,Málaga,46,56,-10
1992,29025,Benalmádena,Málaga,374,202,172
1992,29038,Cártama,Málaga,36,25,11
1992,29042,Coín,Málaga,40,48,-8
1992,29051,Estepona,Málaga,268,441,-173
1992,29054,Fuengirola,Málaga,585,513,72
1992,29067,Málaga,Málaga,2319,2352,-33
1992,29069,Marbella,Málaga,956,852,104
1992,29070,Mijas,Málaga,361,229,132
1992,29075,Nerja,Málaga,115,95,20
1992,29082,Rincón de la Victoria,Málaga,215,110,105
1992,29084,Ronda,Málaga,264,273,-9
1992,29091,Torrox,Málaga,56,46,10
1992,29094,Vélez-Málaga,Málaga,348,287,61
1992,29901,Torremolinos,Málaga,544,283,261
1992,30002,Abarán,Murcia,17,39,-22
1992,30003,Águilas,Murcia,268,333,-65
1992,30005,Alcantarilla,Murcia,257,128,129
1992,30008,Alhama de Murcia,Murcia,80,45,35
1992,30009,Archena,Murcia,81,51,30
1992,30012,Bullas,Murcia,45,25,20
1992,30015,Caravaca de la Cruz,Murcia,191,114,77
1992,30016,Cartagena,Murcia,1273,1202,71
1992,30017,Cehegín,Murcia,127,41,86
1992,30019,Cieza (Murcia),Murcia,103,125,-22
1992,30022,Jumilla,Murcia,82,107,-25
1992,30024,Lorca,Murcia,396,316,80
1992,30026,Mazarrón,Murcia,211,114,97
1992,30027,Molina de Segura,Murcia,205,154,51
1992,30029,Mula,Murcia,49,34,15
1992,30030,Murcia,Murcia,2014,1495,519
1992,30033,Puerto Lumbreras,Murcia,88,51,37
1992,30035,San Javier,Murcia,358,255,103
1992,30036,San Pedro del Pinatar,Murcia,313,211,102
1992,30037,Torre-Pacheco,Murcia,135,115,20
1992,30038,Las Torres de Cotillas,Murcia,82,63,19
1992,30039,Totana,Murcia,102,35,67
1992,30041,La Unión,Murcia,38,66,-28
1992,30043,Yecla,Murcia,178,167,11
1992,31060,Burlada/Burlata,Navarra,121,117,4
1992,31097,Estella-Lizarra,Navarra,72,71,1
1992,31201,Pamplona/Iruña,Navarra,1380,903,477
1992,31227,Tafalla,Navarra,71,51,20
1992,31232,Tudela,Navarra,227,220,7
1992,31901,Barañain,Navarra,157,129,28
1992,32009,O Barco de Valdeorras,Ourense,78,123,-45
1992,32019,O Carballiño,Ourense,54,94,-40
1992,32054,Ourense,Ourense,450,732,-282
1992,32085,Verín,Ourense,168,122,46
1992,33002,Aller,Asturias,15,53,-38
1992,33004,Avilés,Asturias,463,464,-1
1992,33011,Cangas del Narcea,Asturias,73,126,-53
1992,33014,Carreño,Asturias,30,34,-4
1992,33016,Castrillón,Asturias,73,78,-5
1992,33020,Corvera de Asturias,Asturias,54,66,-12
1992,33024,Gijón,Asturias,1398,1237,161
1992,33025,Gozón,Asturias,46,18,28
1992,33026,Grado,Asturias,28,20,8
1992,33031,Langreo,Asturias,76,189,-113
1992,33032,Laviana,Asturias,18,32,-14
1992,33033,Lena,Asturias,40,55,-15
1992,33034,Valdés,Asturias,50,48,2
1992,33035,Llanera,Asturias,23,26,-3
1992,33036,Llanes,Asturias,57,82,-25
1992,33037,Mieres (Asturias),Asturias,138,231,-93
1992,33044,Oviedo,Asturias,1101,902,199
1992,33051,Pravia,Asturias,34,51,-17
1992,33060,San Martín del Rey Aurelio,Asturias,28,85,-57
1992,33066,Siero,Asturias,131,91,40
1992,33073,Tineo,Asturias,1,29,-28
1992,33076,Villaviciosa,Asturias,19,26,-7
1992,34120,Palencia,Palencia,634,684,-50
1992,35002,Agüimes,Las Palmas,99,53,46
1992,35004,Arrecife,Las Palmas,684,648,36
1992,35006,Arucas,Las Palmas,65,60,5
1992,35009,Gáldar,Las Palmas,46,24,22
1992,35011,Ingenio,Las Palmas,31,35,-4
1992,35016,Las Palmas de Gran Canaria,Las Palmas,2580,2564,16
1992,35017,Puerto del Rosario,Las Palmas,302,298,4
1992,35019,San Bartolomé de Tirajana,Las Palmas,473,290,183
1992,35021,Santa Brígida,Las Palmas,77,65,12
1992,35022,Santa Lucía de Tirajana,Las Palmas,114,118,-4
1992,35023,Santa María de Guía de Gran Canaria,Las Palmas,19,34,-15
1992,35026,Telde,Las Palmas,347,272,75
1992,35027,Teror,Las Palmas,17,19,-2
1992,36003,Baiona,Pontevedra,25,33,-8
1992,36004,Bueu,Pontevedra,23,17,6
1992,36006,Cambados,Pontevedra,36,69,-33
1992,36008,Cangas,Pontevedra,50,60,-10
1992,36017,A Estrada,Pontevedra,90,107,-17
1992,36021,Gondomar,Pontevedra,14,17,-3
1992,36022,O Grove,Pontevedra,34,37,-3
1992,36023,A Guarda,Pontevedra,39,54,-15
1992,36024,Lalín,Pontevedra,91,64,27
1992,36026,Marín,Pontevedra,150,127,23
1992,36029,Moaña,Pontevedra,43,25,18
1992,36033,Mos,Pontevedra,16,12,4
1992,36035,Nigrán,Pontevedra,46,22,24
1992,36038,Pontevedra,Pontevedra,434,540,-106
1992,36039,O Porriño,Pontevedra,82,42,40
1992,36041,Poio,Pontevedra,79,38,41
1992,36042,Ponteareas,Pontevedra,85,51,34
1992,36045,Redondela,Pontevedra,71,95,-24
1992,36051,Sanxenxo,Pontevedra,40,49,-9
1992,36052,Silleda,Pontevedra,21,32,-11
1992,36054,Tomiño,Pontevedra,29,19,10
1992,36055,Tui,Pontevedra,113,68,45
1992,36057,Vigo,Pontevedra,1541,1285,256
1992,36060,Vilagarcía de Arousa,Pontevedra,286,233,53
1992,36061,Vilanova de Arousa,Pontevedra,27,64,-37
1992,37046,Béjar,Salamanca,92,106,-14
1992,37107,Ciudad Rodrigo,Salamanca,167,107,60
1992,37274,Salamanca,Salamanca,1492,1391,101
1992,38001,Adeje,Santa Cruz de Tenerife,251,119,132
1992,38006,Arona,Santa Cruz de Tenerife,677,376,301
1992,38011,Candelaria,Santa Cruz de Tenerife,141,98,43
1992,38017,Granadilla de Abona,Santa Cruz de Tenerife,250,178,72
1992,38019,Guía de Isora,Santa Cruz de Tenerife,55,35,20
1992,38020,Güímar,Santa Cruz de Tenerife,65,36,29
1992,38022,Icod de los Vinos,Santa Cruz de Tenerife,56,37,19
1992,38023,San Cristóbal de La Laguna,Santa Cruz de Tenerife,516,380,136
1992,38024,Los Llanos de Aridane,Santa Cruz de Tenerife,110,86,24
1992,38026,La Orotava,Santa Cruz de Tenerife,110,82,28
1992,38028,Puerto de la Cruz,Santa Cruz de Tenerife,269,153,116
1992,38031,Los Realejos,Santa Cruz de Tenerife,54,25,29
1992,38037,Santa Cruz de la Palma,Santa Cruz de Tenerife,159,135,24
1992,38038,Santa Cruz de Tenerife,Santa Cruz de Tenerife,2033,1310,723
1992,38043,Tacoronte,Santa Cruz de Tenerife,52,37,15
1992,39008,El Astillero,Cantabria,47,62,-15
1992,39016,Camargo,Cantabria,75,65,10
1992,39020,Castro-Urdiales,Cantabria,393,203,190
1992,39035,Laredo,Cantabria,161,101,60
1992,39059,Reinosa,Cantabria,48,80,-32
1992,39075,Santander,Cantabria,1136,1099,37
1992,39079,Santoña,Cantabria,44,76,-32
1992,39087,Torrelavega,Cantabria,163,256,-93
1992,40194,Segovia,Segovia,369,632,-263
1992,41004,Alcalá de Guadaíra,Sevilla,246,185,61
1992,41007,La Algaba,Sevilla,18,23,-5
1992,41011,Arahal,Sevilla,40,31,9
1992,41018,Brenes,Sevilla,64,26,38
1992,41020,Las Cabezas de San Juan,Sevilla,144,53,91
1992,41021,Camas,Sevilla,123,91,32
1992,41024,Carmona,Sevilla,137,48,89
1992,41029,Castilleja de la Cuesta,Sevilla,126,42,84
1992,41034,Coria del Río,Sevilla,98,51,47
1992,41038,Dos Hermanas,Sevilla,490,371,119
1992,41039,Écija,Sevilla,269,220,49
1992,41041,Estepa,Sevilla,77,50,27
1992,41053,Lebrija,Sevilla,228,145,83
1992,41055,Lora del Río,Sevilla,127,124,3
1992,41058,Mairena del Alcor,Sevilla,50,42,8
1992,41059,Mairena del Aljarafe,Sevilla,218,110,108
1992,41060,Marchena,Sevilla,76,44,32
1992,41065,Morón de la Frontera,Sevilla,194,203,-9
1992,41068,Osuna,Sevilla,92,75,17
1992,41069,Los Palacios y Villafranca,Sevilla,103,44,59
1992,41075,Pilas,Sevilla,33,20,13
1992,41077,La Puebla de Cazalla,Sevilla,155,126,29
1992,41079,La Puebla del Río,Sevilla,66,50,16
1992,41081,La Rinconada,Sevilla,191,98,93
1992,41086,San Juan de Aznalfarache,Sevilla,144,79,65
1992,41091,Sevilla,Sevilla,3801,2554,1247
1992,41093,Tomares,Sevilla,172,87,85
1992,41095,Utrera,Sevilla,250,172,78
1992,41102,El Viso del Alcor,Sevilla,23,29,-6
1992,42173,Soria,Soria,440,378,62
1992,43014,Amposta,Tarragona,94,86,8
1992,43038,Cambrils,Tarragona,400,158,242
1992,43123,Reus,Tarragona,931,533,398
1992,43136,Sant Carles de la Ràpita,Tarragona,79,102,-23
1992,43148,Tarragona,Tarragona,1059,808,251
1992,43155,Tortosa,Tarragona,192,166,26
1992,43161,Valls,Tarragona,140,107,33
1992,43163,El Vendrell,Tarragona,548,220,328
1992,43171,Vila-seca,Tarragona,265,117,148
1992,43901,Deltebre,Tarragona,41,26,15
1992,44013,Alcañiz,Teruel,93,124,-31
1992,44216,Teruel,Teruel,317,371,-54
1992,45087,Madridejos,Toledo,49,60,-11
1992,45165,Talavera de la Reina,Toledo,596,534,62
1992,45168,Toledo,Toledo,612,536,76
1992,46005,Alaquàs,Valencia,73,94,-21
1992,46013,Alboraya,Valencia,75,52,23
1992,46017,Alzira,Valencia,185,122,63
1992,46019,L'Alcúdia,Valencia,54,14,40
1992,46021,Aldaia,Valencia,83,99,-16
1992,46022,Alfafar,Valencia,96,78,18
1992,46029,Algemesí,Valencia,69,61,8
1992,46031,Alginet,Valencia,25,19,6
1992,46054,Benetússer,Valencia,48,55,-7
1992,46060,Benifaió,Valencia,29,28,1
1992,46078,Burjassot,Valencia,156,110,46
1992,46081,Canals,Valencia,33,16,17
1992,46083,Carcaixent,Valencia,62,46,16
1992,46085,Carlet,Valencia,51,49,2
1992,46094,Catarroja,Valencia,33,44,-11
1992,46102,Quart de Poblet,Valencia,111,126,-15
1992,46105,Cullera,Valencia,99,89,10
1992,46110,Xirivella,Valencia,104,116,-12
1992,46131,Gandia,Valencia,394,342,52
1992,46145,Xátiva,Valencia,89,132,-43
1992,46147,Llíria,Valencia,82,42,40
1992,46159,Manises,Valencia,87,84,3
1992,46164,Massamagrell,Valencia,46,58,-12
1992,46169,Mislata,Valencia,259,156,103
1992,46171,Moncada,Valencia,70,37,33
1992,46181,Oliva,Valencia,109,99,10
1992,46184,Ontinyent,Valencia,58,104,-46
1992,46186,Paiporta,Valencia,82,75,7
1992,46190,Paterna,Valencia,244,148,96
1992,46194,Picassent,Valencia,43,31,12
1992,46205,Puçol,Valencia,61,27,34
1992,46213,Requena,Valencia,147,97,50
1992,46220,Sagunto/Sagunt,Valencia,318,246,72
1992,46230,Silla,Valencia,65,65,0
1992,46235,Sueca,Valencia,79,68,11
1992,46238,Tavernes de la Valldigna,Valencia,39,47,-8
1992,46244,Torrent (Valencia),Valencia,278,197,81
1992,46249,Utiel,Valencia,60,51,9
1992,46250,València,Valencia,4823,3731,1092
1992,47076,Laguna de Duero,Valladolid,179,129,50
1992,47085,Medina del Campo,Valladolid,153,148,5
1992,47186,Valladolid,Valladolid,2495,2524,-29
1992,48003,Amorebieta-Etxano,Vizcaya,33,103,-70
1992,48011,Arrigorriaga,Vizcaya,53,81,-28
1992,48013,Barakaldo,Vizcaya,378,854,-476
1992,48015,Basauri,Vizcaya,146,438,-292
1992,48017,Bermeo,Vizcaya,39,99,-60
1992,48020,Bilbao,Vizcaya,1865,3019,-1154
1992,48027,Durango,Vizcaya,87,156,-69
1992,48034,Ermua,Vizcaya,162,425,-263
1992,48036,Galdakao,Vizcaya,100,169,-69
1992,48044,Getxo,Vizcaya,524,751,-227
1992,48046,Gernika-Lumo,Vizcaya,24,59,-35
1992,48054,Leioa,Vizcaya,104,160,-56
1992,48069,Mungia,Vizcaya,39,44,-5
1992,48073,Ondarroa,Vizcaya,70,149,-79
1992,48078,Portugalete,Vizcaya,153,368,-215
1992,48080,Valle de Trápaga-Trapagaran,Vizcaya,32,98,-66
1992,48082,Santurtzi,Vizcaya,175,400,-225
1992,48084,Sestao,Vizcaya,111,318,-207
1992,48902,Erandio,Vizcaya,79,162,-83
1992,49021,Benavente,Zamora,177,166,11
1992,49275,Zamora,Zamora,398,564,-166
1992,50067,Calatayud,Zaragoza,117,163,-46
1992,50095,Ejea de los Caballeros,Zaragoza,63,57,6
1992,50251,Tarazona,Zaragoza,66,90,-24
1992,50297,Zaragoza,Zaragoza,4223,3346,877
1992,51001,Ceuta,Ceuta,1295,931,364
1992,52001,Melilla,Melilla,1290,1048,242
1993,01036,Laudio/Llodio,Álava,161,234,-73
1993,01059,Vitoria-Gasteiz,Álava,2282,1698,584
1993,02003,Albacete,Albacete,1461,1096,365
1993,02009,Almansa,Albacete,189,204,-15
1993,02037,Hellín,Albacete,266,293,-27
1993,02069,La Roda,Albacete,85,93,-8
1993,02081,Villarrobledo,Albacete,129,140,-11
1993,03009,Alcoy/Alcoi,Alicante,289,315,-26
1993,03014,Alicante/Alacant,Alicante,2493,1910,583
1993,03015,Almoradí,Alicante,88,95,-7
1993,03018,Altea,Alicante,126,82,44
1993,03019,Aspe,Alicante,47,58,-11
1993,03031,Benidorm,Alicante,1310,688,622
1993,03047,Calp,Alicante,143,156,-13
1993,03049,Callosa de Segura,Alicante,62,103,-41
1993,03050,El Campello,Alicante,195,82,113
1993,03056,Cocentaina,Alicante,69,62,7
1993,03059,Crevillent,Alicante,64,89,-25
1993,03063,Dénia,Alicante,343,285,58
1993,03065,Elche/Elx,Alicante,644,733,-89
1993,03066,Elda,Alicante,171,187,-16
1993,03079,Ibi,Alicante,79,113,-34
1993,03082,Jávea/Xàbia,Alicante,146,146,0
1993,03089,Monóvar/Monòver,Alicante,27,33,-6
1993,03090,Mutxamel,Alicante,66,46,20
1993,03093,Novelda,Alicante,81,63,18
1993,03099,Orihuela,Alicante,385,684,-299
1993,03104,Petrer,Alicante,80,97,-17
1993,03119,Sant Joan d'Alacant,Alicante,154,121,33
1993,03121,Santa Pola,Alicante,222,151,71
1993,03122,San Vicente del Raspeig/Sant Vicent del Raspeig,Alicante,228,167,61
1993,03133,Torrevieja,Alicante,1522,604,918
1993,03139,Villajoyosa/La Vila Joiosa,Alicante,186,153,33
1993,03140,Villena,Alicante,158,158,0
1993,04003,Adra,Almería,147,163,-16
1993,04006,Albox,Almería,55,57,-2
1993,04013,Almería,Almería,1580,1224,356
1993,04029,Berja,Almería,70,70,0
1993,04053,Huércal-Overa,Almería,151,179,-28
1993,04066,Níjar,Almería,101,47,54
1993,04079,Roquetas de Mar,Almería,788,388,400
1993,04102,Vícar,Almería,210,77,133
1993,04902,El Ejido,Almería,522,336,186
1993,05019,Ávila,Ávila,483,516,-33
1993,06011,Almendralejo,Badajoz,173,131,42
1993,06015,Badajoz,Badajoz,1141,995,146
1993,06044,Don Benito,Badajoz,248,260,-12
1993,06070,Jerez de los Caballeros,Badajoz,82,46,36
1993,06083,Mérida,Badajoz,585,399,186
1993,06088,Montijo,Badajoz,103,140,-37
1993,06095,Olivenza,Badajoz,115,64,51
1993,06149,Villafranca de los Barros,Badajoz,75,79,-4
1993,06153,Villanueva de la Serena,Badajoz,166,203,-37
1993,06158,Zafra,Badajoz,164,157,7
1993,07011,Calvià,Baleares,520,503,17
1993,07015,Ciutadella de Menorca,Baleares,254,242,12
1993,07022,Felanitx,Baleares,111,126,-15
1993,07026,Eivissa,Baleares,557,865,-308
1993,07027,Inca,Baleares,83,79,4
1993,07031,Llucmajor,Baleares,200,188,12
1993,07032,Maó-Mahón,Baleares,330,485,-155
1993,07033,Manacor,Baleares,206,212,-6
1993,07036,Marratxí,Baleares,50,57,-7
1993,07040,Palma,Baleares,2919,2928,-9
1993,07042,Pollença,Baleares,122,94,28
1993,07044,Sa Pobla,Baleares,26,28,-2
1993,07046,Sant Antoni de Portmany,Baleares,213,308,-95
1993,07048,Sant Josep de sa Talaia,Baleares,186,158,28
1993,07054,Santa Eulària des Riu,Baleares,318,370,-52
1993,07061,Sóller,Baleares,35,26,9
1993,08006,Arenys de Mar,Barcelona,54,72,-18
1993,08015,Badalona,Barcelona,650,1306,-656
1993,08019,Barcelona,Barcelona,6002,12101,-6099
1993,08022,Berga,Barcelona,43,106,-63
1993,08033,Caldes de Montbui,Barcelona,39,28,11
1993,08035,Calella,Barcelona,122,118,4
1993,08041,Canovelles,Barcelona,92,62,30
1993,08051,Castellar del Vallès,Barcelona,63,93,-30
1993,08056,Castelldefels,Barcelona,401,522,-121
1993,08073,Cornellà de Llobregat,Barcelona,336,555,-219
1993,08076,Esparreguera,Barcelona,67,70,-3
1993,08077,Esplugues de Llobregat,Barcelona,208,371,-163
1993,08086,Les Franqueses del Vallès,Barcelona,65,51,14
1993,08089,Gavà,Barcelona,223,308,-85
1993,08096,Granollers,Barcelona,240,277,-37
1993,08101,L'Hospitalet de Llobregat,Barcelona,1074,1948,-874
1993,08102,Igualada,Barcelona,137,119,18
1993,08105,La Llagosta,Barcelona,55,80,-25
1993,08110,Malgrat de Mar,Barcelona,113,118,-5
1993,08112,Manlleu,Barcelona,70,76,-6
1993,08113,Manresa,Barcelona,204,226,-22
1993,08114,Martorell,Barcelona,87,180,-93
1993,08118,El Masnou,Barcelona,124,158,-34
1993,08121,Mataró,Barcelona,399,606,-207
1993,08123,Molins de Rei,Barcelona,65,82,-17
1993,08124,Mollet del Vallès,Barcelona,177,226,-49
1993,08125,Montcada i Reixac,Barcelona,88,189,-101
1993,08136,Montornès del Vallès,Barcelona,39,40,-1
1993,08147,Olesa de Montserrat,Barcelona,58,81,-23
1993,08159,Parets del Vallès,Barcelona,35,97,-62
1993,08163,Pineda de Mar,Barcelona,161,222,-61
1993,08169,El Prat de Llobregat,Barcelona,333,507,-174
1993,08172,Premià de Mar,Barcelona,141,229,-88
1993,08180,Ripollet,Barcelona,98,170,-72
1993,08184,Rubí,Barcelona,220,360,-140
1993,08187,Sabadell,Barcelona,731,1051,-320
1993,08194,Sant Adrià de Besòs,Barcelona,124,278,-154
1993,08196,Sant Andreu de la Barca,Barcelona,114,130,-16
1993,08200,Sant Boi de Llobregat,Barcelona,365,582,-217
1993,08202,Sant Celoni,Barcelona,83,132,-49
1993,08205,Sant Cugat del Vallès,Barcelona,286,279,7
1993,08211,Sant Feliu de Llobregat,Barcelona,161,259,-98
1993,08217,Sant Joan Despí,Barcelona,145,170,-25
1993,08219,Vilassar de Mar,Barcelona,83,113,-30
1993,08221,Sant Just Desvern,Barcelona,61,66,-5
1993,08231,Sant Pere de Ribes,Barcelona,135,124,11
1993,08245,Santa Coloma de Gramenet,Barcelona,477,949,-472
1993,08252,Barberà del Vallès,Barcelona,161,281,-120
1993,08260,Santa Perpètua de Mogoda,Barcelona,71,115,-44
1993,08263,Sant Vicenç dels Horts,Barcelona,80,181,-101
1993,08266,Cerdanyola del Vallès,Barcelona,325,394,-69
1993,08270,Sitges,Barcelona,192,112,80
1993,08279,Terrassa,Barcelona,528,699,-171
1993,08285,Torelló,Barcelona,26,49,-23
1993,08298,Vic,Barcelona,106,143,-37
1993,08301,Viladecans,Barcelona,249,422,-173
1993,08305,Vilafranca del Penedès,Barcelona,151,200,-49
1993,08307,Vilanova i la Geltrú,Barcelona,355,301,54
1993,09018,Aranda de Duero,Burgos,275,331,-56
1993,09059,Burgos,Burgos,1121,1421,-300
1993,09219,Miranda de Ebro,Burgos,388,459,-71
1993,10037,Cáceres,Cáceres,846,601,245
1993,10067,Coria,Cáceres,122,94,28
1993,10121,Miajadas,Cáceres,86,107,-21
1993,10131,Navalmoral de la Mata,Cáceres,203,237,-34
1993,10148,Plasencia,Cáceres,529,369,160
1993,11004,Algeciras,Cádiz,763,1041,-278
1993,11006,Arcos de la Frontera,Cádiz,139,232,-93
1993,11007,Barbate,Cádiz,231,349,-118
1993,11008,Los Barrios,Cádiz,136,95,41
1993,11012,Cádiz,Cádiz,523,930,-407
1993,11014,Conil de la Frontera,Cádiz,76,70,6
1993,11015,Chiclana de la Frontera,Cádiz,304,231,73
1993,11016,Chipiona,Cádiz,96,68,28
1993,11020,Jerez de la Frontera,Cádiz,1097,1458,-361
1993,11022,La Línea de la Concepción,Cádiz,403,464,-61
1993,11023,Medina-Sidonia,Cádiz,38,68,-30
1993,11027,El Puerto de Santa María,Cádiz,590,547,43
1993,11028,Puerto Real,Cádiz,113,88,25
1993,11030,Rota,Cádiz,227,195,32
1993,11031,San Fernando,Cádiz,606,611,-5
1993,11032,Sanlúcar de Barrameda,Cádiz,303,226,77
1993,11033,San Roque,Cádiz,244,224,20
1993,11035,Tarifa,Cádiz,131,124,7
1993,11038,Ubrique,Cádiz,40,87,-47
1993,11039,Vejer de la Frontera,Cádiz,37,51,-14
1993,11041,Villamartín,Cádiz,68,125,-57
1993,12009,Almassora,Castellón,94,57,37
1993,12027,Benicarló,Castellón,230,190,40
1993,12032,Borriana/Burriana,Castellón,135,122,13
1993,12040,Castellón de la Plana/Castelló de la Plana,Castellón,1209,997,212
1993,12082,Nules,Castellón,58,57,1
1993,12084,Onda,Castellón,90,43,47
1993,12126,La Vall d'Uixó,Castellón,125,136,-11
1993,12135,Vila-real,Castellón,198,132,66
1993,12138,Vinaròs,Castellón,358,239,119
1993,13005,Alcázar de San Juan,Ciudad Real,214,308,-94
1993,13023,Bolaños de Calatrava,Ciudad Real,33,25,8
1993,13028,Campo de Criptana,Ciudad Real,48,70,-22
1993,13034,Ciudad Real,Ciudad Real,780,603,177
1993,13039,Daimiel,Ciudad Real,82,80,2
1993,13053,Manzanares,Ciudad Real,178,201,-23
1993,13071,Puertollano,Ciudad Real,437,607,-170
1993,13078,Socuéllamos,Ciudad Real,86,92,-6
1993,13079,La Solana,Ciudad Real,50,54,-4
1993,13082,Tomelloso,Ciudad Real,164,153,11
1993,13087,Valdepeñas,Ciudad Real,219,182,37
1993,14002,Aguilar de la Frontera,Córdoba,77,36,41
1993,14007,Baena,Córdoba,132,133,-1
1993,14013,Cabra,Córdoba,202,148,54
1993,14021,Córdoba,Córdoba,1900,2166,-266
1993,14038,Lucena,Córdoba,289,157,132
1993,14042,Montilla,Córdoba,134,85,49
1993,14049,Palma del Río,Córdoba,190,195,-5
1993,14052,Peñarroya-Pueblonuevo,Córdoba,126,144,-18
1993,14054,Pozoblanco,Córdoba,67,79,-12
1993,14055,Priego de Córdoba,Córdoba,305,173,132
1993,14056,Puente Genil,Córdoba,213,162,51
1993,14058,Rute,Córdoba,119,87,32
1993,14069,Villanueva de Córdoba,Córdoba,48,70,-22
1993,15002,Ames,A Coruña,148,29,119
1993,15005,Arteixo,A Coruña,170,63,107
1993,15009,Betanzos,A Coruña,61,29,32
1993,15011,Boiro,A Coruña,52,51,1
1993,15017,Cambre,A Coruña,101,64,37
1993,15019,Carballo,A Coruña,60,69,-9
1993,15030,A Coruña,A Coruña,1737,1213,524
1993,15031,Culleredo,A Coruña,111,56,55
1993,15035,Fene,A Coruña,55,48,7
1993,15036,Ferrol,A Coruña,571,626,-55
1993,15041,A Laracha,A Coruña,20,27,-7
1993,15053,Muros,A Coruña,33,56,-23
1993,15054,Narón,A Coruña,157,154,3
1993,15057,Noia,A Coruña,86,64,22
1993,15058,Oleiros,A Coruña,222,97,125
1993,15059,Ordes,A Coruña,25,24,1
1993,15065,Padrón,A Coruña,73,88,-15
1993,15067,A Pobra do Caramiñal,A Coruña,46,48,-2
1993,15070,As Pontes de García Rodríguez,A Coruña,109,121,-12
1993,15071,Porto do Son,A Coruña,74,43,31
1993,15072,Rianxo,A Coruña,64,39,25
1993,15073,Ribeira,A Coruña,81,107,-26
1993,15077,Santa Comba,A Coruña,18,20,-2
1993,15078,Santiago de Compostela,A Coruña,868,456,412
1993,15082,Teo,A Coruña,79,55,24
1993,16078,Cuenca,Cuenca,419,437,-18
1993,16203,Tarancón,Cuenca,101,125,-24
1993,17015,Banyoles,Girona,118,106,12
1993,17023,Blanes,Girona,589,470,119
1993,17066,Figueres,Girona,325,423,-98
1993,17079,Girona,Girona,592,668,-76
1993,17095,Lloret de Mar,Girona,556,436,120
1993,17114,Olot,Girona,175,176,-1
1993,17117,Palafrugell,Girona,171,172,-1
1993,17118,Palamós,Girona,164,105,59
1993,17147,Ripoll,Girona,86,133,-47
1993,17152,Roses,Girona,220,218,2
1993,17155,Salt,Girona,147,159,-12
1993,17160,Sant Feliu de Guíxols,Girona,181,156,25
1993,18003,Albolote,Granada,110,25,85
1993,18017,Almuñécar,Granada,138,151,-13
1993,18021,Armilla,Granada,146,81,65
1993,18022,Atarfe,Granada,116,40,76
1993,18023,Baza,Granada,261,152,109
1993,18087,Granada,Granada,2568,2118,450
1993,18089,Guadix,Granada,172,260,-88
1993,18098,Huéscar,Granada,107,99,8
1993,18102,Illora,Granada,81,44,37
1993,18122,Loja,Granada,177,146,31
1993,18127,Maracena,Granada,79,84,-5
1993,18140,Motril,Granada,373,334,39
1993,18158,Pinos Puente,Granada,62,70,-8
1993,18175,Santa Fe,Granada,75,81,-6
1993,19046,Azuqueca de Henares,Guadalajara,742,179,563
1993,19130,Guadalajara,Guadalajara,1013,673,340
1993,20009,Andoain,Guipúzcoa,70,164,-94
1993,20017,Azkoitia,Guipúzcoa,22,73,-51
1993,20018,Azpeitia,Guipúzcoa,29,55,-26
1993,20019,Beasain,Guipúzcoa,55,101,-46
1993,20030,Eibar,Guipúzcoa,192,439,-247
1993,20032,Elgoibar,Guipúzcoa,44,139,-95
1993,20036,Hondarribia,Guipúzcoa,96,94,2
1993,20040,Hernani,Guipúzcoa,61,187,-126
1993,20045,Irun,Guipúzcoa,403,569,-166
1993,20055,Arrasate/Mondragón,Guipúzcoa,91,249,-158
1993,20059,Oñati,Guipúzcoa,18,55,-37
1993,20064,Pasaia,Guipúzcoa,68,137,-69
1993,20067,Errenteria,Guipúzcoa,198,295,-97
1993,20069,Donostia/San Sebastián,Guipúzcoa,1050,1228,-178
1993,20071,Tolosa,Guipúzcoa,55,93,-38
1993,20074,Bergara,Guipúzcoa,61,134,-73
1993,20079,Zarautz,Guipúzcoa,152,113,39
1993,20080,Zumarraga,Guipúzcoa,27,115,-88
1993,20902,Lasarte-Oria,Guipúzcoa,85,146,-61
1993,21005,Almonte,Huelva,178,145,33
1993,21010,Ayamonte,Huelva,113,156,-43
1993,21013,Bollullos Par del Condado,Huelva,30,53,-23
1993,21021,Cartaya,Huelva,66,56,10
1993,21035,Gibraleón,Huelva,29,37,-8
1993,21041,Huelva,Huelva,555,808,-253
1993,21042,Isla Cristina,Huelva,122,122,0
1993,21044,Lepe,Huelva,82,62,20
1993,21050,Moguer,Huelva,92,82,10
1993,21060,Punta Umbría,Huelva,82,51,31
1993,21072,Valverde del Camino,Huelva,29,50,-21
1993,22048,Barbastro,Huesca,118,112,6
1993,22112,Fraga,Huesca,139,140,-1
1993,22125,Huesca,Huesca,644,679,-35
1993,22130,Jaca,Huesca,215,250,-35
1993,22158,Monzón,Huesca,105,164,-59
1993,23002,Alcalá la Real,Jaén,207,246,-39
1993,23003,Alcaudete,Jaén,104,107,-3
1993,23005,Andújar,Jaén,291,397,-106
1993,23009,Baeza,Jaén,114,93,21
1993,23010,Bailén,Jaén,84,112,-28
1993,23024,La Carolina,Jaén,90,138,-48
1993,23050,Jaén,Jaén,664,799,-135
1993,23053,Jódar,Jaén,102,134,-32
1993,23055,Linares,Jaén,376,721,-345
1993,23060,Martos,Jaén,166,121,45
1993,23086,Torredelcampo,Jaén,44,36,8
1993,23087,Torredonjimeno,Jaén,78,81,-3
1993,23092,Úbeda,Jaén,209,274,-65
1993,23095,Villacarrillo,Jaén,97,159,-62
1993,24008,Astorga,León,154,134,20
1993,24010,La Bañeza,León,79,125,-46
1993,24014,Bembibre,León,97,113,-16
1993,24089,León,León,1194,1353,-159
1993,24115,Ponferrada,León,439,628,-189
1993,24142,San Andrés del Rabanedo,León,198,159,39
1993,24202,Villablino,León,63,177,-114
1993,25040,Balaguer,Lleida,80,111,-31
1993,25120,Lleida,Lleida,888,1069,-181
1993,25203,La Seu d'Urgell,Lleida,149,206,-57
1993,25217,Tàrrega,Lleida,105,98,7
1993,26018,Arnedo,La Rioja,27,80,-53
1993,26036,Calahorra,La Rioja,181,239,-58
1993,26089,Logroño,La Rioja,1188,1366,-178
1993,27013,Cervo,Lugo,113,105,8
1993,27016,Chantada,Lugo,78,65,13
1993,27028,Lugo,Lugo,585,504,81
1993,27031,Monforte de Lemos,Lugo,186,172,14
1993,27057,Sarria,Lugo,58,56,2
1993,27065,Vilalba,Lugo,71,79,-8
1993,27066,Viveiro,Lugo,93,111,-18
1993,28005,Alcalá de Henares,Madrid,1397,1951,-554
1993,28006,Alcobendas,Madrid,527,495,32
1993,28007,Alcorcón,Madrid,911,770,141
1993,28009,Algete,Madrid,116,96,20
1993,28013,Aranjuez,Madrid,311,293,18
1993,28014,Arganda del Rey,Madrid,142,147,-5
1993,28022,Boadilla del Monte,Madrid,73,132,-59
1993,28040,Ciempozuelos,Madrid,119,80,39
1993,28045,Colmenar Viejo,Madrid,201,163,38
1993,28047,Collado Villalba,Madrid,546,343,203
1993,28049,Coslada,Madrid,261,445,-184
1993,28058,Fuenlabrada,Madrid,1093,1727,-634
1993,28061,Galapagar,Madrid,195,124,71
1993,28065,Getafe,Madrid,784,878,-94
1993,28074,Leganés,Madrid,882,1015,-133
1993,28079,Madrid,Madrid,17072,21560,-4488
1993,28080,Majadahonda,Madrid,334,262,72
1993,28084,Mejorada del Campo,Madrid,93,132,-39
1993,28092,Móstoles,Madrid,1234,1781,-547
1993,28096,Navalcarnero,Madrid,109,67,42
1993,28106,Parla,Madrid,431,762,-331
1993,28113,Pinto,Madrid,173,141,32
1993,28115,Pozuelo de Alarcón,Madrid,402,315,87
1993,28123,Rivas-Vaciamadrid,Madrid,102,119,-17
1993,28127,Las Rozas de Madrid,Madrid,436,420,16
1993,28130,San Fernando de Henares,Madrid,163,160,3
1993,28134,San Sebastián de los Reyes,Madrid,323,333,-10
1993,28148,Torrejón de Ardoz,Madrid,598,710,-112
1993,28161,Valdemoro,Madrid,329,250,79
1993,28181,Villaviciosa de Odón,Madrid,90,110,-20
1993,28903,Tres Cantos,Madrid,393,86,307
1993,29007,Alhaurín de la Torre,Málaga,127,42,85
1993,29008,Alhaurín el Grande,Málaga,31,38,-7
1993,29012,Álora,Málaga,47,44,3
1993,29015,Antequera,Málaga,177,259,-82
1993,29017,Archidona,Málaga,44,38,6
1993,29025,Benalmádena,Málaga,434,251,183
1993,29038,Cártama,Málaga,31,38,-7
1993,29042,Coín,Málaga,48,52,-4
1993,29051,Estepona,Málaga,440,434,6
1993,29054,Fuengirola,Málaga,721,504,217
1993,29067,Málaga,Málaga,2259,2300,-41
1993,29069,Marbella,Málaga,1002,955,47
1993,29070,Mijas,Málaga,307,230,77
1993,29075,Nerja,Málaga,118,131,-13
1993,29082,Rincón de la Victoria,Málaga,237,99,138
1993,29084,Ronda,Málaga,365,318,47
1993,29091,Torrox,Málaga,49,52,-3
1993,29094,Vélez-Málaga,Málaga,358,317,41
1993,29901,Torremolinos,Málaga,620,335,285
1993,30002,Abarán,Murcia,34,36,-2
1993,30003,Águilas,Murcia,362,243,119
1993,30005,Alcantarilla,Murcia,287,159,128
1993,30008,Alhama de Murcia,Murcia,45,42,3
1993,30009,Archena,Murcia,70,60,10
1993,30012,Bullas,Murcia,39,17,22
1993,30015,Caravaca de la Cruz,Murcia,169,112,57
1993,30016,Cartagena,Murcia,1480,1287,193
1993,30017,Cehegín,Murcia,104,33,71
1993,30019,Cieza (Murcia),Murcia,70,124,-54
1993,30022,Jumilla,Murcia,111,130,-19
1993,30024,Lorca,Murcia,415,280,135
1993,30026,Mazarrón,Murcia,211,136,75
1993,30027,Molina de Segura,Murcia,216,229,-13
1993,30029,Mula,Murcia,44,37,7
1993,30030,Murcia,Murcia,2210,1652,558
1993,30033,Puerto Lumbreras,Murcia,89,69,20
1993,30035,San Javier,Murcia,414,240,174
1993,30036,San Pedro del Pinatar,Murcia,351,172,179
1993,30037,Torre-Pacheco,Murcia,122,95,27
1993,30038,Las Torres de Cotillas,Murcia,85,46,39
1993,30039,Totana,Murcia,69,48,21
1993,30041,La Unión,Murcia,93,92,1
1993,30043,Yecla,Murcia,208,261,-53
1993,31060,Burlada/Burlata,Navarra,102,88,14
1993,31097,Estella-Lizarra,Navarra,92,91,1
1993,31201,Pamplona/Iruña,Navarra,1344,1053,291
1993,31227,Tafalla,Navarra,75,24,51
1993,31232,Tudela,Navarra,264,197,67
1993,31901,Barañain,Navarra,192,149,43
1993,32009,O Barco de Valdeorras,Ourense,120,122,-2
1993,32019,O Carballiño,Ourense,92,87,5
1993,32054,Ourense,Ourense,587,805,-218
1993,32085,Verín,Ourense,98,104,-6
1993,33002,Aller,Asturias,36,52,-16
1993,33004,Avilés,Asturias,403,453,-50
1993,33011,Cangas del Narcea,Asturias,59,114,-55
1993,33014,Carreño,Asturias,28,23,5
1993,33016,Castrillón,Asturias,99,130,-31
1993,33020,Corvera de Asturias,Asturias,85,70,15
1993,33024,Gijón,Asturias,1409,1316,93
1993,33025,Gozón,Asturias,34,22,12
1993,33026,Grado,Asturias,18,24,-6
1993,33031,Langreo,Asturias,111,201,-90
1993,33032,Laviana,Asturias,7,11,-4
1993,33033,Lena,Asturias,50,87,-37
1993,33034,Valdés,Asturias,53,60,-7
1993,33035,Llanera,Asturias,54,17,37
1993,33036,Llanes,Asturias,98,63,35
1993,33037,Mieres (Asturias),Asturias,114,200,-86
1993,33044,Oviedo,Asturias,1126,1034,92
1993,33051,Pravia,Asturias,42,39,3
1993,33060,San Martín del Rey Aurelio,Asturias,38,80,-42
1993,33066,Siero,Asturias,196,126,70
1993,33073,Tineo,Asturias,16,52,-36
1993,33076,Villaviciosa,Asturias,40,39,1
1993,34120,Palencia,Palencia,784,673,111
1993,35002,Agüimes,Las Palmas,72,36,36
1993,35004,Arrecife,Las Palmas,576,556,20
1993,35006,Arucas,Las Palmas,61,42,19
1993,35009,Gáldar,Las Palmas,50,21,29
1993,35011,Ingenio,Las Palmas,51,32,19
1993,35016,Las Palmas de Gran Canaria,Las Palmas,3274,2794,480
1993,35017,Puerto del Rosario,Las Palmas,313,246,67
1993,35019,San Bartolomé de Tirajana,Las Palmas,521,311,210
1993,35021,Santa Brígida,Las Palmas,73,83,-10
1993,35022,Santa Lucía de Tirajana,Las Palmas,105,86,19
1993,35023,Santa María de Guía de Gran Canaria,Las Palmas,25,31,-6
1993,35026,Telde,Las Palmas,354,294,60
1993,35027,Teror,Las Palmas,18,15,3
1993,36003,Baiona,Pontevedra,46,34,12
1993,36004,Bueu,Pontevedra,20,34,-14
1993,36006,Cambados,Pontevedra,40,38,2
1993,36008,Cangas,Pontevedra,61,75,-14
1993,36017,A Estrada,Pontevedra,170,94,76
1993,36021,Gondomar,Pontevedra,25,15,10
1993,36022,O Grove,Pontevedra,66,43,23
1993,36023,A Guarda,Pontevedra,40,49,-9
1993,36024,Lalín,Pontevedra,65,64,1
1993,36026,Marín,Pontevedra,157,200,-43
1993,36029,Moaña,Pontevedra,36,65,-29
1993,36033,Mos,Pontevedra,28,19,9
1993,36035,Nigrán,Pontevedra,63,36,27
1993,36038,Pontevedra,Pontevedra,377,449,-72
1993,36039,O Porriño,Pontevedra,54,63,-9
1993,36041,Poio,Pontevedra,66,42,24
1993,36042,Ponteareas,Pontevedra,72,56,16
1993,36045,Redondela,Pontevedra,89,79,10
1993,36051,Sanxenxo,Pontevedra,44,59,-15
1993,36052,Silleda,Pontevedra,39,38,1
1993,36054,Tomiño,Pontevedra,59,31,28
1993,36055,Tui,Pontevedra,84,57,27
1993,36057,Vigo,Pontevedra,1559,1528,31
1993,36060,Vilagarcía de Arousa,Pontevedra,179,252,-73
1993,36061,Vilanova de Arousa,Pontevedra,19,44,-25
1993,37046,Béjar,Salamanca,119,144,-25
1993,37107,Ciudad Rodrigo,Salamanca,129,143,-14
1993,37274,Salamanca,Salamanca,1579,1516,63
1993,38001,Adeje,Santa Cruz de Tenerife,279,116,163
1993,38006,Arona,Santa Cruz de Tenerife,640,457,183
1993,38011,Candelaria,Santa Cruz de Tenerife,166,87,79
1993,38017,Granadilla de Abona,Santa Cruz de Tenerife,216,191,25
1993,38019,Guía de Isora,Santa Cruz de Tenerife,37,22,15
1993,38020,Güímar,Santa Cruz de Tenerife,51,14,37
1993,38022,Icod de los Vinos,Santa Cruz de Tenerife,45,26,19
1993,38023,San Cristóbal de La Laguna,Santa Cruz de Tenerife,658,454,204
1993,38024,Los Llanos de Aridane,Santa Cruz de Tenerife,70,56,14
1993,38026,La Orotava,Santa Cruz de Tenerife,91,75,16
1993,38028,Puerto de la Cruz,Santa Cruz de Tenerife,264,171,93
1993,38031,Los Realejos,Santa Cruz de Tenerife,40,51,-11
1993,38037,Santa Cruz de la Palma,Santa Cruz de Tenerife,175,155,20
1993,38038,Santa Cruz de Tenerife,Santa Cruz de Tenerife,1555,1075,480
1993,38043,Tacoronte,Santa Cruz de Tenerife,37,34,3
1993,39008,El Astillero,Cantabria,73,65,8
1993,39016,Camargo,Cantabria,86,89,-3
1993,39020,Castro-Urdiales,Cantabria,449,238,211
1993,39035,Laredo,Cantabria,201,96,105
1993,39059,Reinosa,Cantabria,65,85,-20
1993,39075,Santander,Cantabria,1174,1146,28
1993,39079,Santoña,Cantabria,84,80,4
1993,39087,Torrelavega,Cantabria,171,223,-52
1993,40194,Segovia,Segovia,377,486,-109
1993,41004,Alcalá de Guadaíra,Sevilla,284,204,80
1993,41007,La Algaba,Sevilla,27,19,8
1993,41011,Arahal,Sevilla,40,30,10
1993,41018,Brenes,Sevilla,50,56,-6
1993,41020,Las Cabezas de San Juan,Sevilla,107,106,1
1993,41021,Camas,Sevilla,104,98,6
1993,41024,Carmona,Sevilla,112,87,25
1993,41029,Castilleja de la Cuesta,Sevilla,74,53,21
1993,41034,Coria del Río,Sevilla,109,62,47
1993,41038,Dos Hermanas,Sevilla,629,356,273
1993,41039,Écija,Sevilla,272,191,81
1993,41041,Estepa,Sevilla,61,53,8
1993,41053,Lebrija,Sevilla,140,156,-16
1993,41055,Lora del Río,Sevilla,106,143,-37
1993,41058,Mairena del Alcor,Sevilla,72,31,41
1993,41059,Mairena del Aljarafe,Sevilla,378,157,221
1993,41060,Marchena,Sevilla,54,32,22
1993,41065,Morón de la Frontera,Sevilla,273,214,59
1993,41068,Osuna,Sevilla,100,69,31
1993,41069,Los Palacios y Villafranca,Sevilla,99,92,7
1993,41075,Pilas,Sevilla,40,24,16
1993,41077,La Puebla de Cazalla,Sevilla,198,119,79
1993,41079,La Puebla del Río,Sevilla,59,78,-19
1993,41081,La Rinconada,Sevilla,205,45,160
1993,41086,San Juan de Aznalfarache,Sevilla,143,92,51
1993,41091,Sevilla,Sevilla,4743,3109,1634
1993,41093,Tomares,Sevilla,262,125,137
1993,41095,Utrera,Sevilla,282,181,101
1993,41102,El Viso del Alcor,Sevilla,29,13,16
1993,42173,Soria,Soria,339,410,-71
1993,43014,Amposta,Tarragona,78,67,11
1993,43038,Cambrils,Tarragona,427,188,239
1993,43123,Reus,Tarragona,848,501,347
1993,43136,Sant Carles de la Ràpita,Tarragona,90,81,9
1993,43148,Tarragona,Tarragona,1046,911,135
1993,43155,Tortosa,Tarragona,191,153,38
1993,43161,Valls,Tarragona,142,118,24
1993,43163,El Vendrell,Tarragona,845,299,546
1993,43171,Vila-seca,Tarragona,194,108,86
1993,43901,Deltebre,Tarragona,34,32,2
1993,44013,Alcañiz,Teruel,113,138,-25
1993,44216,Teruel,Teruel,336,404,-68
1993,45053,Consuegra,Toledo,50,45,5
1993,45087,Madridejos,Toledo,51,67,-16
1993,45165,Talavera de la Reina,Toledo,714,561,153
1993,45168,Toledo,Toledo,800,624,176
1993,46005,Alaquàs,Valencia,85,112,-27
1993,46013,Alboraya,Valencia,80,30,50
1993,46017,Alzira,Valencia,103,139,-36
1993,46019,L'Alcúdia,Valencia,24,23,1
1993,46021,Aldaia,Valencia,81,79,2
1993,46022,Alfafar,Valencia,97,64,33
1993,46029,Algemesí,Valencia,90,48,42
1993,46031,Alginet,Valencia,23,22,1
1993,46054,Benetússer,Valencia,44,65,-21
1993,46060,Benifaió,Valencia,42,28,14
1993,46070,Bétera,Valencia,69,47,22
1993,46078,Burjassot,Valencia,128,115,13
1993,46081,Canals,Valencia,37,32,5
1993,46083,Carcaixent,Valencia,73,71,2
1993,46085,Carlet,Valencia,42,20,22
1993,46094,Catarroja,Valencia,51,46,5
1993,46102,Quart de Poblet,Valencia,170,137,33
1993,46105,Cullera,Valencia,131,109,22
1993,46110,Xirivella,Valencia,158,100,58
1993,46131,Gandia,Valencia,525,393,132
1993,46135,Godella,Valencia,40,47,-7
1993,46145,Xátiva,Valencia,60,97,-37
1993,46147,Llíria,Valencia,98,44,54
1993,46159,Manises,Valencia,79,81,-2
1993,46164,Massamagrell,Valencia,39,38,1
1993,46169,Mislata,Valencia,237,197,40
1993,46171,Moncada,Valencia,47,40,7
1993,46181,Oliva,Valencia,66,122,-56
1993,46184,Ontinyent,Valencia,72,127,-55
1993,46186,Paiporta,Valencia,108,76,32
1993,46190,Paterna,Valencia,202,229,-27
1993,46194,Picassent,Valencia,48,51,-3
1993,46205,Puçol,Valencia,36,59,-23
1993,46213,Requena,Valencia,113,101,12
1993,46214,Riba-roja de Túria,Valencia,53,38,15
1993,46220,Sagunto/Sagunt,Valencia,295,294,1
1993,46230,Silla,Valencia,85,84,1
1993,46235,Sueca,Valencia,41,60,-19
1993,46238,Tavernes de la Valldigna,Valencia,47,51,-4
1993,46244,Torrent (Valencia),Valencia,258,220,38
1993,46249,Utiel,Valencia,35,44,-9
1993,46250,València,Valencia,4885,4165,720
1993,47076,Laguna de Duero,Valladolid,153,165,-12
1993,47085,Medina del Campo,Valladolid,181,206,-25
1993,47186,Valladolid,Valladolid,2492,2736,-244
1993,48003,Amorebieta-Etxano,Vizcaya,57,110,-53
1993,48011,Arrigorriaga,Vizcaya,60,78,-18
1993,48013,Barakaldo,Vizcaya,430,869,-439
1993,48015,Basauri,Vizcaya,202,443,-241
1993,48017,Bermeo,Vizcaya,69,74,-5
1993,48020,Bilbao,Vizcaya,1938,3104,-1166
1993,48027,Durango,Vizcaya,125,163,-38
1993,48034,Ermua,Vizcaya,126,324,-198
1993,48036,Galdakao,Vizcaya,114,192,-78
1993,48044,Getxo,Vizcaya,497,618,-121
1993,48046,Gernika-Lumo,Vizcaya,35,80,-45
1993,48054,Leioa,Vizcaya,128,187,-59
1993,48069,Mungia,Vizcaya,62,79,-17
1993,48073,Ondarroa,Vizcaya,55,141,-86
1993,48078,Portugalete,Vizcaya,184,462,-278
1993,48080,Valle de Trápaga-Trapagaran,Vizcaya,40,93,-53
1993,48082,Santurtzi,Vizcaya,207,420,-213
1993,48084,Sestao,Vizcaya,139,312,-173
1993,48902,Erandio,Vizcaya,81,148,-67
1993,49021,Benavente,Zamora,253,194,59
1993,49275,Zamora,Zamora,449,648,-199
1993,50067,Calatayud,Zaragoza,117,135,-18
1993,50095,Ejea de los Caballeros,Zaragoza,57,76,-19
1993,50251,Tarazona,Zaragoza,121,117,4
1993,50297,Zaragoza,Zaragoza,4513,3589,924
1993,51001,Ceuta,Ceuta,1137,1123,14
1993,52001,Melilla,Melilla,1539,1257,282
1994,01036,Laudio/Llodio,Álava,206,256,-50
1994,01059,Vitoria-Gasteiz,Álava,2255,1979,276
1994,02003,Albacete,Albacete,1474,1324,150
1994,02009,Almansa,Albacete,188,211,-23
1994,02037,Hellín,Albacete,311,289,22
1994,02069,La Roda,Albacete,116,123,-7
1994,02081,Villarrobledo,Albacete,151,187,-36
1994,03009,Alcoy/Alcoi,Alicante,328,263,65
1994,03011,L'Alfàs del Pi,Alicante,137,54,83
1994,03014,Alicante/Alacant,Alicante,2969,2105,864
1994,03015,Almoradí,Alicante,79,50,29
1994,03018,Altea,Alicante,181,111,70
1994,03019,Aspe,Alicante,61,51,10
1994,03031,Benidorm,Alicante,1467,677,790
1994,03047,Calp,Alicante,209,103,106
1994,03049,Callosa de Segura,Alicante,97,82,15
1994,03050,El Campello,Alicante,286,116,170
1994,03056,Cocentaina,Alicante,85,51,34
1994,03059,Crevillent,Alicante,96,100,-4
1994,03063,Dénia,Alicante,351,272,79
1994,03065,Elche/Elx,Alicante,843,705,138
1994,03066,Elda,Alicante,213,216,-3
1994,03079,Ibi,Alicante,62,102,-40
1994,03082,Jávea/Xàbia,Alicante,184,157,27
1994,03089,Monóvar/Monòver,Alicante,29,27,2
1994,03090,Mutxamel,Alicante,111,64,47
1994,03093,Novelda,Alicante,84,99,-15
1994,03099,Orihuela,Alicante,461,594,-133
1994,03104,Petrer,Alicante,84,62,22
1994,03119,Sant Joan d'Alacant,Alicante,238,130,108
1994,03121,Santa Pola,Alicante,279,177,102
1994,03122,San Vicente del Raspeig/Sant Vicent del Raspeig,Alicante,257,172,85
1994,03133,Torrevieja,Alicante,2059,600,1459
1994,03139,Villajoyosa/La Vila Joiosa,Alicante,192,136,56
1994,03140,Villena,Alicante,156,153,3
1994,04003,Adra,Almería,162,227,-65
1994,04006,Albox,Almería,33,39,-6
1994,04013,Almería,Almería,1436,1301,135
1994,04029,Berja,Almería,101,62,39
1994,04053,Huércal-Overa,Almería,138,169,-31
1994,04066,Níjar,Almería,128,55,73
1994,04079,Roquetas de Mar,Almería,857,477,380
1994,04102,Vícar,Almería,233,115,118
1994,04902,El Ejido,Almería,691,327,364
1994,05019,Ávila,Ávila,453,627,-174
1994,06011,Almendralejo,Badajoz,158,141,17
1994,06014,Azuaga,Badajoz,117,79,38
1994,06015,Badajoz,Badajoz,1279,1136,143
1994,06044,Don Benito,Badajoz,213,203,10
1994,06070,Jerez de los Caballeros,Badajoz,32,58,-26
1994,06083,Mérida,Badajoz,533,472,61
1994,06088,Montijo,Badajoz,153,157,-4
1994,06095,Olivenza,Badajoz,75,70,5
1994,06149,Villafranca de los Barros,Badajoz,87,72,15
1994,06153,Villanueva de la Serena,Badajoz,234,173,61
1994,06158,Zafra,Badajoz,92,148,-56
1994,07011,Calvià,Baleares,676,384,292
1994,07015,Ciutadella de Menorca,Baleares,268,185,83
1994,07022,Felanitx,Baleares,84,60,24
1994,07026,Eivissa,Baleares,677,658,19
1994,07027,Inca,Baleares,150,123,27
1994,07031,Llucmajor,Baleares,194,137,57
1994,07032,Maó-Mahón,Baleares,440,316,124
1994,07033,Manacor,Baleares,280,169,111
1994,07036,Marratxí,Baleares,54,63,-9
1994,07040,Palma,Baleares,3270,2763,507
1994,07042,Pollença,Baleares,110,66,44
1994,07044,Sa Pobla,Baleares,42,27,15
1994,07046,Sant Antoni de Portmany,Baleares,272,179,93
1994,07048,Sant Josep de sa Talaia,Baleares,191,147,44
1994,07054,Santa Eulària des Riu,Baleares,339,261,78
1994,07061,Sóller,Baleares,70,34,36
1994,08006,Arenys de Mar,Barcelona,54,74,-20
1994,08015,Badalona,Barcelona,676,1418,-742
1994,08019,Barcelona,Barcelona,6541,12569,-6028
1994,08022,Berga,Barcelona,93,115,-22
1994,08033,Caldes de Montbui,Barcelona,35,36,-1
1994,08035,Calella,Barcelona,125,129,-4
1994,08041,Canovelles,Barcelona,74,97,-23
1994,08046,Cardedeu,Barcelona,44,59,-15
1994,08051,Castellar del Vallès,Barcelona,56,63,-7
1994,08056,Castelldefels,Barcelona,358,424,-66
1994,08073,Cornellà de Llobregat,Barcelona,322,685,-363
1994,08076,Esparreguera,Barcelona,84,80,4
1994,08077,Esplugues de Llobregat,Barcelona,178,359,-181
1994,08086,Les Franqueses del Vallès,Barcelona,37,53,-16
1994,08088,La Garriga,Barcelona,29,41,-12
1994,08089,Gavà,Barcelona,227,269,-42
1994,08096,Granollers,Barcelona,229,365,-136
1994,08101,L'Hospitalet de Llobregat,Barcelona,1050,1999,-949
1994,08102,Igualada,Barcelona,142,147,-5
1994,08105,La Llagosta,Barcelona,49,114,-65
1994,08110,Malgrat de Mar,Barcelona,124,112,12
1994,08112,Manlleu,Barcelona,82,118,-36
1994,08113,Manresa,Barcelona,201,302,-101
1994,08114,Martorell,Barcelona,113,131,-18
1994,08118,El Masnou,Barcelona,123,167,-44
1994,08121,Mataró,Barcelona,452,633,-181
1994,08123,Molins de Rei,Barcelona,42,109,-67
1994,08124,Mollet del Vallès,Barcelona,184,268,-84
1994,08125,Montcada i Reixac,Barcelona,82,136,-54
1994,08136,Montornès del Vallès,Barcelona,32,70,-38
1994,08147,Olesa de Montserrat,Barcelona,59,68,-9
1994,08159,Parets del Vallès,Barcelona,48,76,-28
1994,08163,Pineda de Mar,Barcelona,164,209,-45
1994,08169,El Prat de Llobregat,Barcelona,258,559,-301
1994,08172,Premià de Mar,Barcelona,210,260,-50
1994,08180,Ripollet,Barcelona,135,229,-94
1994,08184,Rubí,Barcelona,224,413,-189
1994,08187,Sabadell,Barcelona,689,1056,-367
1994,08194,Sant Adrià de Besòs,Barcelona,160,162,-2
1994,08196,Sant Andreu de la Barca,Barcelona,208,184,24
1994,08200,Sant Boi de Llobregat,Barcelona,308,430,-122
1994,08202,Sant Celoni,Barcelona,101,112,-11
1994,08205,Sant Cugat del Vallès,Barcelona,337,293,44
1994,08211,Sant Feliu de Llobregat,Barcelona,133,300,-167
1994,08217,Sant Joan Despí,Barcelona,145,165,-20
1994,08219,Vilassar de Mar,Barcelona,97,86,11
1994,08221,Sant Just Desvern,Barcelona,74,96,-22
1994,08231,Sant Pere de Ribes,Barcelona,144,115,29
1994,08245,Santa Coloma de Gramenet,Barcelona,461,978,-517
1994,08252,Barberà del Vallès,Barcelona,147,230,-83
1994,08260,Santa Perpètua de Mogoda,Barcelona,51,167,-116
1994,08263,Sant Vicenç dels Horts,Barcelona,82,136,-54
1994,08266,Cerdanyola del Vallès,Barcelona,262,492,-230
1994,08270,Sitges,Barcelona,205,103,102
1994,08279,Terrassa,Barcelona,540,835,-295
1994,08285,Torelló,Barcelona,40,43,-3
1994,08298,Vic,Barcelona,108,184,-76
1994,08301,Viladecans,Barcelona,234,530,-296
1994,08305,Vilafranca del Penedès,Barcelona,204,185,19
1994,08307,Vilanova i la Geltrú,Barcelona,295,372,-77
1994,09018,Aranda de Duero,Burgos,265,358,-93
1994,09059,Burgos,Burgos,1177,1421,-244
1994,09219,Miranda de Ebro,Burgos,420,522,-102
1994,10037,Cáceres,Cáceres,808,701,107
1994,10067,Coria,Cáceres,157,150,7
1994,10121,Miajadas,Cáceres,86,120,-34
1994,10131,Navalmoral de la Mata,Cáceres,292,200,92
1994,10148,Plasencia,Cáceres,367,343,24
1994,11004,Algeciras,Cádiz,811,995,-184
1994,11006,Arcos de la Frontera,Cádiz,131,198,-67
1994,11007,Barbate,Cádiz,173,274,-101
1994,11008,Los Barrios,Cádiz,124,74,50
1994,11012,Cádiz,Cádiz,527,982,-455
1994,11014,Conil de la Frontera,Cádiz,98,56,42
1994,11015,Chiclana de la Frontera,Cádiz,378,278,100
1994,11016,Chipiona,Cádiz,99,71,28
1994,11020,Jerez de la Frontera,Cádiz,977,1559,-582
1994,11022,La Línea de la Concepción,Cádiz,557,497,60
1994,11023,Medina-Sidonia,Cádiz,39,44,-5
1994,11027,El Puerto de Santa María,Cádiz,800,729,71
1994,11028,Puerto Real,Cádiz,126,126,0
1994,11030,Rota,Cádiz,292,210,82
1994,11031,San Fernando,Cádiz,853,790,63
1994,11032,Sanlúcar de Barrameda,Cádiz,237,260,-23
1994,11033,San Roque,Cádiz,228,236,-8
1994,11035,Tarifa,Cádiz,176,112,64
1994,11038,Ubrique,Cádiz,49,86,-37
1994,11039,Vejer de la Frontera,Cádiz,47,58,-11
1994,11041,Villamartín,Cádiz,74,120,-46
1994,12009,Almassora,Castellón,78,88,-10
1994,12027,Benicarló,Castellón,190,198,-8
1994,12032,Borriana/Burriana,Castellón,183,114,69
1994,12040,Castellón de la Plana/Castelló de la Plana,Castellón,1331,999,332
1994,12082,Nules,Castellón,59,30,29
1994,12084,Onda,Castellón,76,43,33
1994,12126,La Vall d'Uixó,Castellón,137,128,9
1994,12135,Vila-real,Castellón,195,159,36
1994,12138,Vinaròs,Castellón,381,268,113
1994,13005,Alcázar de San Juan,Ciudad Real,231,338,-107
1994,13023,Bolaños de Calatrava,Ciudad Real,44,26,18
1994,13028,Campo de Criptana,Ciudad Real,69,120,-51
1994,13034,Ciudad Real,Ciudad Real,724,627,97
1994,13039,Daimiel,Ciudad Real,97,112,-15
1994,13053,Manzanares,Ciudad Real,167,190,-23
1994,13071,Puertollano,Ciudad Real,403,440,-37
1994,13078,Socuéllamos,Ciudad Real,85,100,-15
1994,13079,La Solana,Ciudad Real,60,76,-16
1994,13082,Tomelloso,Ciudad Real,116,148,-32
1994,13087,Valdepeñas,Ciudad Real,188,189,-1
1994,14002,Aguilar de la Frontera,Córdoba,37,55,-18
1994,14007,Baena,Córdoba,144,119,25
1994,14013,Cabra,Córdoba,128,120,8
1994,14021,Córdoba,Córdoba,1866,2257,-391
1994,14038,Lucena,Córdoba,241,180,61
1994,14042,Montilla,Córdoba,119,132,-13
1994,14049,Palma del Río,Córdoba,156,150,6
1994,14052,Peñarroya-Pueblonuevo,Córdoba,96,137,-41
1994,14054,Pozoblanco,Córdoba,81,92,-11
1994,14055,Priego de Córdoba,Córdoba,203,212,-9
1994,14056,Puente Genil,Córdoba,221,218,3
1994,14058,Rute,Córdoba,72,74,-2
1994,14069,Villanueva de Córdoba,Córdoba,55,56,-1
1994,15002,Ames,A Coruña,137,36,101
1994,15005,Arteixo,A Coruña,103,70,33
1994,15009,Betanzos,A Coruña,108,76,32
1994,15011,Boiro,A Coruña,83,92,-9
1994,15017,Cambre,A Coruña,112,62,50
1994,15019,Carballo,A Coruña,77,91,-14
1994,15030,A Coruña,A Coruña,1908,1502,406
1994,15031,Culleredo,A Coruña,118,62,56
1994,15035,Fene,A Coruña,53,50,3
1994,15036,Ferrol,A Coruña,687,798,-111
1994,15041,A Laracha,A Coruña,11,20,-9
1994,15053,Muros,A Coruña,41,80,-39
1994,15054,Narón,A Coruña,197,270,-73
1994,15057,Noia,A Coruña,86,101,-15
1994,15058,Oleiros,A Coruña,281,124,157
1994,15059,Ordes,A Coruña,36,28,8
1994,15065,Padrón,A Coruña,61,67,-6
1994,15067,A Pobra do Caramiñal,A Coruña,49,39,10
1994,15070,As Pontes de García Rodríguez,A Coruña,80,179,-99
1994,15071,Porto do Son,A Coruña,41,60,-19
1994,15072,Rianxo,A Coruña,34,49,-15
1994,15073,Ribeira,A Coruña,108,90,18
1994,15077,Santa Comba,A Coruña,14,15,-1
1994,15078,Santiago de Compostela,A Coruña,776,553,223
1994,15082,Teo,A Coruña,83,76,7
1994,16078,Cuenca,Cuenca,475,533,-58
1994,16203,Tarancón,Cuenca,100,174,-74
1994,17015,Banyoles,Girona,95,66,29
1994,17023,Blanes,Girona,577,502,75
1994,17066,Figueres,Girona,351,387,-36
1994,17079,Girona,Girona,655,681,-26
1994,17095,Lloret de Mar,Girona,569,367,202
1994,17114,Olot,Girona,152,159,-7
1994,17117,Palafrugell,Girona,174,191,-17
1994,17118,Palamós,Girona,232,154,78
1994,17147,Ripoll,Girona,122,128,-6
1994,17152,Roses,Girona,244,205,39
1994,17155,Salt,Girona,145,181,-36
1994,17160,Sant Feliu de Guíxols,Girona,241,168,73
1994,18003,Albolote,Granada,92,137,-45
1994,18017,Almuñécar,Granada,145,147,-2
1994,18021,Armilla,Granada,116,109,7
1994,18022,Atarfe,Granada,95,66,29
1994,18023,Baza,Granada,186,224,-38
1994,18087,Granada,Granada,2713,2467,246
1994,18089,Guadix,Granada,160,231,-71
1994,18098,Huéscar,Granada,84,121,-37
1994,18102,Illora,Granada,80,72,8
1994,18122,Loja,Granada,148,171,-23
1994,18127,Maracena,Granada,59,67,-8
1994,18140,Motril,Granada,372,343,29
1994,18158,Pinos Puente,Granada,54,56,-2
1994,18175,Santa Fe,Granada,76,101,-25
1994,18193,La Zubia,Granada,89,41,48
1994,19046,Azuqueca de Henares,Guadalajara,1035,239,796
1994,19130,Guadalajara,Guadalajara,1117,759,358
1994,20009,Andoain,Guipúzcoa,49,108,-59
1994,20017,Azkoitia,Guipúzcoa,22,55,-33
1994,20018,Azpeitia,Guipúzcoa,64,54,10
1994,20019,Beasain,Guipúzcoa,50,97,-47
1994,20030,Eibar,Guipúzcoa,241,450,-209
1994,20032,Elgoibar,Guipúzcoa,75,111,-36
1994,20036,Hondarribia,Guipúzcoa,82,111,-29
1994,20040,Hernani,Guipúzcoa,73,158,-85
1994,20045,Irun,Guipúzcoa,488,634,-146
1994,20055,Arrasate/Mondragón,Guipúzcoa,120,292,-172
1994,20059,Oñati,Guipúzcoa,53,69,-16
1994,20064,Pasaia,Guipúzcoa,73,126,-53
1994,20067,Errenteria,Guipúzcoa,162,338,-176
1994,20069,Donostia/San Sebastián,Guipúzcoa,1240,1339,-99
1994,20071,Tolosa,Guipúzcoa,82,142,-60
1994,20074,Bergara,Guipúzcoa,59,119,-60
1994,20079,Zarautz,Guipúzcoa,189,146,43
1994,20080,Zumarraga,Guipúzcoa,42,101,-59
1994,20902,Lasarte-Oria,Guipúzcoa,72,152,-80
1994,21005,Almonte,Huelva,119,140,-21
1994,21010,Ayamonte,Huelva,163,121,42
1994,21013,Bollullos Par del Condado,Huelva,43,44,-1
1994,21021,Cartaya,Huelva,91,66,25
1994,21035,Gibraleón,Huelva,42,56,-14
1994,21041,Huelva,Huelva,613,868,-255
1994,21042,Isla Cristina,Huelva,96,87,9
1994,21044,Lepe,Huelva,118,96,22
1994,21050,Moguer,Huelva,88,86,2
1994,21060,Punta Umbría,Huelva,62,64,-2
1994,21072,Valverde del Camino,Huelva,21,35,-14
1994,22048,Barbastro,Huesca,182,173,9
1994,22112,Fraga,Huesca,161,131,30
1994,22125,Huesca,Huesca,574,619,-45
1994,22130,Jaca,Huesca,302,215,87
1994,22158,Monzón,Huesca,146,96,50
1994,23002,Alcalá la Real,Jaén,218,216,2
1994,23003,Alcaudete,Jaén,98,125,-27
1994,23005,Andújar,Jaén,275,403,-128
1994,23009,Baeza,Jaén,186,127,59
1994,23010,Bailén,Jaén,86,101,-15
1994,23024,La Carolina,Jaén,110,137,-27
1994,23050,Jaén,Jaén,680,898,-218
1994,23053,Jódar,Jaén,81,148,-67
1994,23055,Linares,Jaén,374,681,-307
1994,23060,Martos,Jaén,210,112,98
1994,23086,Torredelcampo,Jaén,62,37,25
1994,23087,Torredonjimeno,Jaén,79,65,14
1994,23092,Úbeda,Jaén,236,356,-120
1994,23095,Villacarrillo,Jaén,104,148,-44
1994,24008,Astorga,León,144,115,29
1994,24010,La Bañeza,León,112,114,-2
1994,24014,Bembibre,León,102,123,-21
1994,24089,León,León,1204,1278,-74
1994,24115,Ponferrada,León,482,570,-88
1994,24142,San Andrés del Rabanedo,León,252,186,66
1994,24202,Villablino,León,98,172,-74
1994,25040,Balaguer,Lleida,75,103,-28
1994,25120,Lleida,Lleida,876,1140,-264
1994,25203,La Seu d'Urgell,Lleida,213,250,-37
1994,25217,Tàrrega,Lleida,141,116,25
1994,26018,Arnedo,La Rioja,80,74,6
1994,26036,Calahorra,La Rioja,225,198,27
1994,26089,Logroño,La Rioja,1294,1356,-62
1994,27013,Cervo,Lugo,136,170,-34
1994,27016,Chantada,Lugo,66,99,-33
1994,27028,Lugo,Lugo,742,645,97
1994,27031,Monforte de Lemos,Lugo,178,174,4
1994,27057,Sarria,Lugo,78,77,1
1994,27065,Vilalba,Lugo,93,88,5
1994,27066,Viveiro,Lugo,141,126,15
1994,28005,Alcalá de Henares,Madrid,1455,2277,-822
1994,28006,Alcobendas,Madrid,553,624,-71
1994,28007,Alcorcón,Madrid,858,917,-59
1994,28009,Algete,Madrid,99,152,-53
1994,28013,Aranjuez,Madrid,386,410,-24
1994,28014,Arganda del Rey,Madrid,132,160,-28
1994,28022,Boadilla del Monte,Madrid,82,120,-38
1994,28040,Ciempozuelos,Madrid,80,46,34
1994,28045,Colmenar Viejo,Madrid,266,209,57
1994,28047,Collado Villalba,Madrid,568,409,159
1994,28049,Coslada,Madrid,308,560,-252
1994,28058,Fuenlabrada,Madrid,1135,2229,-1094
1994,28061,Galapagar,Madrid,177,127,50
1994,28065,Getafe,Madrid,672,1169,-497
1994,28074,Leganés,Madrid,748,1248,-500
1994,28079,Madrid,Madrid,18253,24191,-5938
1994,28080,Majadahonda,Madrid,405,323,82
1994,28084,Mejorada del Campo,Madrid,84,119,-35
1994,28092,Móstoles,Madrid,1082,2093,-1011
1994,28096,Navalcarnero,Madrid,133,115,18
1994,28106,Parla,Madrid,412,940,-528
1994,28113,Pinto,Madrid,260,168,92
1994,28115,Pozuelo de Alarcón,Madrid,359,438,-79
1994,28123,Rivas-Vaciamadrid,Madrid,131,108,23
1994,28127,Las Rozas de Madrid,Madrid,496,448,48
1994,28130,San Fernando de Henares,Madrid,149,247,-98
1994,28131,San Lorenzo de El Escorial,Madrid,87,102,-15
1994,28134,San Sebastián de los Reyes,Madrid,361,421,-60
1994,28148,Torrejón de Ardoz,Madrid,528,849,-321
1994,28161,Valdemoro,Madrid,326,362,-36
1994,28181,Villaviciosa de Odón,Madrid,87,106,-19
1994,28903,Tres Cantos,Madrid,425,243,182
1994,29007,Alhaurín de la Torre,Málaga,172,49,123
1994,29008,Alhaurín el Grande,Málaga,16,54,-38
1994,29012,Álora,Málaga,40,59,-19
1994,29015,Antequera,Málaga,245,196,49
1994,29017,Archidona,Málaga,51,42,9
1994,29025,Benalmádena,Málaga,434,253,181
1994,29038,Cártama,Málaga,36,36,0
1994,29042,Coín,Málaga,46,56,-10
1994,29051,Estepona,Málaga,518,381,137
1994,29054,Fuengirola,Málaga,785,505,280
1994,29067,Málaga,Málaga,2690,2539,151
1994,29069,Marbella,Málaga,1231,754,477
1994,29070,Mijas,Málaga,255,187,68
1994,29075,Nerja,Málaga,124,122,2
1994,29082,Rincón de la Victoria,Málaga,303,112,191
1994,29084,Ronda,Málaga,354,283,71
1994,29091,Torrox,Málaga,62,47,15
1994,29094,Vélez-Málaga,Málaga,458,339,119
1994,29901,Torremolinos,Málaga,537,351,186
1994,30002,Abarán,Murcia,36,39,-3
1994,30003,Águilas,Murcia,323,283,40
1994,30005,Alcantarilla,Murcia,242,203,39
1994,30008,Alhama de Murcia,Murcia,80,63,17
1994,30009,Archena,Murcia,62,54,8
1994,30012,Bullas,Murcia,45,22,23
1994,30015,Caravaca de la Cruz,Murcia,160,97,63
1994,30016,Cartagena,Murcia,1851,1861,-10
1994,30017,Cehegín,Murcia,111,55,56
1994,30019,Cieza (Murcia),Murcia,126,125,1
1994,30022,Jumilla,Murcia,137,136,1
1994,30024,Lorca,Murcia,420,331,89
1994,30026,Mazarrón,Murcia,244,133,111
1994,30027,Molina de Segura,Murcia,198,205,-7
1994,30029,Mula,Murcia,48,41,7
1994,30030,Murcia,Murcia,2207,1849,358
1994,30033,Puerto Lumbreras,Murcia,97,67,30
1994,30035,San Javier,Murcia,535,350,185
1994,30036,San Pedro del Pinatar,Murcia,359,205,154
1994,30037,Torre-Pacheco,Murcia,235,183,52
1994,30038,Las Torres de Cotillas,Murcia,76,40,36
1994,30039,Totana,Murcia,95,50,45
1994,30041,La Unión,Murcia,45,81,-36
1994,30043,Yecla,Murcia,212,215,-3
1994,31060,Burlada/Burlata,Navarra,130,112,18
1994,31097,Estella-Lizarra,Navarra,128,85,43
1994,31201,Pamplona/Iruña,Navarra,1493,1070,423
1994,31227,Tafalla,Navarra,67,71,-4
1994,31232,Tudela,Navarra,327,189,138
1994,31901,Barañain,Navarra,206,129,77
1994,32009,O Barco de Valdeorras,Ourense,135,116,19
1994,32019,O Carballiño,Ourense,86,80,6
1994,32054,Ourense,Ourense,779,798,-19
1994,32085,Verín,Ourense,212,121,91
1994,33002,Aller,Asturias,37,61,-24
1994,33004,Avilés,Asturias,358,517,-159
1994,33011,Cangas del Narcea,Asturias,80,141,-61
1994,33014,Carreño,Asturias,31,33,-2
1994,33016,Castrillón,Asturias,74,164,-90
1994,33020,Corvera de Asturias,Asturias,45,131,-86
1994,33024,Gijón,Asturias,1419,1575,-156
1994,33025,Gozón,Asturias,33,27,6
1994,33026,Grado,Asturias,29,23,6
1994,33031,Langreo,Asturias,105,236,-131
1994,33032,Laviana,Asturias,23,42,-19
1994,33033,Lena,Asturias,45,57,-12
1994,33034,Valdés,Asturias,64,85,-21
1994,33035,Llanera,Asturias,39,50,-11
1994,33036,Llanes,Asturias,95,89,6
1994,33037,Mieres (Asturias),Asturias,150,233,-83
1994,33044,Oviedo,Asturias,1069,1284,-215
1994,33051,Pravia,Asturias,38,53,-15
1994,33060,San Martín del Rey Aurelio,Asturias,40,56,-16
1994,33066,Siero,Asturias,246,185,61
1994,33073,Tineo,Asturias,22,29,-7
1994,33076,Villaviciosa,Asturias,39,33,6
1994,34120,Palencia,Palencia,665,836,-171
1994,35002,Agüimes,Las Palmas,161,53,108
1994,35004,Arrecife,Las Palmas,924,463,461
1994,35006,Arucas,Las Palmas,74,57,17
1994,35009,Gáldar,Las Palmas,34,38,-4
1994,35011,Ingenio,Las Palmas,40,31,9
1994,35012,Mogán,Las Palmas,218,87,131
1994,35016,Las Palmas de Gran Canaria,Las Palmas,3233,2821,412
1994,35017,Puerto del Rosario,Las Palmas,523,234,289
1994,35019,San Bartolomé de Tirajana,Las Palmas,648,325,323
1994,35021,Santa Brígida,Las Palmas,102,66,36
1994,35022,Santa Lucía de Tirajana,Las Palmas,182,86,96
1994,35023,Santa María de Guía de Gran Canaria,Las Palmas,13,41,-28
1994,35026,Telde,Las Palmas,432,274,158
1994,35027,Teror,Las Palmas,13,19,-6
1994,36003,Baiona,Pontevedra,37,34,3
1994,36004,Bueu,Pontevedra,37,31,6
1994,36006,Cambados,Pontevedra,39,82,-43
1994,36008,Cangas,Pontevedra,75,90,-15
1994,36017,A Estrada,Pontevedra,135,143,-8
1994,36021,Gondomar,Pontevedra,14,11,3
1994,36022,O Grove,Pontevedra,62,75,-13
1994,36023,A Guarda,Pontevedra,23,94,-71
1994,36024,Lalín,Pontevedra,62,84,-22
1994,36026,Marín,Pontevedra,262,210,52
1994,36029,Moaña,Pontevedra,42,85,-43
1994,36033,Mos,Pontevedra,25,13,12
1994,36035,Nigrán,Pontevedra,85,57,28
1994,36038,Pontevedra,Pontevedra,505,625,-120
1994,36039,O Porriño,Pontevedra,70,66,4
1994,36041,Poio,Pontevedra,78,55,23
1994,36042,Ponteareas,Pontevedra,86,71,15
1994,36045,Redondela,Pontevedra,99,109,-10
1994,36051,Sanxenxo,Pontevedra,74,52,22
1994,36052,Silleda,Pontevedra,44,35,9
1994,36054,Tomiño,Pontevedra,46,51,-5
1994,36055,Tui,Pontevedra,91,73,18
1994,36057,Vigo,Pontevedra,1691,1540,151
1994,36060,Vilagarcía de Arousa,Pontevedra,214,211,3
1994,36061,Vilanova de Arousa,Pontevedra,45,46,-1
1994,37046,Béjar,Salamanca,123,199,-76
1994,37107,Ciudad Rodrigo,Salamanca,129,134,-5
1994,37274,Salamanca,Salamanca,1960,1710,250
1994,38001,Adeje,Santa Cruz de Tenerife,392,143,249
1994,38006,Arona,Santa Cruz de Tenerife,987,391,596
1994,38011,Candelaria,Santa Cruz de Tenerife,180,109,71
1994,38017,Granadilla de Abona,Santa Cruz de Tenerife,356,196,160
1994,38019,Guía de Isora,Santa Cruz de Tenerife,72,50,22
1994,38020,Güímar,Santa Cruz de Tenerife,51,71,-20
1994,38022,Icod de los Vinos,Santa Cruz de Tenerife,43,38,5
1994,38023,San Cristóbal de La Laguna,Santa Cruz de Tenerife,645,479,166
1994,38024,Los Llanos de Aridane,Santa Cruz de Tenerife,111,73,38
1994,38026,La Orotava,Santa Cruz de Tenerife,102,54,48
1994,38028,Puerto de la Cruz,Santa Cruz de Tenerife,387,210,177
1994,38031,Los Realejos,Santa Cruz de Tenerife,85,55,30
1994,38032,El Rosario,Santa Cruz de Tenerife,164,69,95
1994,38037,Santa Cruz de la Palma,Santa Cruz de Tenerife,123,127,-4
1994,38038,Santa Cruz de Tenerife,Santa Cruz de Tenerife,1770,1436,334
1994,38043,Tacoronte,Santa Cruz de Tenerife,42,37,5
1994,39008,El Astillero,Cantabria,90,79,11
1994,39016,Camargo,Cantabria,138,90,48
1994,39020,Castro-Urdiales,Cantabria,636,221,415
1994,39025,Los Corrales de Buelna,Cantabria,35,21,14
1994,39035,Laredo,Cantabria,242,148,94
1994,39059,Reinosa,Cantabria,115,83,32
1994,39075,Santander,Cantabria,1347,1254,93
1994,39079,Santoña,Cantabria,100,97,3
1994,39087,Torrelavega,Cantabria,240,339,-99
1994,40194,Segovia,Segovia,438,549,-111
1994,41004,Alcalá de Guadaíra,Sevilla,236,217,19
1994,41007,La Algaba,Sevilla,12,36,-24
1994,41011,Arahal,Sevilla,48,25,23
1994,41018,Brenes,Sevilla,53,25,28
1994,41020,Las Cabezas de San Juan,Sevilla,64,129,-65
1994,41021,Camas,Sevilla,83,88,-5
1994,41024,Carmona,Sevilla,88,95,-7
1994,41029,Castilleja de la Cuesta,Sevilla,108,72,36
1994,41034,Coria del Río,Sevilla,85,39,46
1994,41038,Dos Hermanas,Sevilla,538,409,129
1994,41039,Écija,Sevilla,245,206,39
1994,41041,Estepa,Sevilla,45,44,1
1994,41053,Lebrija,Sevilla,158,171,-13
1994,41055,Lora del Río,Sevilla,107,143,-36
1994,41058,Mairena del Alcor,Sevilla,73,64,9
1994,41059,Mairena del Aljarafe,Sevilla,439,169,270
1994,41060,Marchena,Sevilla,45,48,-3
1994,41065,Morón de la Frontera,Sevilla,161,229,-68
1994,41068,Osuna,Sevilla,130,73,57
1994,41069,Los Palacios y Villafranca,Sevilla,66,68,-2
1994,41075,Pilas,Sevilla,31,42,-11
1994,41077,La Puebla de Cazalla,Sevilla,122,176,-54
1994,41079,La Puebla del Río,Sevilla,19,47,-28
1994,41081,La Rinconada,Sevilla,161,88,73
1994,41086,San Juan de Aznalfarache,Sevilla,124,155,-31
1994,41087,Sanlúcar la Mayor,Sevilla,51,39,12
1994,41091,Sevilla,Sevilla,4642,3495,1147
1994,41093,Tomares,Sevilla,247,93,154
1994,41095,Utrera,Sevilla,327,225,102
1994,41102,El Viso del Alcor,Sevilla,13,20,-7
1994,42173,Soria,Soria,414,465,-51
1994,43014,Amposta,Tarragona,89,87,2
1994,43038,Cambrils,Tarragona,412,190,222
1994,43123,Reus,Tarragona,730,634,96
1994,43136,Sant Carles de la Ràpita,Tarragona,120,85,35
1994,43148,Tarragona,Tarragona,1066,940,126
1994,43155,Tortosa,Tarragona,244,215,29
1994,43161,Valls,Tarragona,146,103,43
1994,43163,El Vendrell,Tarragona,811,335,476
1994,43171,Vila-seca,Tarragona,208,137,71
1994,43901,Deltebre,Tarragona,38,39,-1
1994,44013,Alcañiz,Teruel,144,118,26
1994,44216,Teruel,Teruel,362,391,-29
1994,45053,Consuegra,Toledo,41,49,-8
1994,45087,Madridejos,Toledo,82,76,6
1994,45165,Talavera de la Reina,Toledo,698,654,44
1994,45168,Toledo,Toledo,1045,704,341
1994,46005,Alaquàs,Valencia,64,79,-15
1994,46013,Alboraya,Valencia,73,60,13
1994,46017,Alzira,Valencia,127,136,-9
1994,46019,L'Alcúdia,Valencia,22,28,-6
1994,46021,Aldaia,Valencia,97,87,10
1994,46022,Alfafar,Valencia,75,112,-37
1994,46029,Algemesí,Valencia,68,57,11
1994,46031,Alginet,Valencia,28,24,4
1994,46054,Benetússer,Valencia,60,45,15
1994,46060,Benifaió,Valencia,26,47,-21
1994,46070,Bétera,Valencia,82,71,11
1994,46078,Burjassot,Valencia,111,140,-29
1994,46081,Canals,Valencia,32,45,-13
1994,46083,Carcaixent,Valencia,52,78,-26
1994,46085,Carlet,Valencia,34,30,4
1994,46094,Catarroja,Valencia,81,52,29
1994,46102,Quart de Poblet,Valencia,89,112,-23
1994,46105,Cullera,Valencia,117,103,14
1994,46110,Xirivella,Valencia,117,142,-25
1994,46116,L'Eliana,Valencia,106,57,49
1994,46131,Gandia,Valencia,579,362,217
1994,46135,Godella,Valencia,46,59,-13
1994,46145,Xátiva,Valencia,120,109,11
1994,46147,Llíria,Valencia,65,73,-8
1994,46159,Manises,Valencia,102,118,-16
1994,46164,Massamagrell,Valencia,41,46,-5
1994,46169,Mislata,Valencia,245,231,14
1994,46171,Moncada,Valencia,53,52,1
1994,46181,Oliva,Valencia,120,121,-1
1994,46184,Ontinyent,Valencia,91,137,-46
1994,46186,Paiporta,Valencia,109,75,34
1994,46190,Paterna,Valencia,320,272,48
1994,46194,Picassent,Valencia,41,30,11
1994,46205,Puçol,Valencia,61,45,16
1994,46213,Requena,Valencia,124,82,42
1994,46214,Riba-roja de Túria,Valencia,70,59,11
1994,46220,Sagunto/Sagunt,Valencia,366,319,47
1994,46230,Silla,Valencia,80,72,8
1994,46235,Sueca,Valencia,66,58,8
1994,46238,Tavernes de la Valldigna,Valencia,50,50,0
1994,46244,Torrent (Valencia),Valencia,299,257,42
1994,46249,Utiel,Valencia,59,64,-5
1994,46250,València,Valencia,3842,4484,-642
1994,47076,Laguna de Duero,Valladolid,175,178,-3
1994,47085,Medina del Campo,Valladolid,171,177,-6
1994,47186,Valladolid,Valladolid,2790,3072,-282
1994,48003,Amorebieta-Etxano,Vizcaya,48,146,-98
1994,48011,Arrigorriaga,Vizcaya,52,94,-42
1994,48013,Barakaldo,Vizcaya,355,1057,-702
1994,48015,Basauri,Vizcaya,178,422,-244
1994,48017,Bermeo,Vizcaya,57,108,-51
1994,48020,Bilbao,Vizcaya,2082,3507,-1425
1994,48027,Durango,Vizcaya,177,196,-19
1994,48034,Ermua,Vizcaya,152,357,-205
1994,48036,Galdakao,Vizcaya,113,211,-98
1994,48044,Getxo,Vizcaya,559,720,-161
1994,48046,Gernika-Lumo,Vizcaya,61,62,-1
1994,48054,Leioa,Vizcaya,125,220,-95
1994,48069,Mungia,Vizcaya,45,72,-27
1994,48073,Ondarroa,Vizcaya,73,177,-104
1994,48078,Portugalete,Vizcaya,224,468,-244
1994,48080,Valle de Trápaga-Trapagaran,Vizcaya,32,88,-56
1994,48082,Santurtzi,Vizcaya,185,475,-290
1994,48084,Sestao,Vizcaya,172,388,-216
1994,48902,Erandio,Vizcaya,64,177,-113
1994,49021,Benavente,Zamora,224,182,42
1994,49275,Zamora,Zamora,518,682,-164
1994,50067,Calatayud,Zaragoza,139,144,-5
1994,50095,Ejea de los Caballeros,Zaragoza,92,62,30
1994,50251,Tarazona,Zaragoza,58,81,-23
1994,50297,Zaragoza,Zaragoza,3986,4061,-75
1994,51001,Ceuta,Ceuta,1167,1167,0
1994,52001,Melilla,Melilla,1676,1444,232
1995,01036,Laudio/Llodio,Álava,191,275,-84
1995,01059,Vitoria-Gasteiz,Álava,2556,1910,646
1995,02003,Albacete,Albacete,1437,1326,111
1995,02009,Almansa,Albacete,217,228,-11
1995,02037,Hellín,Albacete,294,319,-25
1995,02069,La Roda,Albacete,121,138,-17
1995,02081,Villarrobledo,Albacete,148,237,-89
1995,03009,Alcoy/Alcoi,Alicante,323,358,-35
1995,03011,L'Alfàs del Pi,Alicante,138,97,41
1995,03014,Alicante/Alacant,Alicante,3060,2153,907
1995,03015,Almoradí,Alicante,104,72,32
1995,03018,Altea,Alicante,229,95,134
1995,03019,Aspe,Alicante,53,65,-12
1995,03031,Benidorm,Alicante,1523,773,750
1995,03047,Calp,Alicante,229,85,144
1995,03049,Callosa de Segura,Alicante,85,73,12
1995,03050,El Campello,Alicante,282,125,157
1995,03056,Cocentaina,Alicante,67,54,13
1995,03059,Crevillent,Alicante,130,89,41
1995,03063,Dénia,Alicante,422,306,116
1995,03065,Elche/Elx,Alicante,1042,771,271
1995,03066,Elda,Alicante,301,186,115
1995,03079,Ibi,Alicante,86,97,-11
1995,03082,Jávea/Xàbia,Alicante,227,135,92
1995,03089,Monóvar/Monòver,Alicante,34,23,11
1995,03090,Mutxamel,Alicante,67,50,17
1995,03093,Novelda,Alicante,96,108,-12
1995,03099,Orihuela,Alicante,524,546,-22
1995,03104,Petrer,Alicante,130,86,44
1995,03119,Sant Joan d'Alacant,Alicante,203,117,86
1995,03121,Santa Pola,Alicante,322,156,166
1995,03122,San Vicente del Raspeig/Sant Vicent del Raspeig,Alicante,258,184,74
1995,03133,Torrevieja,Alicante,2373,730,1643
1995,03139,Villajoyosa/La Vila Joiosa,Alicante,251,182,69
1995,03140,Villena,Alicante,204,140,64
1995,04003,Adra,Almería,206,103,103
1995,04006,Albox,Almería,71,64,7
1995,04013,Almería,Almería,1695,1338,357
1995,04029,Berja,Almería,114,82,32
1995,04053,Huércal-Overa,Almería,142,165,-23
1995,04066,Níjar,Almería,127,54,73
1995,04079,Roquetas de Mar,Almería,906,564,342
1995,04102,Vícar,Almería,245,124,121
1995,04902,El Ejido,Almería,702,398,304
1995,05019,Ávila,Ávila,516,519,-3
1995,06011,Almendralejo,Badajoz,202,207,-5
1995,06014,Azuaga,Badajoz,96,103,-7
1995,06015,Badajoz,Badajoz,1324,1281,43
1995,06044,Don Benito,Badajoz,315,251,64
1995,06070,Jerez de los Caballeros,Badajoz,77,69,8
1995,06083,Mérida,Badajoz,511,449,62
1995,06088,Montijo,Badajoz,142,92,50
1995,06095,Olivenza,Badajoz,89,85,4
1995,06149,Villafranca de los Barros,Badajoz,69,99,-30
1995,06153,Villanueva de la Serena,Badajoz,213,162,51
1995,06158,Zafra,Badajoz,145,139,6
1995,07011,Calvià,Baleares,773,373,400
1995,07015,Ciutadella de Menorca,Baleares,327,201,126
1995,07022,Felanitx,Baleares,162,91,71
1995,07026,Eivissa,Baleares,750,549,201
1995,07027,Inca,Baleares,136,83,53
1995,07031,Llucmajor,Baleares,269,134,135
1995,07032,Maó-Mahón,Baleares,442,351,91
1995,07033,Manacor,Baleares,379,183,196
1995,07036,Marratxí,Baleares,64,38,26
1995,07040,Palma,Baleares,4166,2767,1399
1995,07042,Pollença,Baleares,160,85,75
1995,07044,Sa Pobla,Baleares,75,23,52
1995,07046,Sant Antoni de Portmany,Baleares,359,174,185
1995,07048,Sant Josep de sa Talaia,Baleares,202,142,60
1995,07054,Santa Eulària des Riu,Baleares,420,194,226
1995,07061,Sóller,Baleares,58,48,10
1995,08006,Arenys de Mar,Barcelona,74,82,-8
1995,08015,Badalona,Barcelona,743,1228,-485
1995,08019,Barcelona,Barcelona,7140,12739,-5599
1995,08022,Berga,Barcelona,55,79,-24
1995,08033,Caldes de Montbui,Barcelona,57,33,24
1995,08035,Calella,Barcelona,126,100,26
1995,08041,Canovelles,Barcelona,84,100,-16
1995,08046,Cardedeu,Barcelona,42,64,-22
1995,08051,Castellar del Vallès,Barcelona,64,81,-17
1995,08056,Castelldefels,Barcelona,463,433,30
1995,08073,Cornellà de Llobregat,Barcelona,466,598,-132
1995,08076,Esparreguera,Barcelona,85,109,-24
1995,08077,Esplugues de Llobregat,Barcelona,208,363,-155
1995,08086,Les Franqueses del Vallès,Barcelona,47,67,-20
1995,08088,La Garriga,Barcelona,41,46,-5
1995,08089,Gavà,Barcelona,259,276,-17
1995,08096,Granollers,Barcelona,274,324,-50
1995,08101,L'Hospitalet de Llobregat,Barcelona,1126,1893,-767
1995,08102,Igualada,Barcelona,113,156,-43
1995,08105,La Llagosta,Barcelona,94,68,26
1995,08110,Malgrat de Mar,Barcelona,108,90,18
1995,08112,Manlleu,Barcelona,46,68,-22
1995,08113,Manresa,Barcelona,252,300,-48
1995,08114,Martorell,Barcelona,96,107,-11
1995,08118,El Masnou,Barcelona,103,130,-27
1995,08121,Mataró,Barcelona,446,521,-75
1995,08123,Molins de Rei,Barcelona,56,95,-39
1995,08124,Mollet del Vallès,Barcelona,211,246,-35
1995,08125,Montcada i Reixac,Barcelona,99,141,-42
1995,08136,Montornès del Vallès,Barcelona,58,75,-17
1995,08147,Olesa de Montserrat,Barcelona,93,88,5
1995,08159,Parets del Vallès,Barcelona,39,56,-17
1995,08163,Pineda de Mar,Barcelona,189,154,35
1995,08169,El Prat de Llobregat,Barcelona,307,523,-216
1995,08172,Premià de Mar,Barcelona,122,259,-137
1995,08180,Ripollet,Barcelona,107,227,-120
1995,08184,Rubí,Barcelona,252,385,-133
1995,08187,Sabadell,Barcelona,763,1020,-257
1995,08194,Sant Adrià de Besòs,Barcelona,148,264,-116
1995,08196,Sant Andreu de la Barca,Barcelona,184,180,4
1995,08200,Sant Boi de Llobregat,Barcelona,350,451,-101
1995,08202,Sant Celoni,Barcelona,82,120,-38
1995,08205,Sant Cugat del Vallès,Barcelona,359,298,61
1995,08211,Sant Feliu de Llobregat,Barcelona,161,250,-89
1995,08217,Sant Joan Despí,Barcelona,157,186,-29
1995,08219,Vilassar de Mar,Barcelona,109,107,2
1995,08221,Sant Just Desvern,Barcelona,70,100,-30
1995,08231,Sant Pere de Ribes,Barcelona,132,149,-17
1995,08238,Sant Quirze del Vallès,Barcelona,41,39,2
1995,08245,Santa Coloma de Gramenet,Barcelona,479,923,-444
1995,08252,Barberà del Vallès,Barcelona,100,198,-98
1995,08260,Santa Perpètua de Mogoda,Barcelona,75,105,-30
1995,08263,Sant Vicenç dels Horts,Barcelona,100,160,-60
1995,08266,Cerdanyola del Vallès,Barcelona,244,366,-122
1995,08270,Sitges,Barcelona,170,127,43
1995,08279,Terrassa,Barcelona,591,799,-208
1995,08285,Torelló,Barcelona,37,37,0
1995,08298,Vic,Barcelona,131,133,-2
1995,08301,Viladecans,Barcelona,285,439,-154
1995,08305,Vilafranca del Penedès,Barcelona,194,173,21
1995,08307,Vilanova i la Geltrú,Barcelona,372,334,38
1995,08904,Badia del Vallès,Barcelona,76,126,-50
1995,09018,Aranda de Duero,Burgos,220,419,-199
1995,09059,Burgos,Burgos,1313,1528,-215
1995,09219,Miranda de Ebro,Burgos,395,619,-224
1995,10037,Cáceres,Cáceres,710,693,17
1995,10067,Coria,Cáceres,143,127,16
1995,10121,Miajadas,Cáceres,93,128,-35
1995,10131,Navalmoral de la Mata,Cáceres,181,275,-94
1995,10148,Plasencia,Cáceres,364,392,-28
1995,11004,Algeciras,Cádiz,887,957,-70
1995,11006,Arcos de la Frontera,Cádiz,149,294,-145
1995,11007,Barbate,Cádiz,175,430,-255
1995,11008,Los Barrios,Cádiz,116,109,7
1995,11012,Cádiz,Cádiz,609,1082,-473
1995,11014,Conil de la Frontera,Cádiz,84,93,-9
1995,11015,Chiclana de la Frontera,Cádiz,434,302,132
1995,11016,Chipiona,Cádiz,117,113,4
1995,11020,Jerez de la Frontera,Cádiz,1077,1957,-880
1995,11022,La Línea de la Concepción,Cádiz,421,706,-285
1995,11023,Medina-Sidonia,Cádiz,8,51,-43
1995,11027,El Puerto de Santa María,Cádiz,755,827,-72
1995,11028,Puerto Real,Cádiz,163,153,10
1995,11030,Rota,Cádiz,383,396,-13
1995,11031,San Fernando,Cádiz,733,973,-240
1995,11032,Sanlúcar de Barrameda,Cádiz,221,265,-44
1995,11033,San Roque,Cádiz,183,211,-28
1995,11035,Tarifa,Cádiz,179,140,39
1995,11038,Ubrique,Cádiz,52,97,-45
1995,11039,Vejer de la Frontera,Cádiz,41,80,-39
1995,11041,Villamartín,Cádiz,82,108,-26
1995,12009,Almassora,Castellón,91,70,21
1995,12027,Benicarló,Castellón,214,198,16
1995,12032,Borriana/Burriana,Castellón,196,134,62
1995,12040,Castellón de la Plana/Castelló de la Plana,Castellón,1587,1109,478
1995,12082,Nules,Castellón,64,69,-5
1995,12084,Onda,Castellón,83,64,19
1995,12126,La Vall d'Uixó,Castellón,151,136,15
1995,12135,Vila-real,Castellón,306,180,126
1995,12138,Vinaròs,Castellón,446,277,169
1995,13005,Alcázar de San Juan,Ciudad Real,290,334,-44
1995,13023,Bolaños de Calatrava,Ciudad Real,32,18,14
1995,13028,Campo de Criptana,Ciudad Real,58,86,-28
1995,13034,Ciudad Real,Ciudad Real,719,703,16
1995,13039,Daimiel,Ciudad Real,140,101,39
1995,13053,Manzanares,Ciudad Real,211,190,21
1995,13071,Puertollano,Ciudad Real,465,608,-143
1995,13078,Socuéllamos,Ciudad Real,63,94,-31
1995,13079,La Solana,Ciudad Real,43,71,-28
1995,13082,Tomelloso,Ciudad Real,157,174,-17
1995,13087,Valdepeñas,Ciudad Real,236,223,13
1995,14002,Aguilar de la Frontera,Córdoba,26,59,-33
1995,14007,Baena,Córdoba,136,140,-4
1995,14013,Cabra,Córdoba,132,126,6
1995,14021,Córdoba,Córdoba,1845,2651,-806
1995,14038,Lucena,Córdoba,241,179,62
1995,14042,Montilla,Córdoba,100,146,-46
1995,14049,Palma del Río,Córdoba,157,212,-55
1995,14052,Peñarroya-Pueblonuevo,Córdoba,106,158,-52
1995,14054,Pozoblanco,Córdoba,80,78,2
1995,14055,Priego de Córdoba,Córdoba,238,175,63
1995,14056,Puente Genil,Córdoba,138,253,-115
1995,14058,Rute,Córdoba,79,115,-36
1995,14069,Villanueva de Córdoba,Córdoba,63,71,-8
1995,15002,Ames,A Coruña,163,74,89
1995,15005,Arteixo,A Coruña,83,82,1
1995,15009,Betanzos,A Coruña,85,75,10
1995,15011,Boiro,A Coruña,74,93,-19
1995,15017,Cambre,A Coruña,70,36,34
1995,15019,Carballo,A Coruña,57,74,-17
1995,15030,A Coruña,A Coruña,2014,1588,426
1995,15031,Culleredo,A Coruña,108,81,27
1995,15035,Fene,A Coruña,51,76,-25
1995,15036,Ferrol,A Coruña,701,754,-53
1995,15041,A Laracha,A Coruña,31,17,14
1995,15053,Muros,A Coruña,49,137,-88
1995,15054,Narón,A Coruña,206,244,-38
1995,15057,Noia,A Coruña,119,87,32
1995,15058,Oleiros,A Coruña,277,115,162
1995,15059,Ordes,A Coruña,34,40,-6
1995,15065,Padrón,A Coruña,53,89,-36
1995,15067,A Pobra do Caramiñal,A Coruña,48,47,1
1995,15070,As Pontes de García Rodríguez,A Coruña,92,225,-133
1995,15071,Porto do Son,A Coruña,25,65,-40
1995,15072,Rianxo,A Coruña,29,53,-24
1995,15073,Ribeira,A Coruña,126,108,18
1995,15075,Sada (A Coruña),A Coruña,75,53,22
1995,15077,Santa Comba,A Coruña,31,23,8
1995,15078,Santiago de Compostela,A Coruña,1148,574,574
1995,15082,Teo,A Coruña,81,67,14
1995,16078,Cuenca,Cuenca,413,517,-104
1995,16203,Tarancón,Cuenca,125,145,-20
1995,17015,Banyoles,Girona,83,73,10
1995,17023,Blanes,Girona,726,461,265
1995,17066,Figueres,Girona,324,347,-23
1995,17079,Girona,Girona,782,615,167
1995,17095,Lloret de Mar,Girona,529,358,171
1995,17114,Olot,Girona,199,153,46
1995,17117,Palafrugell,Girona,207,170,37
1995,17118,Palamós,Girona,198,147,51
1995,17147,Ripoll,Girona,102,135,-33
1995,17152,Roses,Girona,220,178,42
1995,17155,Salt,Girona,187,184,3
1995,17160,Sant Feliu de Guíxols,Girona,254,190,64
1995,18003,Albolote,Granada,93,59,34
1995,18017,Almuñécar,Granada,194,177,17
1995,18021,Armilla,Granada,147,115,32
1995,18022,Atarfe,Granada,72,60,12
1995,18023,Baza,Granada,216,234,-18
1995,18087,Granada,Granada,2279,2731,-452
1995,18089,Guadix,Granada,204,217,-13
1995,18098,Huéscar,Granada,90,115,-25
1995,18102,Illora,Granada,64,92,-28
1995,18122,Loja,Granada,105,182,-77
1995,18127,Maracena,Granada,73,55,18
1995,18140,Motril,Granada,376,362,14
1995,18158,Pinos Puente,Granada,56,86,-30
1995,18173,Salobreña,Granada,80,114,-34
1995,18175,Santa Fe,Granada,75,61,14
1995,18193,La Zubia,Granada,69,72,-3
1995,19046,Azuqueca de Henares,Guadalajara,1187,260,927
1995,19130,Guadalajara,Guadalajara,1087,687,400
1995,20009,Andoain,Guipúzcoa,56,102,-46
1995,20017,Azkoitia,Guipúzcoa,28,62,-34
1995,20018,Azpeitia,Guipúzcoa,46,59,-13
1995,20019,Beasain,Guipúzcoa,48,91,-43
1995,20030,Eibar,Guipúzcoa,244,459,-215
1995,20032,Elgoibar,Guipúzcoa,36,95,-59
1995,20036,Hondarribia,Guipúzcoa,107,82,25
1995,20040,Hernani,Guipúzcoa,67,112,-45
1995,20045,Irun,Guipúzcoa,484,600,-116
1995,20055,Arrasate/Mondragón,Guipúzcoa,123,274,-151
1995,20059,Oñati,Guipúzcoa,53,71,-18
1995,20064,Pasaia,Guipúzcoa,60,139,-79
1995,20067,Errenteria,Guipúzcoa,179,351,-172
1995,20069,Donostia/San Sebastián,Guipúzcoa,1312,1418,-106
1995,20071,Tolosa,Guipúzcoa,75,124,-49
1995,20074,Bergara,Guipúzcoa,63,102,-39
1995,20079,Zarautz,Guipúzcoa,166,146,20
1995,20080,Zumarraga,Guipúzcoa,38,101,-63
1995,20902,Lasarte-Oria,Guipúzcoa,117,178,-61
1995,21005,Almonte,Huelva,183,128,55
1995,21010,Ayamonte,Huelva,169,134,35
1995,21013,Bollullos Par del Condado,Huelva,30,38,-8
1995,21021,Cartaya,Huelva,138,88,50
1995,21035,Gibraleón,Huelva,29,30,-1
1995,21041,Huelva,Huelva,729,792,-63
1995,21042,Isla Cristina,Huelva,134,112,22
1995,21044,Lepe,Huelva,184,111,73
1995,21050,Moguer,Huelva,132,72,60
1995,21060,Punta Umbría,Huelva,87,74,13
1995,21072,Valverde del Camino,Huelva,45,51,-6
1995,22048,Barbastro,Huesca,138,162,-24
1995,22112,Fraga,Huesca,105,126,-21
1995,22125,Huesca,Huesca,486,459,27
1995,22130,Jaca,Huesca,278,251,27
1995,22158,Monzón,Huesca,112,154,-42
1995,23002,Alcalá la Real,Jaén,218,234,-16
1995,23003,Alcaudete,Jaén,88,110,-22
1995,23005,Andújar,Jaén,274,417,-143
1995,23009,Baeza,Jaén,130,141,-11
1995,23010,Bailén,Jaén,76,114,-38
1995,23024,La Carolina,Jaén,108,164,-56
1995,23050,Jaén,Jaén,692,817,-125
1995,23053,Jódar,Jaén,64,123,-59
1995,23055,Linares,Jaén,416,792,-376
1995,23060,Martos,Jaén,148,95,53
1995,23086,Torredelcampo,Jaén,55,38,17
1995,23087,Torredonjimeno,Jaén,59,82,-23
1995,23092,Úbeda,Jaén,237,296,-59
1995,23095,Villacarrillo,Jaén,98,162,-64
1995,24008,Astorga,León,166,121,45
1995,24010,La Bañeza,León,121,120,1
1995,24014,Bembibre,León,97,152,-55
1995,24089,León,León,1368,1462,-94
1995,24115,Ponferrada,León,550,628,-78
1995,24142,San Andrés del Rabanedo,León,259,203,56
1995,24202,Villablino,León,96,154,-58
1995,25040,Balaguer,Lleida,63,78,-15
1995,25120,Lleida,Lleida,916,1129,-213
1995,25203,La Seu d'Urgell,Lleida,211,244,-33
1995,25217,Tàrrega,Lleida,170,102,68
1995,26018,Arnedo,La Rioja,129,104,25
1995,26036,Calahorra,La Rioja,234,259,-25
1995,26089,Logroño,La Rioja,1449,1289,160
1995,27016,Chantada,Lugo,69,102,-33
1995,27028,Lugo,Lugo,664,679,-15
1995,27031,Monforte de Lemos,Lugo,162,174,-12
1995,27057,Sarria,Lugo,83,59,24
1995,27065,Vilalba,Lugo,94,75,19
1995,27066,Viveiro,Lugo,126,94,32
1995,28005,Alcalá de Henares,Madrid,1456,2460,-1004
1995,28006,Alcobendas,Madrid,613,623,-10
1995,28007,Alcorcón,Madrid,828,913,-85
1995,28009,Algete,Madrid,66,140,-74
1995,28013,Aranjuez,Madrid,382,393,-11
1995,28014,Arganda del Rey,Madrid,134,214,-80
1995,28022,Boadilla del Monte,Madrid,86,131,-45
1995,28040,Ciempozuelos,Madrid,102,85,17
1995,28045,Colmenar Viejo,Madrid,271,230,41
1995,28047,Collado Villalba,Madrid,611,435,176
1995,28049,Coslada,Madrid,322,515,-193
1995,28058,Fuenlabrada,Madrid,1132,1997,-865
1995,28061,Galapagar,Madrid,191,202,-11
1995,28065,Getafe,Madrid,766,1144,-378
1995,28074,Leganés,Madrid,837,1331,-494
1995,28079,Madrid,Madrid,19898,25496,-5598
1995,28080,Majadahonda,Madrid,372,316,56
1995,28084,Mejorada del Campo,Madrid,63,183,-120
1995,28092,Móstoles,Madrid,1053,1958,-905
1995,28096,Navalcarnero,Madrid,101,128,-27
1995,28106,Parla,Madrid,427,947,-520
1995,28113,Pinto,Madrid,181,168,13
1995,28115,Pozuelo de Alarcón,Madrid,382,394,-12
1995,28123,Rivas-Vaciamadrid,Madrid,103,104,-1
1995,28127,Las Rozas de Madrid,Madrid,499,443,56
1995,28130,San Fernando de Henares,Madrid,169,230,-61
1995,28131,San Lorenzo de El Escorial,Madrid,123,92,31
1995,28134,San Sebastián de los Reyes,Madrid,366,373,-7
1995,28148,Torrejón de Ardoz,Madrid,639,842,-203
1995,28152,Torrelodones,Madrid,90,115,-25
1995,28161,Valdemoro,Madrid,424,245,179
1995,28181,Villaviciosa de Odón,Madrid,99,86,13
1995,28903,Tres Cantos,Madrid,480,293,187
1995,29007,Alhaurín de la Torre,Málaga,133,125,8
1995,29008,Alhaurín el Grande,Málaga,48,53,-5
1995,29012,Álora,Málaga,65,76,-11
1995,29015,Antequera,Málaga,233,174,59
1995,29017,Archidona,Málaga,50,36,14
1995,29025,Benalmádena,Málaga,524,230,294
1995,29038,Cártama,Málaga,29,38,-9
1995,29042,Coín,Málaga,68,72,-4
1995,29051,Estepona,Málaga,574,301,273
1995,29054,Fuengirola,Málaga,818,437,381
1995,29067,Málaga,Málaga,2668,3008,-340
1995,29069,Marbella,Málaga,1583,705,878
1995,29070,Mijas,Málaga,297,158,139
1995,29075,Nerja,Málaga,143,146,-3
1995,29082,Rincón de la Victoria,Málaga,285,136,149
1995,29084,Ronda,Málaga,350,319,31
1995,29091,Torrox,Málaga,40,47,-7
1995,29094,Vélez-Málaga,Málaga,403,296,107
1995,29901,Torremolinos,Málaga,627,373,254
1995,30002,Abarán,Murcia,35,44,-9
1995,30003,Águilas,Murcia,294,210,84
1995,30005,Alcantarilla,Murcia,272,224,48
1995,30008,Alhama de Murcia,Murcia,90,76,14
1995,30009,Archena,Murcia,81,54,27
1995,30012,Bullas,Murcia,23,51,-28
1995,30015,Caravaca de la Cruz,Murcia,194,127,67
1995,30016,Cartagena,Murcia,1810,2045,-235
1995,30017,Cehegín,Murcia,115,84,31
1995,30019,Cieza (Murcia),Murcia,125,118,7
1995,30022,Jumilla,Murcia,119,99,20
1995,30024,Lorca,Murcia,491,410,81
1995,30026,Mazarrón,Murcia,249,119,130
1995,30027,Molina de Segura,Murcia,193,209,-16
1995,30029,Mula,Murcia,60,57,3
1995,30030,Murcia,Murcia,2144,2066,78
1995,30033,Puerto Lumbreras,Murcia,94,102,-8
1995,30035,San Javier,Murcia,504,469,35
1995,30036,San Pedro del Pinatar,Murcia,381,216,165
1995,30037,Torre-Pacheco,Murcia,213,167,46
1995,30038,Las Torres de Cotillas,Murcia,56,68,-12
1995,30039,Totana,Murcia,86,45,41
1995,30041,La Unión,Murcia,82,84,-2
1995,30043,Yecla,Murcia,252,260,-8
1995,31060,Burlada/Burlata,Navarra,126,92,34
1995,31097,Estella-Lizarra,Navarra,91,94,-3
1995,31201,Pamplona/Iruña,Navarra,1449,1137,312
1995,31227,Tafalla,Navarra,57,77,-20
1995,31232,Tudela,Navarra,375,244,131
1995,31901,Barañain,Navarra,186,149,37
1995,32009,O Barco de Valdeorras,Ourense,145,131,14
1995,32019,O Carballiño,Ourense,86,118,-32
1995,32054,Ourense,Ourense,834,1015,-181
1995,32085,Verín,Ourense,142,133,9
1995,33002,Aller,Asturias,54,49,5
1995,33004,Avilés,Asturias,358,569,-211
1995,33011,Cangas del Narcea,Asturias,82,127,-45
1995,33014,Carreño,Asturias,27,45,-18
1995,33016,Castrillón,Asturias,73,134,-61
1995,33020,Corvera de Asturias,Asturias,63,107,-44
1995,33024,Gijón,Asturias,1343,1750,-407
1995,33025,Gozón,Asturias,30,46,-16
1995,33026,Grado,Asturias,29,29,0
1995,33031,Langreo,Asturias,121,217,-96
1995,33032,Laviana,Asturias,28,28,0
1995,33033,Lena,Asturias,45,89,-44
1995,33034,Valdés,Asturias,82,73,9
1995,33035,Llanera,Asturias,83,41,42
1995,33036,Llanes,Asturias,98,97,1
1995,33037,Mieres (Asturias),Asturias,173,262,-89
1995,33044,Oviedo,Asturias,1154,1229,-75
1995,33060,San Martín del Rey Aurelio,Asturias,37,82,-45
1995,33066,Siero,Asturias,229,144,85
1995,33073,Tineo,Asturias,32,29,3
1995,33076,Villaviciosa,Asturias,43,33,10
1995,34120,Palencia,Palencia,710,772,-62
1995,35002,Agüimes,Las Palmas,167,92,75
1995,35004,Arrecife,Las Palmas,1418,495,923
1995,35006,Arucas,Las Palmas,87,71,16
1995,35009,Gáldar,Las Palmas,43,30,13
1995,35011,Ingenio,Las Palmas,66,28,38
1995,35012,Mogán,Las Palmas,287,145,142
1995,35016,Las Palmas de Gran Canaria,Las Palmas,3713,2823,890
1995,35017,Puerto del Rosario,Las Palmas,761,375,386
1995,35019,San Bartolomé de Tirajana,Las Palmas,651,433,218
1995,35021,Santa Brígida,Las Palmas,104,66,38
1995,35022,Santa Lucía de Tirajana,Las Palmas,226,126,100
1995,35023,Santa María de Guía de Gran Canaria,Las Palmas,51,48,3
1995,35026,Telde,Las Palmas,434,324,110
1995,35027,Teror,Las Palmas,28,17,11
1995,35028,Tías,Las Palmas,673,285,388
1995,36003,Baiona,Pontevedra,45,41,4
1995,36004,Bueu,Pontevedra,35,40,-5
1995,36006,Cambados,Pontevedra,52,74,-22
1995,36008,Cangas,Pontevedra,73,109,-36
1995,36017,A Estrada,Pontevedra,124,152,-28
1995,36021,Gondomar,Pontevedra,27,32,-5
1995,36022,O Grove,Pontevedra,82,59,23
1995,36023,A Guarda,Pontevedra,46,104,-58
1995,36024,Lalín,Pontevedra,92,99,-7
1995,36026,Marín,Pontevedra,213,256,-43
1995,36029,Moaña,Pontevedra,38,70,-32
1995,36033,Mos,Pontevedra,48,48,0
1995,36035,Nigrán,Pontevedra,71,84,-13
1995,36038,Pontevedra,Pontevedra,560,526,34
1995,36039,O Porriño,Pontevedra,79,69,10
1995,36041,Poio,Pontevedra,64,67,-3
1995,36042,Ponteareas,Pontevedra,132,85,47
1995,36045,Redondela,Pontevedra,89,114,-25
1995,36051,Sanxenxo,Pontevedra,95,51,44
1995,36052,Silleda,Pontevedra,25,50,-25
1995,36054,Tomiño,Pontevedra,41,67,-26
1995,36055,Tui,Pontevedra,58,91,-33
1995,36057,Vigo,Pontevedra,1740,1888,-148
1995,36060,Vilagarcía de Arousa,Pontevedra,223,306,-83
1995,36061,Vilanova de Arousa,Pontevedra,50,75,-25
1995,37046,Béjar,Salamanca,113,197,-84
1995,37107,Ciudad Rodrigo,Salamanca,122,164,-42
1995,37274,Salamanca,Salamanca,1733,1724,9
1995,38001,Adeje,Santa Cruz de Tenerife,524,216,308
1995,38006,Arona,Santa Cruz de Tenerife,1162,468,694
1995,38011,Candelaria,Santa Cruz de Tenerife,138,140,-2
1995,38017,Granadilla de Abona,Santa Cruz de Tenerife,483,216,267
1995,38019,Guía de Isora,Santa Cruz de Tenerife,93,34,59
1995,38020,Güímar,Santa Cruz de Tenerife,58,30,28
1995,38022,Icod de los Vinos,Santa Cruz de Tenerife,51,39,12
1995,38023,San Cristóbal de La Laguna,Santa Cruz de Tenerife,689,486,203
1995,38024,Los Llanos de Aridane,Santa Cruz de Tenerife,75,90,-15
1995,38026,La Orotava,Santa Cruz de Tenerife,106,99,7
1995,38028,Puerto de la Cruz,Santa Cruz de Tenerife,282,231,51
1995,38031,Los Realejos,Santa Cruz de Tenerife,82,43,39
1995,38032,El Rosario,Santa Cruz de Tenerife,149,134,15
1995,38037,Santa Cruz de la Palma,Santa Cruz de Tenerife,210,175,35
1995,38038,Santa Cruz de Tenerife,Santa Cruz de Tenerife,1530,1508,22
1995,38043,Tacoronte,Santa Cruz de Tenerife,76,53,23
1995,39008,El Astillero,Cantabria,80,90,-10
1995,39016,Camargo,Cantabria,157,105,52
1995,39020,Castro-Urdiales,Cantabria,908,240,668
1995,39025,Los Corrales de Buelna,Cantabria,45,50,-5
1995,39035,Laredo,Cantabria,224,178,46
1995,39059,Reinosa,Cantabria,79,103,-24
1995,39075,Santander,Cantabria,1369,1504,-135
1995,39079,Santoña,Cantabria,125,107,18
1995,39087,Torrelavega,Cantabria,250,284,-34
1995,40194,Segovia,Segovia,488,559,-71
1995,41004,Alcalá de Guadaíra,Sevilla,217,279,-62
1995,41007,La Algaba,Sevilla,32,35,-3
1995,41011,Arahal,Sevilla,50,39,11
1995,41018,Brenes,Sevilla,37,56,-19
1995,41020,Las Cabezas de San Juan,Sevilla,57,105,-48
1995,41021,Camas,Sevilla,111,102,9
1995,41024,Carmona,Sevilla,105,115,-10
1995,41029,Castilleja de la Cuesta,Sevilla,133,98,35
1995,41034,Coria del Río,Sevilla,59,81,-22
1995,41038,Dos Hermanas,Sevilla,587,499,88
1995,41039,Écija,Sevilla,253,204,49
1995,41041,Estepa,Sevilla,64,45,19
1995,41053,Lebrija,Sevilla,149,190,-41
1995,41055,Lora del Río,Sevilla,82,105,-23
1995,41058,Mairena del Alcor,Sevilla,50,45,5
1995,41059,Mairena del Aljarafe,Sevilla,404,205,199
1995,41060,Marchena,Sevilla,63,36,27
1995,41065,Morón de la Frontera,Sevilla,206,282,-76
1995,41068,Osuna,Sevilla,115,106,9
1995,41069,Los Palacios y Villafranca,Sevilla,96,125,-29
1995,41075,Pilas,Sevilla,27,51,-24
1995,41077,La Puebla de Cazalla,Sevilla,125,154,-29
1995,41079,La Puebla del Río,Sevilla,17,50,-33
1995,41081,La Rinconada,Sevilla,149,152,-3
1995,41086,San Juan de Aznalfarache,Sevilla,96,141,-45
1995,41087,Sanlúcar la Mayor,Sevilla,54,28,26
1995,41091,Sevilla,Sevilla,4770,4299,471
1995,41093,Tomares,Sevilla,218,147,71
1995,41095,Utrera,Sevilla,280,272,8
1995,41102,El Viso del Alcor,Sevilla,36,32,4
1995,42173,Soria,Soria,396,440,-44
1995,43014,Amposta,Tarragona,108,67,41
1995,43038,Cambrils,Tarragona,484,201,283
1995,43123,Reus,Tarragona,785,599,186
1995,43136,Sant Carles de la Ràpita,Tarragona,96,66,30
1995,43148,Tarragona,Tarragona,1105,893,212
1995,43155,Tortosa,Tarragona,296,214,82
1995,43161,Valls,Tarragona,178,134,44
1995,43163,El Vendrell,Tarragona,916,300,616
1995,43171,Vila-seca,Tarragona,222,119,103
1995,43901,Deltebre,Tarragona,31,24,7
1995,43905,Salou,Tarragona,522,182,340
1995,44013,Alcañiz,Teruel,143,110,33
1995,44216,Teruel,Teruel,405,351,54
1995,45053,Consuegra,Toledo,64,58,6
1995,45087,Madridejos,Toledo,60,57,3
1995,45165,Talavera de la Reina,Toledo,744,753,-9
1995,45168,Toledo,Toledo,1007,841,166
1995,46005,Alaquàs,Valencia,95,87,8
1995,46007,Albal,Valencia,35,38,-3
1995,46013,Alboraya,Valencia,117,55,62
1995,46017,Alzira,Valencia,112,136,-24
1995,46019,L'Alcúdia,Valencia,33,38,-5
1995,46021,Aldaia,Valencia,95,110,-15
1995,46022,Alfafar,Valencia,70,104,-34
1995,46029,Algemesí,Valencia,55,74,-19
1995,46031,Alginet,Valencia,34,27,7
1995,46054,Benetússer,Valencia,31,70,-39
1995,46060,Benifaió,Valencia,33,51,-18
1995,46070,Bétera,Valencia,173,120,53
1995,46078,Burjassot,Valencia,155,157,-2
1995,46081,Canals,Valencia,41,36,5
1995,46083,Carcaixent,Valencia,42,52,-10
1995,46085,Carlet,Valencia,18,36,-18
1995,46094,Catarroja,Valencia,64,60,4
1995,46102,Quart de Poblet,Valencia,117,105,12
1995,46105,Cullera,Valencia,115,120,-5
1995,46110,Xirivella,Valencia,123,162,-39
1995,46116,L'Eliana,Valencia,83,92,-9
1995,46131,Gandia,Valencia,558,454,104
1995,46135,Godella,Valencia,37,34,3
1995,46145,Xátiva,Valencia,157,96,61
1995,46147,Llíria,Valencia,104,58,46
1995,46159,Manises,Valencia,105,88,17
1995,46164,Massamagrell,Valencia,45,35,10
1995,46169,Mislata,Valencia,269,224,45
1995,46171,Moncada,Valencia,61,47,14
1995,46181,Oliva,Valencia,140,139,1
1995,46184,Ontinyent,Valencia,142,126,16
1995,46186,Paiporta,Valencia,83,64,19
1995,46190,Paterna,Valencia,290,306,-16
1995,46194,Picassent,Valencia,68,42,26
1995,46205,Puçol,Valencia,69,66,3
1995,46213,Requena,Valencia,116,99,17
1995,46214,Riba-roja de Túria,Valencia,28,55,-27
1995,46220,Sagunto/Sagunt,Valencia,344,320,24
1995,46230,Silla,Valencia,68,78,-10
1995,46235,Sueca,Valencia,73,72,1
1995,46238,Tavernes de la Valldigna,Valencia,59,35,24
1995,46244,Torrent (Valencia),Valencia,270,250,20
1995,46249,Utiel,Valencia,40,30,10
1995,46250,València,Valencia,4714,4678,36
1995,47076,Laguna de Duero,Valladolid,221,154,67
1995,47085,Medina del Campo,Valladolid,157,176,-19
1995,47186,Valladolid,Valladolid,2841,3122,-281
1995,48003,Amorebieta-Etxano,Vizcaya,75,121,-46
1995,48011,Arrigorriaga,Vizcaya,80,125,-45
1995,48013,Barakaldo,Vizcaya,408,935,-527
1995,48015,Basauri,Vizcaya,205,438,-233
1995,48017,Bermeo,Vizcaya,45,114,-69
1995,48020,Bilbao,Vizcaya,1693,3547,-1854
1995,48027,Durango,Vizcaya,166,191,-25
1995,48034,Ermua,Vizcaya,213,293,-80
1995,48036,Galdakao,Vizcaya,129,200,-71
1995,48044,Getxo,Vizcaya,563,799,-236
1995,48046,Gernika-Lumo,Vizcaya,57,65,-8
1995,48054,Leioa,Vizcaya,143,256,-113
1995,48069,Mungia,Vizcaya,57,54,3
1995,48073,Ondarroa,Vizcaya,63,170,-107
1995,48078,Portugalete,Vizcaya,201,578,-377
1995,48080,Valle de Trápaga-Trapagaran,Vizcaya,22,95,-73
1995,48082,Santurtzi,Vizcaya,242,439,-197
1995,48084,Sestao,Vizcaya,148,347,-199
1995,48902,Erandio,Vizcaya,82,225,-143
1995,49021,Benavente,Zamora,251,226,25
1995,49275,Zamora,Zamora,547,730,-183
1995,50067,Calatayud,Zaragoza,156,165,-9
1995,50095,Ejea de los Caballeros,Zaragoza,58,83,-25
1995,50251,Tarazona,Zaragoza,83,118,-35
1995,50297,Zaragoza,Zaragoza,4413,4055,358
1995,51001,Ceuta,Ceuta,994,1389,-395
1995,52001,Melilla,Melilla,1880,1527,353
1996,01036,Laudio/Llodio,Álava,115,173,-58
1996,01059,Vitoria-Gasteiz,Álava,1803,1307,496
1996,02003,Albacete,Albacete,845,989,-144
1996,02009,Almansa,Albacete,181,150,31
1996,02037,Hellín,Albacete,217,285,-68
1996,02069,La Roda,Albacete,85,63,22
1996,02081,Villarrobledo,Albacete,76,128,-52
1996,03009,Alcoy/Alcoi,Alicante,146,243,-97
1996,03011,L'Alfàs del Pi,Alicante,106,46,60
1996,03014,Alicante/Alacant,Alicante,1786,1612,174
1996,03015,Almoradí,Alicante,65,47,18
1996,03018,Altea,Alicante,111,104,7
1996,03019,Aspe,Alicante,53,63,-10
1996,03031,Benidorm,Alicante,843,580,263
1996,03047,Calp,Alicante,152,79,73
1996,03049,Callosa de Segura,Alicante,66,75,-9
1996,03050,El Campello,Alicante,166,78,88
1996,03056,Cocentaina,Alicante,34,67,-33
1996,03059,Crevillent,Alicante,52,61,-9
1996,03063,Dénia,Alicante,326,173,153
1996,03065,Elche/Elx,Alicante,728,529,199
1996,03066,Elda,Alicante,164,155,9
1996,03079,Ibi,Alicante,61,74,-13
1996,03082,Jávea/Xàbia,Alicante,120,91,29
1996,03089,Monóvar/Monòver,Alicante,21,24,-3
1996,03090,Mutxamel,Alicante,102,44,58
1996,03093,Novelda,Alicante,59,59,0
1996,03099,Orihuela,Alicante,352,411,-59
1996,03102,Pego,Alicante,49,86,-37
1996,03104,Petrer,Alicante,93,57,36
1996,03119,Sant Joan d'Alacant,Alicante,148,96,52
1996,03121,Santa Pola,Alicante,227,164,63
1996,03122,San Vicente del Raspeig/Sant Vicent del Raspeig,Alicante,195,139,56
1996,03133,Torrevieja,Alicante,1936,674,1262
1996,03139,Villajoyosa/La Vila Joiosa,Alicante,159,108,51
1996,03140,Villena,Alicante,139,150,-11
1996,04003,Adra,Almería,87,85,2
1996,04013,Almería,Almería,857,965,-108
1996,04029,Berja,Almería,48,56,-8
1996,04053,Huércal-Overa,Almería,140,105,35
1996,04066,Níjar,Almería,58,55,3
1996,04079,Roquetas de Mar,Almería,701,396,305
1996,04102,Vícar,Almería,147,86,61
1996,04902,El Ejido,Almería,473,305,168
1996,05019,Ávila,Ávila,318,365,-47
1996,06011,Almendralejo,Badajoz,171,140,31
1996,06015,Badajoz,Badajoz,1076,922,154
1996,06044,Don Benito,Badajoz,268,197,71
1996,06083,Mérida,Badajoz,529,317,212
1996,06088,Montijo,Badajoz,93,96,-3
1996,06095,Olivenza,Badajoz,45,62,-17
1996,06149,Villafranca de los Barros,Badajoz,63,84,-21
1996,06153,Villanueva de la Serena,Badajoz,146,145,1
1996,06158,Zafra,Badajoz,99,82,17
1996,07003,Alcúdia,Baleares,278,204,74
1996,07011,Calvià,Baleares,565,273,292
1996,07015,Ciutadella de Menorca,Baleares,263,149,114
1996,07022,Felanitx,Baleares,102,64,38
1996,07026,Eivissa,Baleares,416,446,-30
1996,07027,Inca,Baleares,132,69,63
1996,07031,Llucmajor,Baleares,245,82,163
1996,07032,Maó-Mahón,Baleares,339,308,31
1996,07033,Manacor,Baleares,401,149,252
1996,07036,Marratxí,Baleares,63,41,22
1996,07040,Palma,Baleares,3758,2037,1721
1996,07042,Pollença,Baleares,201,82,119
1996,07044,Sa Pobla,Baleares,51,19,32
1996,07046,Sant Antoni de Portmany,Baleares,176,146,30
1996,07048,Sant Josep de sa Talaia,Baleares,97,112,-15
1996,07054,Santa Eulària des Riu,Baleares,226,234,-8
1996,07061,Sóller,Baleares,48,22,26
1996,08006,Arenys de Mar,Barcelona,42,36,6
1996,08015,Badalona,Barcelona,664,903,-239
1996,08019,Barcelona,Barcelona,5930,8359,-2429
1996,08022,Berga,Barcelona,27,35,-8
1996,08033,Caldes de Montbui,Barcelona,28,46,-18
1996,08035,Calella,Barcelona,76,82,-6
1996,08041,Canovelles,Barcelona,39,38,1
1996,08046,Cardedeu,Barcelona,40,34,6
1996,08051,Castellar del Vallès,Barcelona,44,46,-2
1996,08056,Castelldefels,Barcelona,311,308,3
1996,08073,Cornellà de Llobregat,Barcelona,309,400,-91
1996,08076,Esparreguera,Barcelona,69,93,-24
1996,08077,Esplugues de Llobregat,Barcelona,190,275,-85
1996,08086,Les Franqueses del Vallès,Barcelona,34,32,2
1996,08088,La Garriga,Barcelona,41,31,10
1996,08089,Gavà,Barcelona,168,189,-21
1996,08096,Granollers,Barcelona,176,209,-33
1996,08101,L'Hospitalet de Llobregat,Barcelona,644,1296,-652
1996,08102,Igualada,Barcelona,91,110,-19
1996,08105,La Llagosta,Barcelona,42,41,1
1996,08110,Malgrat de Mar,Barcelona,102,103,-1
1996,08112,Manlleu,Barcelona,51,50,1
1996,08113,Manresa,Barcelona,111,181,-70
1996,08114,Martorell,Barcelona,83,61,22
1996,08118,El Masnou,Barcelona,116,102,14
1996,08121,Mataró,Barcelona,388,394,-6
1996,08123,Molins de Rei,Barcelona,42,53,-11
1996,08124,Mollet del Vallès,Barcelona,158,202,-44
1996,08125,Montcada i Reixac,Barcelona,79,88,-9
1996,08136,Montornès del Vallès,Barcelona,44,72,-28
1996,08147,Olesa de Montserrat,Barcelona,55,50,5
1996,08159,Parets del Vallès,Barcelona,59,49,10
1996,08163,Pineda de Mar,Barcelona,154,146,8
1996,08169,El Prat de Llobregat,Barcelona,334,444,-110
1996,08172,Premià de Mar,Barcelona,92,132,-40
1996,08180,Ripollet,Barcelona,76,159,-83
1996,08184,Rubí,Barcelona,240,292,-52
1996,08187,Sabadell,Barcelona,621,725,-104
1996,08194,Sant Adrià de Besòs,Barcelona,121,178,-57
1996,08196,Sant Andreu de la Barca,Barcelona,107,129,-22
1996,08200,Sant Boi de Llobregat,Barcelona,225,505,-280
1996,08202,Sant Celoni,Barcelona,66,88,-22
1996,08205,Sant Cugat del Vallès,Barcelona,228,213,15
1996,08211,Sant Feliu de Llobregat,Barcelona,102,180,-78
1996,08217,Sant Joan Despí,Barcelona,70,128,-58
1996,08219,Vilassar de Mar,Barcelona,75,57,18
1996,08221,Sant Just Desvern,Barcelona,27,68,-41
1996,08231,Sant Pere de Ribes,Barcelona,158,81,77
1996,08238,Sant Quirze del Vallès,Barcelona,34,29,5
1996,08245,Santa Coloma de Gramenet,Barcelona,429,610,-181
1996,08252,Barberà del Vallès,Barcelona,96,164,-68
1996,08260,Santa Perpètua de Mogoda,Barcelona,62,91,-29
1996,08263,Sant Vicenç dels Horts,Barcelona,103,75,28
1996,08266,Cerdanyola del Vallès,Barcelona,235,264,-29
1996,08270,Sitges,Barcelona,142,71,71
1996,08279,Terrassa,Barcelona,500,598,-98
1996,08285,Torelló,Barcelona,36,27,9
1996,08298,Vic,Barcelona,141,97,44
1996,08301,Viladecans,Barcelona,226,242,-16
1996,08302,Vilanova del Camí,Barcelona,31,24,7
1996,08305,Vilafranca del Penedès,Barcelona,144,134,10
1996,08307,Vilanova i la Geltrú,Barcelona,355,226,129
1996,08904,Badia del Vallès,Barcelona,71,110,-39
1996,09018,Aranda de Duero,Burgos,155,208,-53
1996,09059,Burgos,Burgos,926,1195,-269
1996,09219,Miranda de Ebro,Burgos,353,458,-105
1996,10037,Cáceres,Cáceres,264,531,-267
1996,10067,Coria,Cáceres,103,109,-6
1996,10131,Navalmoral de la Mata,Cáceres,108,161,-53
1996,10148,Plasencia,Cáceres,113,330,-217
1996,11004,Algeciras,Cádiz,761,651,110
1996,11006,Arcos de la Frontera,Cádiz,117,234,-117
1996,11007,Barbate,Cádiz,190,301,-111
1996,11008,Los Barrios,Cádiz,151,66,85
1996,11012,Cádiz,Cádiz,248,989,-741
1996,11014,Conil de la Frontera,Cádiz,45,73,-28
1996,11015,Chiclana de la Frontera,Cádiz,402,294,108
1996,11016,Chipiona,Cádiz,87,93,-6
1996,11020,Jerez de la Frontera,Cádiz,928,1765,-837
1996,11022,La Línea de la Concepción,Cádiz,393,403,-10
1996,11023,Medina-Sidonia,Cádiz,16,41,-25
1996,11027,El Puerto de Santa María,Cádiz,642,636,6
1996,11028,Puerto Real,Cádiz,105,112,-7
1996,11030,Rota,Cádiz,210,255,-45
1996,11031,San Fernando,Cádiz,485,744,-259
1996,11032,Sanlúcar de Barrameda,Cádiz,232,209,23
1996,11033,San Roque,Cádiz,106,150,-44
1996,11035,Tarifa,Cádiz,83,83,0
1996,11038,Ubrique,Cádiz,49,50,-1
1996,11039,Vejer de la Frontera,Cádiz,31,24,7
1996,11041,Villamartín,Cádiz,60,73,-13
1996,12009,Almassora,Castellón,80,56,24
1996,12027,Benicarló,Castellón,86,143,-57
1996,12032,Borriana/Burriana,Castellón,96,131,-35
1996,12040,Castellón de la Plana/Castelló de la Plana,Castellón,1217,869,348
1996,12082,Nules,Castellón,49,41,8
1996,12084,Onda,Castellón,52,30,22
1996,12126,La Vall d'Uixó,Castellón,137,104,33
1996,12135,Vila-real,Castellón,124,147,-23
1996,12138,Vinaròs,Castellón,247,121,126
1996,13005,Alcázar de San Juan,Ciudad Real,206,187,19
1996,13023,Bolaños de Calatrava,Ciudad Real,32,30,2
1996,13028,Campo de Criptana,Ciudad Real,50,72,-22
1996,13034,Ciudad Real,Ciudad Real,507,408,99
1996,13039,Daimiel,Ciudad Real,90,101,-11
1996,13053,Manzanares,Ciudad Real,126,129,-3
1996,13071,Puertollano,Ciudad Real,354,417,-63
1996,13078,Socuéllamos,Ciudad Real,39,79,-40
1996,13079,La Solana,Ciudad Real,39,30,9
1996,13082,Tomelloso,Ciudad Real,119,102,17
1996,13087,Valdepeñas,Ciudad Real,153,142,11
1996,14002,Aguilar de la Frontera,Córdoba,53,32,21
1996,14007,Baena,Córdoba,304,79,225
1996,14013,Cabra,Córdoba,58,94,-36
1996,14017,La Carlota,Córdoba,84,64,20
1996,14021,Córdoba,Córdoba,1640,1924,-284
1996,14038,Lucena,Córdoba,202,143,59
1996,14042,Montilla,Córdoba,87,67,20
1996,14049,Palma del Río,Córdoba,169,169,0
1996,14052,Peñarroya-Pueblonuevo,Córdoba,74,106,-32
1996,14054,Pozoblanco,Córdoba,61,55,6
1996,14055,Priego de Córdoba,Córdoba,155,119,36
1996,14056,Puente Genil,Córdoba,171,179,-8
1996,14058,Rute,Córdoba,70,56,14
1996,14069,Villanueva de Córdoba,Córdoba,52,68,-16
1996,15002,Ames,A Coruña,121,41,80
1996,15005,Arteixo,A Coruña,85,27,58
1996,15009,Betanzos,A Coruña,24,68,-44
1996,15011,Boiro,A Coruña,65,102,-37
1996,15017,Cambre,A Coruña,79,58,21
1996,15019,Carballo,A Coruña,72,81,-9
1996,15030,A Coruña,A Coruña,1110,1040,70
1996,15031,Culleredo,A Coruña,58,44,14
1996,15035,Fene,A Coruña,55,56,-1
1996,15036,Ferrol,A Coruña,610,656,-46
1996,15041,A Laracha,A Coruña,11,16,-5
1996,15053,Muros,A Coruña,28,217,-189
1996,15054,Narón,A Coruña,146,170,-24
1996,15057,Noia,A Coruña,49,93,-44
1996,15058,Oleiros,A Coruña,147,121,26
1996,15059,Ordes,A Coruña,42,15,27
1996,15065,Padrón,A Coruña,59,51,8
1996,15067,A Pobra do Caramiñal,A Coruña,25,33,-8
1996,15070,As Pontes de García Rodríguez,A Coruña,56,116,-60
1996,15071,Porto do Son,A Coruña,25,82,-57
1996,15072,Rianxo,A Coruña,51,67,-16
1996,15073,Ribeira,A Coruña,106,73,33
1996,15077,Santa Comba,A Coruña,6,20,-14
1996,15078,Santiago de Compostela,A Coruña,626,484,142
1996,15082,Teo,A Coruña,48,32,16
1996,16078,Cuenca,Cuenca,237,321,-84
1996,16203,Tarancón,Cuenca,96,89,7
1996,17015,Banyoles,Girona,87,37,50
1996,17023,Blanes,Girona,579,482,97
1996,17066,Figueres,Girona,262,243,19
1996,17079,Girona,Girona,434,528,-94
1996,17095,Lloret de Mar,Girona,472,273,199
1996,17114,Olot,Girona,100,81,19
1996,17117,Palafrugell,Girona,138,123,15
1996,17118,Palamós,Girona,134,87,47
1996,17147,Ripoll,Girona,59,106,-47
1996,17152,Roses,Girona,168,132,36
1996,17155,Salt,Girona,151,139,12
1996,17160,Sant Feliu de Guíxols,Girona,187,125,62
1996,18003,Albolote,Granada,69,46,23
1996,18017,Almuñécar,Granada,103,178,-75
1996,18021,Armilla,Granada,115,75,40
1996,18022,Atarfe,Granada,32,47,-15
1996,18023,Baza,Granada,101,165,-64
1996,18087,Granada,Granada,1896,1843,53
1996,18089,Guadix,Granada,98,109,-11
1996,18102,Illora,Granada,59,69,-10
1996,18122,Loja,Granada,62,113,-51
1996,18127,Maracena,Granada,23,58,-35
1996,18140,Motril,Granada,244,292,-48
1996,18158,Pinos Puente,Granada,38,76,-38
1996,18173,Salobreña,Granada,92,64,28
1996,18175,Santa Fe,Granada,65,65,0
1996,18193,La Zubia,Granada,87,70,17
1996,19046,Azuqueca de Henares,Guadalajara,846,205,641
1996,19130,Guadalajara,Guadalajara,762,458,304
1996,20009,Andoain,Guipúzcoa,28,98,-70
1996,20017,Azkoitia,Guipúzcoa,34,36,-2
1996,20018,Azpeitia,Guipúzcoa,30,37,-7
1996,20019,Beasain,Guipúzcoa,43,67,-24
1996,20030,Eibar,Guipúzcoa,164,302,-138
1996,20032,Elgoibar,Guipúzcoa,38,81,-43
1996,20036,Hondarribia,Guipúzcoa,56,62,-6
1996,20040,Hernani,Guipúzcoa,57,82,-25
1996,20045,Irun,Guipúzcoa,328,442,-114
1996,20055,Arrasate/Mondragón,Guipúzcoa,104,205,-101
1996,20059,Oñati,Guipúzcoa,64,46,18
1996,20064,Pasaia,Guipúzcoa,40,93,-53
1996,20067,Errenteria,Guipúzcoa,132,221,-89
1996,20069,Donostia/San Sebastián,Guipúzcoa,546,1055,-509
1996,20071,Tolosa,Guipúzcoa,47,101,-54
1996,20074,Bergara,Guipúzcoa,39,77,-38
1996,20079,Zarautz,Guipúzcoa,73,126,-53
1996,20080,Zumarraga,Guipúzcoa,24,75,-51
1996,20902,Lasarte-Oria,Guipúzcoa,54,111,-57
1996,21005,Almonte,Huelva,97,120,-23
1996,21010,Ayamonte,Huelva,80,95,-15
1996,21013,Bollullos Par del Condado,Huelva,34,17,17
1996,21021,Cartaya,Huelva,64,39,25
1996,21035,Gibraleón,Huelva,34,44,-10
1996,21041,Huelva,Huelva,520,601,-81
1996,21042,Isla Cristina,Huelva,67,66,1
1996,21044,Lepe,Huelva,146,118,28
1996,21050,Moguer,Huelva,67,59,8
1996,21060,Punta Umbría,Huelva,66,28,38
1996,21072,Valverde del Camino,Huelva,46,38,8
1996,22048,Barbastro,Huesca,83,142,-59
1996,22112,Fraga,Huesca,75,114,-39
1996,22125,Huesca,Huesca,367,361,6
1996,22130,Jaca,Huesca,153,157,-4
1996,22158,Monzón,Huesca,73,84,-11
1996,23002,Alcalá la Real,Jaén,134,217,-83
1996,23003,Alcaudete,Jaén,61,119,-58
1996,23005,Andújar,Jaén,175,348,-173
1996,23009,Baeza,Jaén,62,111,-49
1996,23010,Bailén,Jaén,29,130,-101
1996,23024,La Carolina,Jaén,10,118,-108
1996,23050,Jaén,Jaén,574,637,-63
1996,23053,Jódar,Jaén,70,88,-18
1996,23055,Linares,Jaén,252,589,-337
1996,23060,Martos,Jaén,64,80,-16
1996,23086,Torredelcampo,Jaén,33,39,-6
1996,23087,Torredonjimeno,Jaén,34,48,-14
1996,23092,Úbeda,Jaén,155,233,-78
1996,23095,Villacarrillo,Jaén,40,97,-57
1996,24008,Astorga,León,83,105,-22
1996,24010,La Bañeza,León,76,73,3
1996,24014,Bembibre,León,58,84,-26
1996,24089,León,León,836,1036,-200
1996,24115,Ponferrada,León,248,391,-143
1996,24142,San Andrés del Rabanedo,León,100,91,9
1996,24202,Villablino,León,56,140,-84
1996,25040,Balaguer,Lleida,39,55,-16
1996,25120,Lleida,Lleida,632,817,-185
1996,25203,La Seu d'Urgell,Lleida,138,156,-18
1996,25217,Tàrrega,Lleida,95,64,31
1996,26018,Arnedo,La Rioja,126,64,62
1996,26036,Calahorra,La Rioja,182,146,36
1996,26089,Logroño,La Rioja,958,862,96
1996,27016,Chantada,Lugo,47,60,-13
1996,27028,Lugo,Lugo,492,429,63
1996,27031,Monforte de Lemos,Lugo,97,120,-23
1996,27057,Sarria,Lugo,40,39,1
1996,27065,Vilalba,Lugo,61,52,9
1996,27066,Viveiro,Lugo,99,57,42
1996,28005,Alcalá de Henares,Madrid,1024,1613,-589
1996,28006,Alcobendas,Madrid,402,449,-47
1996,28007,Alcorcón,Madrid,461,713,-252
1996,28009,Algete,Madrid,37,65,-28
1996,28013,Aranjuez,Madrid,285,283,2
1996,28014,Arganda del Rey,Madrid,78,125,-47
1996,28022,Boadilla del Monte,Madrid,72,80,-8
1996,28040,Ciempozuelos,Madrid,61,53,8
1996,28045,Colmenar Viejo,Madrid,190,178,12
1996,28047,Collado Villalba,Madrid,123,247,-124
1996,28049,Coslada,Madrid,206,314,-108
1996,28058,Fuenlabrada,Madrid,585,1286,-701
1996,28061,Galapagar,Madrid,73,109,-36
1996,28065,Getafe,Madrid,405,776,-371
1996,28074,Leganés,Madrid,558,879,-321
1996,28079,Madrid,Madrid,12935,16704,-3769
1996,28080,Majadahonda,Madrid,182,241,-59
1996,28084,Mejorada del Campo,Madrid,62,121,-59
1996,28092,Móstoles,Madrid,766,1266,-500
1996,28096,Navalcarnero,Madrid,45,47,-2
1996,28106,Parla,Madrid,265,563,-298
1996,28113,Pinto,Madrid,165,112,53
1996,28115,Pozuelo de Alarcón,Madrid,269,253,16
1996,28123,Rivas-Vaciamadrid,Madrid,61,66,-5
1996,28127,Las Rozas de Madrid,Madrid,337,284,53
1996,28130,San Fernando de Henares,Madrid,109,165,-56
1996,28131,San Lorenzo de El Escorial,Madrid,58,45,13
1996,28134,San Sebastián de los Reyes,Madrid,201,232,-31
1996,28148,Torrejón de Ardoz,Madrid,405,612,-207
1996,28152,Torrelodones,Madrid,48,57,-9
1996,28161,Valdemoro,Madrid,231,286,-55
1996,28181,Villaviciosa de Odón,Madrid,59,74,-15
1996,28903,Tres Cantos,Madrid,278,211,67
1996,29007,Alhaurín de la Torre,Málaga,93,40,53
1996,29008,Alhaurín el Grande,Málaga,44,56,-12
1996,29012,Álora,Málaga,55,74,-19
1996,29015,Antequera,Málaga,161,172,-11
1996,29025,Benalmádena,Málaga,238,148,90
1996,29038,Cártama,Málaga,45,46,-1
1996,29042,Coín,Málaga,40,34,6
1996,29051,Estepona,Málaga,382,244,138
1996,29054,Fuengirola,Málaga,702,386,316
1996,29067,Málaga,Málaga,1581,2056,-475
1996,29069,Marbella,Málaga,1041,536,505
1996,29070,Mijas,Málaga,147,125,22
1996,29075,Nerja,Málaga,54,82,-28
1996,29082,Rincón de la Victoria,Málaga,237,90,147
1996,29084,Ronda,Málaga,200,246,-46
1996,29091,Torrox,Málaga,31,30,1
1996,29094,Vélez-Málaga,Málaga,340,211,129
1996,29901,Torremolinos,Málaga,396,328,68
1996,30002,Abarán,Murcia,45,41,4
1996,30003,Águilas,Murcia,256,223,33
1996,30005,Alcantarilla,Murcia,229,203,26
1996,30008,Alhama de Murcia,Murcia,50,44,6
1996,30009,Archena,Murcia,72,73,-1
1996,30012,Bullas,Murcia,23,13,10
1996,30015,Caravaca de la Cruz,Murcia,133,93,40
1996,30016,Cartagena,Murcia,1507,1502,5
1996,30017,Cehegín,Murcia,65,54,11
1996,30019,Cieza (Murcia),Murcia,63,128,-65
1996,30022,Jumilla,Murcia,92,79,13
1996,30024,Lorca,Murcia,446,311,135
1996,30026,Mazarrón,Murcia,199,105,94
1996,30027,Molina de Segura,Murcia,174,169,5
1996,30029,Mula,Murcia,46,43,3
1996,30030,Murcia,Murcia,1761,1482,279
1996,30033,Puerto Lumbreras,Murcia,89,84,5
1996,30035,San Javier,Murcia,406,247,159
1996,30036,San Pedro del Pinatar,Murcia,311,153,158
1996,30037,Torre-Pacheco,Murcia,165,108,57
1996,30038,Las Torres de Cotillas,Murcia,70,63,7
1996,30039,Totana,Murcia,97,62,35
1996,30041,La Unión,Murcia,50,50,0
1996,30043,Yecla,Murcia,170,154,16
1996,31060,Burlada/Burlata,Navarra,93,57,36
1996,31097,Estella-Lizarra,Navarra,67,82,-15
1996,31201,Pamplona/Iruña,Navarra,795,742,53
1996,31227,Tafalla,Navarra,33,26,7
1996,31232,Tudela,Navarra,224,144,80
1996,31901,Barañain,Navarra,121,108,13
1996,32009,O Barco de Valdeorras,Ourense,115,51,64
1996,32019,O Carballiño,Ourense,54,52,2
1996,32054,Ourense,Ourense,452,567,-115
1996,32085,Verín,Ourense,109,118,-9
1996,33002,Aller,Asturias,31,47,-16
1996,33004,Avilés,Asturias,300,425,-125
1996,33011,Cangas del Narcea,Asturias,73,78,-5
1996,33014,Carreño,Asturias,28,32,-4
1996,33016,Castrillón,Asturias,127,97,30
1996,33020,Corvera de Asturias,Asturias,88,73,15
1996,33024,Gijón,Asturias,1041,1115,-74
1996,33025,Gozón,Asturias,13,23,-10
1996,33026,Grado,Asturias,15,19,-4
1996,33031,Langreo,Asturias,90,166,-76
1996,33032,Laviana,Asturias,20,17,3
1996,33033,Lena,Asturias,41,38,3
1996,33034,Valdés,Asturias,71,59,12
1996,33035,Llanera,Asturias,38,23,15
1996,33036,Llanes,Asturias,50,68,-18
1996,33037,Mieres (Asturias),Asturias,86,172,-86
1996,33044,Oviedo,Asturias,922,885,37
1996,33060,San Martín del Rey Aurelio,Asturias,13,36,-23
1996,33066,Siero,Asturias,118,104,14
1996,33073,Tineo,Asturias,25,32,-7
1996,33076,Villaviciosa,Asturias,34,19,15
1996,34120,Palencia,Palencia,537,542,-5
1996,35002,Agüimes,Las Palmas,135,72,63
1996,35004,Arrecife,Las Palmas,1367,465,902
1996,35006,Arucas,Las Palmas,59,61,-2
1996,35009,Gáldar,Las Palmas,35,22,13
1996,35011,Ingenio,Las Palmas,56,26,30
1996,35012,Mogán,Las Palmas,257,75,182
1996,35016,Las Palmas de Gran Canaria,Las Palmas,3253,2311,942
1996,35017,Puerto del Rosario,Las Palmas,977,722,255
1996,35019,San Bartolomé de Tirajana,Las Palmas,503,269,234
1996,35021,Santa Brígida,Las Palmas,46,48,-2
1996,35022,Santa Lucía de Tirajana,Las Palmas,252,82,170
1996,35023,Santa María de Guía de Gran Canaria,Las Palmas,17,30,-13
1996,35026,Telde,Las Palmas,370,238,132
1996,35027,Teror,Las Palmas,13,23,-10
1996,35028,Tías,Las Palmas,669,225,444
1996,36003,Baiona,Pontevedra,17,31,-14
1996,36004,Bueu,Pontevedra,26,44,-18
1996,36006,Cambados,Pontevedra,59,76,-17
1996,36008,Cangas,Pontevedra,46,76,-30
1996,36017,A Estrada,Pontevedra,85,96,-11
1996,36021,Gondomar,Pontevedra,28,18,10
1996,36022,O Grove,Pontevedra,26,40,-14
1996,36024,Lalín,Pontevedra,37,57,-20
1996,36026,Marín,Pontevedra,151,232,-81
1996,36029,Moaña,Pontevedra,37,50,-13
1996,36033,Mos,Pontevedra,22,21,1
1996,36035,Nigrán,Pontevedra,40,44,-4
1996,36038,Pontevedra,Pontevedra,312,461,-149
1996,36039,O Porriño,Pontevedra,37,35,2
1996,36041,Poio,Pontevedra,41,40,1
1996,36042,Ponteareas,Pontevedra,50,75,-25
1996,36045,Redondela,Pontevedra,40,79,-39
1996,36051,Sanxenxo,Pontevedra,49,55,-6
1996,36054,Tomiño,Pontevedra,25,41,-16
1996,36055,Tui,Pontevedra,27,68,-41
1996,36057,Vigo,Pontevedra,1177,1366,-189
1996,36060,Vilagarcía de Arousa,Pontevedra,146,269,-123
1996,36061,Vilanova de Arousa,Pontevedra,40,74,-34
1996,37046,Béjar,Salamanca,104,120,-16
1996,37107,Ciudad Rodrigo,Salamanca,72,137,-65
1996,37274,Salamanca,Salamanca,1273,1293,-20
1996,38001,Adeje,Santa Cruz de Tenerife,347,166,181
1996,38006,Arona,Santa Cruz de Tenerife,1374,385,989
1996,38011,Candelaria,Santa Cruz de Tenerife,250,101,149
1996,38017,Granadilla de Abona,Santa Cruz de Tenerife,422,175,247
1996,38019,Guía de Isora,Santa Cruz de Tenerife,58,33,25
1996,38020,Güímar,Santa Cruz de Tenerife,70,21,49
1996,38022,Icod de los Vinos,Santa Cruz de Tenerife,39,20,19
1996,38023,San Cristóbal de La Laguna,Santa Cruz de Tenerife,315,368,-53
1996,38024,Los Llanos de Aridane,Santa Cruz de Tenerife,109,86,23
1996,38026,La Orotava,Santa Cruz de Tenerife,107,70,37
1996,38028,Puerto de la Cruz,Santa Cruz de Tenerife,305,168,137
1996,38031,Los Realejos,Santa Cruz de Tenerife,61,47,14
1996,38032,El Rosario,Santa Cruz de Tenerife,104,88,16
1996,38037,Santa Cruz de la Palma,Santa Cruz de Tenerife,210,120,90
1996,38038,Santa Cruz de Tenerife,Santa Cruz de Tenerife,1606,1196,410
1996,38043,Tacoronte,Santa Cruz de Tenerife,53,38,15
1996,39008,El Astillero,Cantabria,51,74,-23
1996,39016,Camargo,Cantabria,90,85,5
1996,39020,Castro-Urdiales,Cantabria,716,254,462
1996,39025,Los Corrales de Buelna,Cantabria,22,19,3
1996,39035,Laredo,Cantabria,148,106,42
1996,39052,Piélagos,Cantabria,30,30,0
1996,39059,Reinosa,Cantabria,47,39,8
1996,39075,Santander,Cantabria,816,1118,-302
1996,39079,Santoña,Cantabria,57,60,-3
1996,39087,Torrelavega,Cantabria,174,257,-83
1996,40194,Segovia,Segovia,269,406,-137
1996,41004,Alcalá de Guadaíra,Sevilla,94,178,-84
1996,41007,La Algaba,Sevilla,16,42,-26
1996,41011,Arahal,Sevilla,46,35,11
1996,41018,Brenes,Sevilla,24,56,-32
1996,41020,Las Cabezas de San Juan,Sevilla,53,79,-26
1996,41021,Camas,Sevilla,51,101,-50
1996,41024,Carmona,Sevilla,102,95,7
1996,41029,Castilleja de la Cuesta,Sevilla,71,83,-12
1996,41034,Coria del Río,Sevilla,38,52,-14
1996,41038,Dos Hermanas,Sevilla,489,490,-1
1996,41039,Écija,Sevilla,186,212,-26
1996,41041,Estepa,Sevilla,54,49,5
1996,41053,Lebrija,Sevilla,106,142,-36
1996,41055,Lora del Río,Sevilla,75,115,-40
1996,41058,Mairena del Alcor,Sevilla,31,45,-14
1996,41059,Mairena del Aljarafe,Sevilla,187,136,51
1996,41060,Marchena,Sevilla,31,38,-7
1996,41065,Morón de la Frontera,Sevilla,185,208,-23
1996,41068,Osuna,Sevilla,88,38,50
1996,41069,Los Palacios y Villafranca,Sevilla,79,97,-18
1996,41075,Pilas,Sevilla,40,19,21
1996,41077,La Puebla de Cazalla,Sevilla,94,172,-78
1996,41079,La Puebla del Río,Sevilla,35,52,-17
1996,41081,La Rinconada,Sevilla,99,72,27
1996,41086,San Juan de Aznalfarache,Sevilla,76,158,-82
1996,41087,Sanlúcar la Mayor,Sevilla,35,20,15
1996,41091,Sevilla,Sevilla,3637,3053,584
1996,41093,Tomares,Sevilla,141,100,41
1996,41095,Utrera,Sevilla,177,203,-26
1996,41102,El Viso del Alcor,Sevilla,26,13,13
1996,42173,Soria,Soria,298,267,31
1996,43014,Amposta,Tarragona,84,73,11
1996,43038,Cambrils,Tarragona,305,167,138
1996,43123,Reus,Tarragona,535,463,72
1996,43136,Sant Carles de la Ràpita,Tarragona,110,58,52
1996,43148,Tarragona,Tarragona,836,642,194
1996,43155,Tortosa,Tarragona,95,182,-87
1996,43161,Valls,Tarragona,112,69,43
1996,43163,El Vendrell,Tarragona,751,283,468
1996,43171,Vila-seca,Tarragona,160,92,68
1996,43901,Deltebre,Tarragona,43,15,28
1996,43905,Salou,Tarragona,306,167,139
1996,44013,Alcañiz,Teruel,84,119,-35
1996,44216,Teruel,Teruel,202,294,-92
1996,45053,Consuegra,Toledo,29,54,-25
1996,45087,Madridejos,Toledo,51,46,5
1996,45165,Talavera de la Reina,Toledo,472,495,-23
1996,45168,Toledo,Toledo,575,590,-15
1996,46005,Alaquàs,Valencia,81,51,30
1996,46007,Albal,Valencia,27,27,0
1996,46013,Alboraya,Valencia,65,46,19
1996,46017,Alzira,Valencia,91,105,-14
1996,46019,L'Alcúdia,Valencia,20,34,-14
1996,46021,Aldaia,Valencia,68,59,9
1996,46022,Alfafar,Valencia,55,51,4
1996,46029,Algemesí,Valencia,41,39,2
1996,46031,Alginet,Valencia,22,27,-5
1996,46054,Benetússer,Valencia,56,50,6
1996,46060,Benifaió,Valencia,42,26,16
1996,46070,Bétera,Valencia,215,122,93
1996,46078,Burjassot,Valencia,91,122,-31
1996,46081,Canals,Valencia,33,38,-5
1996,46083,Carcaixent,Valencia,47,40,7
1996,46085,Carlet,Valencia,19,34,-15
1996,46094,Catarroja,Valencia,33,58,-25
1996,46102,Quart de Poblet,Valencia,100,81,19
1996,46105,Cullera,Valencia,81,71,10
1996,46110,Xirivella,Valencia,88,72,16
1996,46116,L'Eliana,Valencia,95,84,11
1996,46131,Gandia,Valencia,592,267,325
1996,46135,Godella,Valencia,26,32,-6
1996,46145,Xátiva,Valencia,83,75,8
1996,46147,Llíria,Valencia,119,44,75
1996,46159,Manises,Valencia,69,59,10
1996,46164,Massamagrell,Valencia,43,33,10
1996,46169,Mislata,Valencia,172,179,-7
1996,46171,Moncada,Valencia,34,52,-18
1996,46181,Oliva,Valencia,83,72,11
1996,46184,Ontinyent,Valencia,93,71,22
1996,46186,Paiporta,Valencia,52,43,9
1996,46190,Paterna,Valencia,205,210,-5
1996,46194,Picassent,Valencia,28,34,-6
1996,46205,Puçol,Valencia,52,32,20
1996,46213,Requena,Valencia,89,74,15
1996,46214,Riba-roja de Túria,Valencia,43,33,10
1996,46220,Sagunto/Sagunt,Valencia,182,206,-24
1996,46230,Silla,Valencia,61,51,10
1996,46235,Sueca,Valencia,42,46,-4
1996,46238,Tavernes de la Valldigna,Valencia,52,29,23
1996,46244,Torrent (Valencia),Valencia,196,193,3
1996,46249,Utiel,Valencia,12,54,-42
1996,46250,València,Valencia,4803,3028,1775
1996,47076,Laguna de Duero,Valladolid,186,112,74
1996,47085,Medina del Campo,Valladolid,114,130,-16
1996,47186,Valladolid,Valladolid,1972,2168,-196
1996,48003,Amorebieta-Etxano,Vizcaya,35,80,-45
1996,48011,Arrigorriaga,Vizcaya,35,87,-52
1996,48013,Barakaldo,Vizcaya,255,706,-451
1996,48015,Basauri,Vizcaya,152,307,-155
1996,48017,Bermeo,Vizcaya,42,53,-11
1996,48020,Bilbao,Vizcaya,1550,2525,-975
1996,48027,Durango,Vizcaya,112,106,6
1996,48034,Ermua,Vizcaya,130,155,-25
1996,48036,Galdakao,Vizcaya,83,182,-99
1996,48044,Getxo,Vizcaya,372,551,-179
1996,48046,Gernika-Lumo,Vizcaya,18,54,-36
1996,48054,Leioa,Vizcaya,102,136,-34
1996,48069,Mungia,Vizcaya,50,65,-15
1996,48073,Ondarroa,Vizcaya,50,74,-24
1996,48078,Portugalete,Vizcaya,160,380,-220
1996,48080,Valle de Trápaga-Trapagaran,Vizcaya,27,100,-73
1996,48082,Santurtzi,Vizcaya,172,363,-191
1996,48084,Sestao,Vizcaya,106,306,-200
1996,48902,Erandio,Vizcaya,53,139,-86
1996,49021,Benavente,Zamora,154,129,25
1996,49275,Zamora,Zamora,410,477,-67
1996,50067,Calatayud,Zaragoza,128,135,-7
1996,50095,Ejea de los Caballeros,Zaragoza,48,45,3
1996,50251,Tarazona,Zaragoza,88,74,14
1996,50297,Zaragoza,Zaragoza,2787,2829,-42
1996,51001,Ceuta,Ceuta,978,1182,-204
1996,52001,Melilla,Melilla,1909,1226,683
1997,01036,Laudio/Llodio,Álava,164,280,-116
1997,01059,Vitoria-Gasteiz,Álava,2513,2059,454
1997,02003,Albacete,Albacete,1157,1316,-159
1997,02009,Almansa,Albacete,210,239,-29
1997,02037,Hellín,Albacete,204,283,-79
1997,02069,La Roda,Albacete,91,122,-31
1997,02081,Villarrobledo,Albacete,189,205,-16
1997,03009,Alcoy/Alcoi,Alicante,251,355,-104
1997,03011,L'Alfàs del Pi,Alicante,189,90,99
1997,03014,Alicante/Alacant,Alicante,3318,2127,1191
1997,03015,Almoradí,Alicante,92,79,13
1997,03018,Altea,Alicante,165,88,77
1997,03019,Aspe,Alicante,52,52,0
1997,03031,Benidorm,Alicante,1425,845,580
1997,03047,Calp,Alicante,266,123,143
1997,03049,Callosa de Segura,Alicante,56,58,-2
1997,03050,El Campello,Alicante,273,110,163
1997,03056,Cocentaina,Alicante,51,58,-7
1997,03059,Crevillent,Alicante,85,91,-6
1997,03063,Dénia,Alicante,420,237,183
1997,03065,Elche/Elx,Alicante,1010,707,303
1997,03066,Elda,Alicante,253,215,38
1997,03079,Ibi,Alicante,95,93,2
1997,03082,Jávea/Xàbia,Alicante,250,126,124
1997,03089,Monóvar/Monòver,Alicante,30,23,7
1997,03090,Mutxamel,Alicante,76,68,8
1997,03093,Novelda,Alicante,80,74,6
1997,03099,Orihuela,Alicante,571,490,81
1997,03102,Pego,Alicante,87,72,15
1997,03104,Petrer,Alicante,128,99,29
1997,03119,Sant Joan d'Alacant,Alicante,215,119,96
1997,03121,Santa Pola,Alicante,341,192,149
1997,03122,San Vicente del Raspeig/Sant Vicent del Raspeig,Alicante,242,160,82
1997,03133,Torrevieja,Alicante,2573,872,1701
1997,03139,Villajoyosa/La Vila Joiosa,Alicante,232,131,101
1997,03140,Villena,Alicante,180,203,-23
1997,04003,Adra,Almería,170,151,19
1997,04013,Almería,Almería,1334,1276,58
1997,04029,Berja,Almería,119,49,70
1997,04053,Huércal-Overa,Almería,180,175,5
1997,04066,Níjar,Almería,105,91,14
1997,04079,Roquetas de Mar,Almería,945,525,420
1997,04102,Vícar,Almería,215,119,96
1997,04902,El Ejido,Almería,698,356,342
1997,05019,Ávila,Ávila,475,562,-87
1997,06011,Almendralejo,Badajoz,188,193,-5
1997,06015,Badajoz,Badajoz,1322,1312,10
1997,06044,Don Benito,Badajoz,207,306,-99
1997,06083,Mérida,Badajoz,438,443,-5
1997,06088,Montijo,Badajoz,142,96,46
1997,06095,Olivenza,Badajoz,90,92,-2
1997,06149,Villafranca de los Barros,Badajoz,49,63,-14
1997,06153,Villanueva de la Serena,Badajoz,177,190,-13
1997,06158,Zafra,Badajoz,88,113,-25
1997,07003,Alcúdia,Baleares,380,206,174
1997,07011,Calvià,Baleares,826,289,537
1997,07015,Ciutadella de Menorca,Baleares,353,184,169
1997,07022,Felanitx,Baleares,174,72,102
1997,07026,Eivissa,Baleares,727,667,60
1997,07027,Inca,Baleares,228,104,124
1997,07031,Llucmajor,Baleares,356,177,179
1997,07032,Maó-Mahón,Baleares,327,315,12
1997,07033,Manacor,Baleares,679,214,465
1997,07036,Marratxí,Baleares,85,29,56
1997,07040,Palma,Baleares,4474,2915,1559
1997,07042,Pollença,Baleares,265,88,177
1997,07044,Sa Pobla,Baleares,25,28,-3
1997,07046,Sant Antoni de Portmany,Baleares,234,131,103
1997,07048,Sant Josep de sa Talaia,Baleares,211,87,124
1997,07054,Santa Eulària des Riu,Baleares,556,184,372
1997,07061,Sóller,Baleares,125,32,93
1997,08006,Arenys de Mar,Barcelona,60,87,-27
1997,08015,Badalona,Barcelona,727,1238,-511
1997,08019,Barcelona,Barcelona,7012,12454,-5442
1997,08022,Berga,Barcelona,46,96,-50
1997,08033,Caldes de Montbui,Barcelona,28,51,-23
1997,08035,Calella,Barcelona,112,112,0
1997,08041,Canovelles,Barcelona,57,52,5
1997,08046,Cardedeu,Barcelona,60,37,23
1997,08051,Castellar del Vallès,Barcelona,62,69,-7
1997,08056,Castelldefels,Barcelona,524,394,130
1997,08073,Cornellà de Llobregat,Barcelona,343,501,-158
1997,08076,Esparreguera,Barcelona,110,87,23
1997,08077,Esplugues de Llobregat,Barcelona,234,334,-100
1997,08086,Les Franqueses del Vallès,Barcelona,64,38,26
1997,08088,La Garriga,Barcelona,25,57,-32
1997,08089,Gavà,Barcelona,227,270,-43
1997,08096,Granollers,Barcelona,217,298,-81
1997,08101,L'Hospitalet de Llobregat,Barcelona,989,1747,-758
1997,08102,Igualada,Barcelona,122,213,-91
1997,08105,La Llagosta,Barcelona,42,70,-28
1997,08110,Malgrat de Mar,Barcelona,111,149,-38
1997,08112,Manlleu,Barcelona,70,129,-59
1997,08113,Manresa,Barcelona,170,244,-74
1997,08114,Martorell,Barcelona,132,115,17
1997,08118,El Masnou,Barcelona,100,143,-43
1997,08121,Mataró,Barcelona,428,508,-80
1997,08123,Molins de Rei,Barcelona,74,107,-33
1997,08124,Mollet del Vallès,Barcelona,234,252,-18
1997,08125,Montcada i Reixac,Barcelona,95,135,-40
1997,08136,Montornès del Vallès,Barcelona,54,63,-9
1997,08147,Olesa de Montserrat,Barcelona,101,76,25
1997,08159,Parets del Vallès,Barcelona,59,79,-20
1997,08163,Pineda de Mar,Barcelona,156,221,-65
1997,08169,El Prat de Llobregat,Barcelona,281,476,-195
1997,08172,Premià de Mar,Barcelona,122,211,-89
1997,08180,Ripollet,Barcelona,151,191,-40
1997,08184,Rubí,Barcelona,276,300,-24
1997,08187,Sabadell,Barcelona,683,955,-272
1997,08194,Sant Adrià de Besòs,Barcelona,100,156,-56
1997,08196,Sant Andreu de la Barca,Barcelona,125,203,-78
1997,08200,Sant Boi de Llobregat,Barcelona,386,426,-40
1997,08202,Sant Celoni,Barcelona,87,131,-44
1997,08205,Sant Cugat del Vallès,Barcelona,420,304,116
1997,08211,Sant Feliu de Llobregat,Barcelona,131,253,-122
1997,08217,Sant Joan Despí,Barcelona,59,148,-89
1997,08219,Vilassar de Mar,Barcelona,102,97,5
1997,08221,Sant Just Desvern,Barcelona,57,63,-6
1997,08231,Sant Pere de Ribes,Barcelona,150,136,14
1997,08238,Sant Quirze del Vallès,Barcelona,54,30,24
1997,08245,Santa Coloma de Gramenet,Barcelona,481,870,-389
1997,08252,Barberà del Vallès,Barcelona,122,157,-35
1997,08260,Santa Perpètua de Mogoda,Barcelona,97,102,-5
1997,08263,Sant Vicenç dels Horts,Barcelona,88,139,-51
1997,08266,Cerdanyola del Vallès,Barcelona,299,312,-13
1997,08270,Sitges,Barcelona,158,116,42
1997,08279,Terrassa,Barcelona,564,788,-224
1997,08285,Torelló,Barcelona,38,45,-7
1997,08298,Vic,Barcelona,138,189,-51
1997,08301,Viladecans,Barcelona,286,413,-127
1997,08302,Vilanova del Camí,Barcelona,38,56,-18
1997,08305,Vilafranca del Penedès,Barcelona,183,171,12
1997,08307,Vilanova i la Geltrú,Barcelona,412,308,104
1997,08904,Badia del Vallès,Barcelona,56,108,-52
1997,09018,Aranda de Duero,Burgos,199,318,-119
1997,09059,Burgos,Burgos,1307,1553,-246
1997,09219,Miranda de Ebro,Burgos,430,586,-156
1997,10037,Cáceres,Cáceres,701,729,-28
1997,10067,Coria,Cáceres,149,90,59
1997,10131,Navalmoral de la Mata,Cáceres,161,239,-78
1997,10148,Plasencia,Cáceres,322,395,-73
1997,11004,Algeciras,Cádiz,932,969,-37
1997,11006,Arcos de la Frontera,Cádiz,111,309,-198
1997,11007,Barbate,Cádiz,238,235,3
1997,11008,Los Barrios,Cádiz,177,125,52
1997,11012,Cádiz,Cádiz,556,1330,-774
1997,11014,Conil de la Frontera,Cádiz,60,46,14
1997,11015,Chiclana de la Frontera,Cádiz,402,409,-7
1997,11016,Chipiona,Cádiz,134,75,59
1997,11020,Jerez de la Frontera,Cádiz,1105,2345,-1240
1997,11022,La Línea de la Concepción,Cádiz,429,685,-256
1997,11023,Medina-Sidonia,Cádiz,50,62,-12
1997,11027,El Puerto de Santa María,Cádiz,798,818,-20
1997,11028,Puerto Real,Cádiz,140,107,33
1997,11030,Rota,Cádiz,309,363,-54
1997,11031,San Fernando,Cádiz,682,815,-133
1997,11032,Sanlúcar de Barrameda,Cádiz,253,284,-31
1997,11033,San Roque,Cádiz,209,256,-47
1997,11035,Tarifa,Cádiz,112,148,-36
1997,11038,Ubrique,Cádiz,39,73,-34
1997,11039,Vejer de la Frontera,Cádiz,36,60,-24
1997,11041,Villamartín,Cádiz,97,102,-5
1997,12009,Almassora,Castellón,76,51,25
1997,12027,Benicarló,Castellón,262,221,41
1997,12032,Borriana/Burriana,Castellón,140,116,24
1997,12040,Castellón de la Plana/Castelló de la Plana,Castellón,1462,1012,450
1997,12082,Nules,Castellón,84,66,18
1997,12084,Onda,Castellón,91,43,48
1997,12126,La Vall d'Uixó,Castellón,183,160,23
1997,12135,Vila-real,Castellón,284,182,102
1997,12138,Vinaròs,Castellón,429,278,151
1997,13005,Alcázar de San Juan,Ciudad Real,274,301,-27
1997,13023,Bolaños de Calatrava,Ciudad Real,23,36,-13
1997,13028,Campo de Criptana,Ciudad Real,69,62,7
1997,13034,Ciudad Real,Ciudad Real,579,579,0
1997,13039,Daimiel,Ciudad Real,77,104,-27
1997,13053,Manzanares,Ciudad Real,140,196,-56
1997,13071,Puertollano,Ciudad Real,427,634,-207
1997,13078,Socuéllamos,Ciudad Real,48,84,-36
1997,13079,La Solana,Ciudad Real,56,65,-9
1997,13082,Tomelloso,Ciudad Real,129,145,-16
1997,13087,Valdepeñas,Ciudad Real,183,222,-39
1997,14002,Aguilar de la Frontera,Córdoba,44,61,-17
1997,14007,Baena,Córdoba,353,224,129
1997,14013,Cabra,Córdoba,106,99,7
1997,14017,La Carlota,Córdoba,80,80,0
1997,14021,Córdoba,Córdoba,1799,2920,-1121
1997,14038,Lucena,Córdoba,287,227,60
1997,14042,Montilla,Córdoba,102,106,-4
1997,14049,Palma del Río,Córdoba,188,189,-1
1997,14052,Peñarroya-Pueblonuevo,Córdoba,84,207,-123
1997,14054,Pozoblanco,Córdoba,78,101,-23
1997,14055,Priego de Córdoba,Córdoba,177,157,20
1997,14056,Puente Genil,Córdoba,184,203,-19
1997,14058,Rute,Córdoba,61,70,-9
1997,14069,Villanueva de Córdoba,Córdoba,69,70,-1
1997,15002,Ames,A Coruña,225,67,158
1997,15005,Arteixo,A Coruña,65,69,-4
1997,15009,Betanzos,A Coruña,87,52,35
1997,15011,Boiro,A Coruña,52,132,-80
1997,15017,Cambre,A Coruña,123,59,64
1997,15019,Carballo,A Coruña,72,125,-53
1997,15030,A Coruña,A Coruña,1652,1671,-19
1997,15031,Culleredo,A Coruña,108,92,16
1997,15035,Fene,A Coruña,59,63,-4
1997,15036,Ferrol,A Coruña,776,818,-42
1997,15041,A Laracha,A Coruña,16,32,-16
1997,15053,Muros,A Coruña,62,223,-161
1997,15054,Narón,A Coruña,177,207,-30
1997,15057,Noia,A Coruña,115,103,12
1997,15058,Oleiros,A Coruña,252,134,118
1997,15059,Ordes,A Coruña,30,37,-7
1997,15065,Padrón,A Coruña,91,91,0
1997,15067,A Pobra do Caramiñal,A Coruña,37,59,-22
1997,15070,As Pontes de García Rodríguez,A Coruña,64,105,-41
1997,15071,Porto do Son,A Coruña,40,101,-61
1997,15072,Rianxo,A Coruña,45,77,-32
1997,15073,Ribeira,A Coruña,133,138,-5
1997,15077,Santa Comba,A Coruña,12,25,-13
1997,15078,Santiago de Compostela,A Coruña,996,700,296
1997,15082,Teo,A Coruña,89,58,31
1997,16078,Cuenca,Cuenca,326,493,-167
1997,16203,Tarancón,Cuenca,124,149,-25
1997,17015,Banyoles,Girona,109,45,64
1997,17023,Blanes,Girona,757,535,222
1997,17066,Figueres,Girona,367,382,-15
1997,17079,Girona,Girona,728,679,49
1997,17095,Lloret de Mar,Girona,526,308,218
1997,17114,Olot,Girona,176,105,71
1997,17117,Palafrugell,Girona,224,176,48
1997,17118,Palamós,Girona,209,124,85
1997,17147,Ripoll,Girona,262,144,118
1997,17152,Roses,Girona,230,133,97
1997,17155,Salt,Girona,184,164,20
1997,17160,Sant Feliu de Guíxols,Girona,243,209,34
1997,18003,Albolote,Granada,110,91,19
1997,18017,Almuñécar,Granada,146,262,-116
1997,18021,Armilla,Granada,136,103,33
1997,18022,Atarfe,Granada,69,81,-12
1997,18023,Baza,Granada,156,156,0
1997,18087,Granada,Granada,2328,2700,-372
1997,18089,Guadix,Granada,148,298,-150
1997,18102,Illora,Granada,82,108,-26
1997,18122,Loja,Granada,140,140,0
1997,18127,Maracena,Granada,113,102,11
1997,18140,Motril,Granada,310,418,-108
1997,18158,Pinos Puente,Granada,62,84,-22
1997,18173,Salobreña,Granada,120,130,-10
1997,18175,Santa Fe,Granada,65,80,-15
1997,18193,La Zubia,Granada,104,80,24
1997,19046,Azuqueca de Henares,Guadalajara,1045,298,747
1997,19130,Guadalajara,Guadalajara,1021,669,352
1997,20009,Andoain,Guipúzcoa,67,95,-28
1997,20017,Azkoitia,Guipúzcoa,41,45,-4
1997,20018,Azpeitia,Guipúzcoa,32,52,-20
1997,20019,Beasain,Guipúzcoa,71,80,-9
1997,20030,Eibar,Guipúzcoa,240,390,-150
1997,20032,Elgoibar,Guipúzcoa,68,102,-34
1997,20036,Hondarribia,Guipúzcoa,81,90,-9
1997,20040,Hernani,Guipúzcoa,96,106,-10
1997,20045,Irun,Guipúzcoa,550,644,-94
1997,20055,Arrasate/Mondragón,Guipúzcoa,127,236,-109
1997,20059,Oñati,Guipúzcoa,47,55,-8
1997,20064,Pasaia,Guipúzcoa,81,89,-8
1997,20067,Errenteria,Guipúzcoa,180,267,-87
1997,20069,Donostia/San Sebastián,Guipúzcoa,1280,1595,-315
1997,20071,Tolosa,Guipúzcoa,64,95,-31
1997,20074,Bergara,Guipúzcoa,50,91,-41
1997,20079,Zarautz,Guipúzcoa,187,137,50
1997,20080,Zumarraga,Guipúzcoa,80,93,-13
1997,20902,Lasarte-Oria,Guipúzcoa,117,144,-27
1997,21005,Almonte,Huelva,149,129,20
1997,21010,Ayamonte,Huelva,92,129,-37
1997,21013,Bollullos Par del Condado,Huelva,38,30,8
1997,21021,Cartaya,Huelva,125,95,30
1997,21035,Gibraleón,Huelva,42,53,-11
1997,21041,Huelva,Huelva,618,805,-187
1997,21042,Isla Cristina,Huelva,107,148,-41
1997,21044,Lepe,Huelva,151,123,28
1997,21050,Moguer,Huelva,146,107,39
1997,21060,Punta Umbría,Huelva,81,86,-5
1997,21072,Valverde del Camino,Huelva,46,56,-10
1997,22048,Barbastro,Huesca,146,155,-9
1997,22112,Fraga,Huesca,133,133,0
1997,22125,Huesca,Huesca,330,516,-186
1997,22130,Jaca,Huesca,215,264,-49
1997,22158,Monzón,Huesca,114,119,-5
1997,23002,Alcalá la Real,Jaén,212,218,-6
1997,23003,Alcaudete,Jaén,93,93,0
1997,23005,Andújar,Jaén,229,379,-150
1997,23009,Baeza,Jaén,120,74,46
1997,23010,Bailén,Jaén,67,109,-42
1997,23024,La Carolina,Jaén,42,187,-145
1997,23050,Jaén,Jaén,717,822,-105
1997,23053,Jódar,Jaén,102,92,10
1997,23055,Linares,Jaén,385,796,-411
1997,23060,Martos,Jaén,134,95,39
1997,23086,Torredelcampo,Jaén,57,36,21
1997,23087,Torredonjimeno,Jaén,82,57,25
1997,23092,Úbeda,Jaén,185,305,-120
1997,23095,Villacarrillo,Jaén,64,92,-28
1997,24008,Astorga,León,97,170,-73
1997,24010,La Bañeza,León,77,102,-25
1997,24014,Bembibre,León,58,138,-80
1997,24089,León,León,1106,1457,-351
1997,24115,Ponferrada,León,477,601,-124
1997,24142,San Andrés del Rabanedo,León,182,137,45
1997,24202,Villablino,León,97,200,-103
1997,25040,Balaguer,Lleida,104,115,-11
1997,25120,Lleida,Lleida,869,1003,-134
1997,25203,La Seu d'Urgell,Lleida,176,189,-13
1997,25217,Tàrrega,Lleida,139,101,38
1997,26018,Arnedo,La Rioja,102,75,27
1997,26036,Calahorra,La Rioja,206,171,35
1997,26089,Logroño,La Rioja,1460,1228,232
1997,27016,Chantada,Lugo,64,101,-37
1997,27028,Lugo,Lugo,594,696,-102
1997,27031,Monforte de Lemos,Lugo,244,145,99
1997,27057,Sarria,Lugo,90,47,43
1997,27065,Vilalba,Lugo,70,76,-6
1997,27066,Viveiro,Lugo,134,147,-13
1997,28005,Alcalá de Henares,Madrid,1350,2062,-712
1997,28006,Alcobendas,Madrid,542,553,-11
1997,28007,Alcorcón,Madrid,745,953,-208
1997,28009,Algete,Madrid,168,110,58
1997,28013,Aranjuez,Madrid,201,367,-166
1997,28014,Arganda del Rey,Madrid,160,186,-26
1997,28022,Boadilla del Monte,Madrid,107,124,-17
1997,28040,Ciempozuelos,Madrid,80,69,11
1997,28045,Colmenar Viejo,Madrid,261,219,42
1997,28047,Collado Villalba,Madrid,457,340,117
1997,28049,Coslada,Madrid,297,483,-186
1997,28058,Fuenlabrada,Madrid,1145,1595,-450
1997,28061,Galapagar,Madrid,168,208,-40
1997,28065,Getafe,Madrid,686,1020,-334
1997,28074,Leganés,Madrid,645,1160,-515
1997,28079,Madrid,Madrid,17289,23370,-6081
1997,28080,Majadahonda,Madrid,404,322,82
1997,28084,Mejorada del Campo,Madrid,57,101,-44
1997,28092,Móstoles,Madrid,915,1711,-796
1997,28096,Navalcarnero,Madrid,94,112,-18
1997,28106,Parla,Madrid,403,734,-331
1997,28113,Pinto,Madrid,220,168,52
1997,28115,Pozuelo de Alarcón,Madrid,439,352,87
1997,28123,Rivas-Vaciamadrid,Madrid,120,116,4
1997,28127,Las Rozas de Madrid,Madrid,537,354,183
1997,28130,San Fernando de Henares,Madrid,181,192,-11
1997,28131,San Lorenzo de El Escorial,Madrid,125,101,24
1997,28134,San Sebastián de los Reyes,Madrid,369,376,-7
1997,28148,Torrejón de Ardoz,Madrid,576,721,-145
1997,28152,Torrelodones,Madrid,126,83,43
1997,28161,Valdemoro,Madrid,356,321,35
1997,28181,Villaviciosa de Odón,Madrid,84,70,14
1997,28903,Tres Cantos,Madrid,537,227,310
1997,29007,Alhaurín de la Torre,Málaga,212,71,141
1997,29008,Alhaurín el Grande,Málaga,36,31,5
1997,29012,Álora,Málaga,72,69,3
1997,29015,Antequera,Málaga,206,191,15
1997,29025,Benalmádena,Málaga,502,278,224
1997,29038,Cártama,Málaga,18,15,3
1997,29042,Coín,Málaga,74,41,33
1997,29051,Estepona,Málaga,764,337,427
1997,29054,Fuengirola,Málaga,950,414,536
1997,29067,Málaga,Málaga,2767,2924,-157
1997,29069,Marbella,Málaga,1626,652,974
1997,29070,Mijas,Málaga,450,160,290
1997,29075,Nerja,Málaga,139,76,63
1997,29082,Rincón de la Victoria,Málaga,268,138,130
1997,29084,Ronda,Málaga,270,302,-32
1997,29091,Torrox,Málaga,66,46,20
1997,29094,Vélez-Málaga,Málaga,348,267,81
1997,29901,Torremolinos,Málaga,730,405,325
1997,30002,Abarán,Murcia,49,32,17
1997,30003,Águilas,Murcia,395,205,190
1997,30005,Alcantarilla,Murcia,260,230,30
1997,30008,Alhama de Murcia,Murcia,69,68,1
1997,30009,Archena,Murcia,63,73,-10
1997,30012,Bullas,Murcia,32,36,-4
1997,30015,Caravaca de la Cruz,Murcia,184,136,48
1997,30016,Cartagena,Murcia,1774,1627,147
1997,30017,Cehegín,Murcia,93,60,33
1997,30019,Cieza (Murcia),Murcia,134,119,15
1997,30022,Jumilla,Murcia,105,198,-93
1997,30024,Lorca,Murcia,401,353,48
1997,30026,Mazarrón,Murcia,354,139,215
1997,30027,Molina de Segura,Murcia,286,216,70
1997,30029,Mula,Murcia,59,55,4
1997,30030,Murcia,Murcia,1982,1940,42
1997,30033,Puerto Lumbreras,Murcia,115,82,33
1997,30035,San Javier,Murcia,460,391,69
1997,30036,San Pedro del Pinatar,Murcia,414,244,170
1997,30037,Torre-Pacheco,Murcia,229,289,-60
1997,30038,Las Torres de Cotillas,Murcia,92,76,16
1997,30039,Totana,Murcia,94,62,32
1997,30041,La Unión,Murcia,76,63,13
1997,30043,Yecla,Murcia,221,179,42
1997,31060,Burlada/Burlata,Navarra,84,70,14
1997,31097,Estella-Lizarra,Navarra,91,84,7
1997,31201,Pamplona/Iruña,Navarra,1227,1212,15
1997,31227,Tafalla,Navarra,36,43,-7
1997,31232,Tudela,Navarra,275,261,14
1997,31901,Barañain,Navarra,221,122,99
1997,32009,O Barco de Valdeorras,Ourense,181,115,66
1997,32019,O Carballiño,Ourense,74,84,-10
1997,32054,Ourense,Ourense,803,1079,-276
1997,32085,Verín,Ourense,152,142,10
1997,33002,Aller,Asturias,25,73,-48
1997,33004,Avilés,Asturias,448,577,-129
1997,33011,Cangas del Narcea,Asturias,72,135,-63
1997,33014,Carreño,Asturias,53,57,-4
1997,33016,Castrillón,Asturias,144,116,28
1997,33020,Corvera de Asturias,Asturias,82,124,-42
1997,33024,Gijón,Asturias,1686,1695,-9
1997,33025,Gozón,Asturias,24,42,-18
1997,33026,Grado,Asturias,28,53,-25
1997,33031,Langreo,Asturias,92,208,-116
1997,33032,Laviana,Asturias,20,39,-19
1997,33033,Lena,Asturias,70,114,-44
1997,33034,Valdés,Asturias,62,71,-9
1997,33035,Llanera,Asturias,32,42,-10
1997,33036,Llanes,Asturias,74,119,-45
1997,33037,Mieres (Asturias),Asturias,153,241,-88
1997,33044,Oviedo,Asturias,1151,1254,-103
1997,33060,San Martín del Rey Aurelio,Asturias,56,55,1
1997,33066,Siero,Asturias,173,154,19
1997,33073,Tineo,Asturias,41,60,-19
1997,33076,Villaviciosa,Asturias,50,63,-13
1997,34120,Palencia,Palencia,739,765,-26
1997,35002,Agüimes,Las Palmas,241,88,153
1997,35004,Arrecife,Las Palmas,1649,739,910
1997,35006,Arucas,Las Palmas,102,54,48
1997,35009,Gáldar,Las Palmas,62,42,20
1997,35011,Ingenio,Las Palmas,101,21,80
1997,35012,Mogán,Las Palmas,299,188,111
1997,35016,Las Palmas de Gran Canaria,Las Palmas,3699,3001,698
1997,35017,Puerto del Rosario,Las Palmas,852,508,344
1997,35019,San Bartolomé de Tirajana,Las Palmas,640,403,237
1997,35021,Santa Brígida,Las Palmas,83,83,0
1997,35022,Santa Lucía de Tirajana,Las Palmas,566,172,394
1997,35023,Santa María de Guía de Gran Canaria,Las Palmas,57,40,17
1997,35026,Telde,Las Palmas,431,298,133
1997,35027,Teror,Las Palmas,10,10,0
1997,35028,Tías,Las Palmas,624,299,325
1997,36003,Baiona,Pontevedra,65,58,7
1997,36004,Bueu,Pontevedra,27,65,-38
1997,36006,Cambados,Pontevedra,49,83,-34
1997,36008,Cangas,Pontevedra,81,122,-41
1997,36017,A Estrada,Pontevedra,147,151,-4
1997,36021,Gondomar,Pontevedra,43,28,15
1997,36022,O Grove,Pontevedra,62,73,-11
1997,36024,Lalín,Pontevedra,103,135,-32
1997,36026,Marín,Pontevedra,258,245,13
1997,36029,Moaña,Pontevedra,42,82,-40
1997,36033,Mos,Pontevedra,26,52,-26
1997,36035,Nigrán,Pontevedra,83,66,17
1997,36038,Pontevedra,Pontevedra,327,682,-355
1997,36039,O Porriño,Pontevedra,60,88,-28
1997,36041,Poio,Pontevedra,79,72,7
1997,36042,Ponteareas,Pontevedra,89,171,-82
1997,36045,Redondela,Pontevedra,73,100,-27
1997,36051,Sanxenxo,Pontevedra,56,87,-31
1997,36054,Tomiño,Pontevedra,41,52,-11
1997,36055,Tui,Pontevedra,74,97,-23
1997,36057,Vigo,Pontevedra,1721,1922,-201
1997,36060,Vilagarcía de Arousa,Pontevedra,279,316,-37
1997,36061,Vilanova de Arousa,Pontevedra,43,99,-56
1997,37046,Béjar,Salamanca,91,198,-107
1997,37107,Ciudad Rodrigo,Salamanca,102,166,-64
1997,37274,Salamanca,Salamanca,1597,1787,-190
1997,38001,Adeje,Santa Cruz de Tenerife,862,253,609
1997,38006,Arona,Santa Cruz de Tenerife,1849,679,1170
1997,38011,Candelaria,Santa Cruz de Tenerife,239,130,109
1997,38017,Granadilla de Abona,Santa Cruz de Tenerife,537,235,302
1997,38019,Guía de Isora,Santa Cruz de Tenerife,148,57,91
1997,38020,Güímar,Santa Cruz de Tenerife,66,40,26
1997,38022,Icod de los Vinos,Santa Cruz de Tenerife,52,46,6
1997,38023,San Cristóbal de La Laguna,Santa Cruz de Tenerife,1069,585,484
1997,38024,Los Llanos de Aridane,Santa Cruz de Tenerife,188,104,84
1997,38026,La Orotava,Santa Cruz de Tenerife,107,76,31
1997,38028,Puerto de la Cruz,Santa Cruz de Tenerife,382,255,127
1997,38031,Los Realejos,Santa Cruz de Tenerife,86,45,41
1997,38032,El Rosario,Santa Cruz de Tenerife,130,97,33
1997,38037,Santa Cruz de la Palma,Santa Cruz de Tenerife,267,206,61
1997,38038,Santa Cruz de Tenerife,Santa Cruz de Tenerife,1953,1767,186
1997,38043,Tacoronte,Santa Cruz de Tenerife,93,67,26
1997,39008,El Astillero,Cantabria,48,80,-32
1997,39016,Camargo,Cantabria,118,95,23
1997,39020,Castro-Urdiales,Cantabria,1135,412,723
1997,39025,Los Corrales de Buelna,Cantabria,30,44,-14
1997,39035,Laredo,Cantabria,238,175,63
1997,39052,Piélagos,Cantabria,110,47,63
1997,39059,Reinosa,Cantabria,65,95,-30
1997,39075,Santander,Cantabria,1241,1506,-265
1997,39079,Santoña,Cantabria,122,127,-5
1997,39087,Torrelavega,Cantabria,251,381,-130
1997,40194,Segovia,Segovia,391,564,-173
1997,41004,Alcalá de Guadaíra,Sevilla,172,375,-203
1997,41007,La Algaba,Sevilla,38,42,-4
1997,41011,Arahal,Sevilla,46,44,2
1997,41018,Brenes,Sevilla,46,57,-11
1997,41020,Las Cabezas de San Juan,Sevilla,58,139,-81
1997,41021,Camas,Sevilla,120,105,15
1997,41024,Carmona,Sevilla,130,167,-37
1997,41029,Castilleja de la Cuesta,Sevilla,90,94,-4
1997,41034,Coria del Río,Sevilla,62,70,-8
1997,41038,Dos Hermanas,Sevilla,427,629,-202
1997,41039,Écija,Sevilla,151,266,-115
1997,41041,Estepa,Sevilla,74,78,-4
1997,41053,Lebrija,Sevilla,145,205,-60
1997,41055,Lora del Río,Sevilla,113,164,-51
1997,41058,Mairena del Alcor,Sevilla,60,77,-17
1997,41059,Mairena del Aljarafe,Sevilla,296,228,68
1997,41060,Marchena,Sevilla,86,64,22
1997,41065,Morón de la Frontera,Sevilla,195,341,-146
1997,41068,Osuna,Sevilla,115,97,18
1997,41069,Los Palacios y Villafranca,Sevilla,94,159,-65
1997,41075,Pilas,Sevilla,30,29,1
1997,41077,La Puebla de Cazalla,Sevilla,84,150,-66
1997,41079,La Puebla del Río,Sevilla,24,49,-25
1997,41081,La Rinconada,Sevilla,140,133,7
1997,41086,San Juan de Aznalfarache,Sevilla,87,124,-37
1997,41087,Sanlúcar la Mayor,Sevilla,33,38,-5
1997,41091,Sevilla,Sevilla,4025,4867,-842
1997,41093,Tomares,Sevilla,179,122,57
1997,41095,Utrera,Sevilla,189,239,-50
1997,41102,El Viso del Alcor,Sevilla,33,51,-18
1997,42173,Soria,Soria,420,436,-16
1997,43014,Amposta,Tarragona,96,89,7
1997,43038,Cambrils,Tarragona,384,209,175
1997,43123,Reus,Tarragona,682,610,72
1997,43136,Sant Carles de la Ràpita,Tarragona,142,78,64
1997,43148,Tarragona,Tarragona,966,912,54
1997,43155,Tortosa,Tarragona,226,219,7
1997,43161,Valls,Tarragona,157,143,14
1997,43163,El Vendrell,Tarragona,793,358,435
1997,43171,Vila-seca,Tarragona,287,129,158
1997,43901,Deltebre,Tarragona,47,45,2
1997,43905,Salou,Tarragona,455,183,272
1997,44013,Alcañiz,Teruel,151,145,6
1997,44216,Teruel,Teruel,267,334,-67
1997,45053,Consuegra,Toledo,53,58,-5
1997,45087,Madridejos,Toledo,31,67,-36
1997,45165,Talavera de la Reina,Toledo,630,711,-81
1997,45168,Toledo,Toledo,1031,740,291
1997,46005,Alaquàs,Valencia,78,86,-8
1997,46007,Albal,Valencia,37,32,5
1997,46013,Alboraya,Valencia,119,62,57
1997,46017,Alzira,Valencia,163,125,38
1997,46019,L'Alcúdia,Valencia,20,55,-35
1997,46021,Aldaia,Valencia,119,68,51
1997,46022,Alfafar,Valencia,83,81,2
1997,46029,Algemesí,Valencia,61,95,-34
1997,46031,Alginet,Valencia,23,28,-5
1997,46054,Benetússer,Valencia,62,46,16
1997,46060,Benifaió,Valencia,43,36,7
1997,46070,Bétera,Valencia,83,89,-6
1997,46078,Burjassot,Valencia,144,126,18
1997,46081,Canals,Valencia,32,37,-5
1997,46083,Carcaixent,Valencia,52,51,1
1997,46085,Carlet,Valencia,46,43,3
1997,46094,Catarroja,Valencia,53,69,-16
1997,46102,Quart de Poblet,Valencia,121,106,15
1997,46105,Cullera,Valencia,150,123,27
1997,46110,Xirivella,Valencia,91,144,-53
1997,46116,L'Eliana,Valencia,108,63,45
1997,46131,Gandia,Valencia,558,324,234
1997,46135,Godella,Valencia,70,32,38
1997,46145,Xátiva,Valencia,138,134,4
1997,46147,Llíria,Valencia,96,65,31
1997,46159,Manises,Valencia,139,106,33
1997,46164,Massamagrell,Valencia,63,42,21
1997,46169,Mislata,Valencia,179,211,-32
1997,46171,Moncada,Valencia,38,58,-20
1997,46181,Oliva,Valencia,112,119,-7
1997,46184,Ontinyent,Valencia,133,110,23
1997,46186,Paiporta,Valencia,15,59,-44
1997,46190,Paterna,Valencia,319,270,49
1997,46194,Picassent,Valencia,60,53,7
1997,46205,Puçol,Valencia,88,43,45
1997,46213,Requena,Valencia,76,76,0
1997,46214,Riba-roja de Túria,Valencia,49,54,-5
1997,46220,Sagunto/Sagunt,Valencia,317,358,-41
1997,46230,Silla,Valencia,42,78,-36
1997,46235,Sueca,Valencia,44,56,-12
1997,46238,Tavernes de la Valldigna,Valencia,64,46,18
1997,46244,Torrent (Valencia),Valencia,333,266,67
1997,46249,Utiel,Valencia,40,44,-4
1997,46250,València,Valencia,4450,4731,-281
1997,47076,Laguna de Duero,Valladolid,154,117,37
1997,47085,Medina del Campo,Valladolid,114,141,-27
1997,47186,Valladolid,Valladolid,2811,3071,-260
1997,48003,Amorebieta-Etxano,Vizcaya,69,88,-19
1997,48011,Arrigorriaga,Vizcaya,51,64,-13
1997,48013,Barakaldo,Vizcaya,483,1090,-607
1997,48015,Basauri,Vizcaya,195,405,-210
1997,48017,Bermeo,Vizcaya,44,57,-13
1997,48020,Bilbao,Vizcaya,2539,3707,-1168
1997,48027,Durango,Vizcaya,144,153,-9
1997,48034,Ermua,Vizcaya,178,266,-88
1997,48036,Galdakao,Vizcaya,123,198,-75
1997,48044,Getxo,Vizcaya,607,678,-71
1997,48046,Gernika-Lumo,Vizcaya,59,97,-38
1997,48054,Leioa,Vizcaya,147,184,-37
1997,48069,Mungia,Vizcaya,55,73,-18
1997,48073,Ondarroa,Vizcaya,47,120,-73
1997,48078,Portugalete,Vizcaya,183,569,-386
1997,48080,Valle de Trápaga-Trapagaran,Vizcaya,31,85,-54
1997,48082,Santurtzi,Vizcaya,209,567,-358
1997,48084,Sestao,Vizcaya,131,298,-167
1997,48902,Erandio,Vizcaya,91,140,-49
1997,49021,Benavente,Zamora,266,209,57
1997,49275,Zamora,Zamora,581,700,-119
1997,50067,Calatayud,Zaragoza,154,156,-2
1997,50095,Ejea de los Caballeros,Zaragoza,68,95,-27
1997,50251,Tarazona,Zaragoza,162,104,58
1997,50297,Zaragoza,Zaragoza,3689,3982,-293
1997,51001,Ceuta,Ceuta,1284,1486,-202
1997,52001,Melilla,Melilla,1592,1808,-216
1998,01036,Laudio/Llodio,Álava,162,287,-125
1998,01059,Vitoria-Gasteiz,Álava,2508,2533,-25
1998,02003,Albacete,Albacete,1368,1470,-102
1998,02009,Almansa,Albacete,216,196,20
1998,02037,Hellín,Albacete,239,348,-109
1998,02069,La Roda,Albacete,117,93,24
1998,02081,Villarrobledo,Albacete,165,222,-57
1998,03009,Alcoy/Alcoi,Alicante,278,346,-68
1998,03011,L'Alfàs del Pi,Alicante,190,72,118
1998,03014,Alicante/Alacant,Alicante,3279,2516,763
1998,03015,Almoradí,Alicante,93,70,23
1998,03018,Altea,Alicante,237,116,121
1998,03019,Aspe,Alicante,42,44,-2
1998,03031,Benidorm,Alicante,1752,872,880
1998,03047,Calp,Alicante,339,132,207
1998,03049,Callosa de Segura,Alicante,65,72,-7
1998,03050,El Campello,Alicante,353,177,176
1998,03056,Cocentaina,Alicante,38,50,-12
1998,03059,Crevillent,Alicante,114,84,30
1998,03063,Dénia,Alicante,512,275,237
1998,03065,Elche/Elx,Alicante,1049,711,338
1998,03066,Elda,Alicante,281,201,80
1998,03079,Ibi,Alicante,92,87,5
1998,03082,Jávea/Xàbia,Alicante,298,126,172
1998,03089,Monóvar/Monòver,Alicante,20,28,-8
1998,03090,Mutxamel,Alicante,152,52,100
1998,03093,Novelda,Alicante,124,83,41
1998,03099,Orihuela,Alicante,759,590,169
1998,03102,Pego,Alicante,54,69,-15
1998,03104,Petrer,Alicante,138,90,48
1998,03119,Sant Joan d'Alacant,Alicante,276,159,117
1998,03121,Santa Pola,Alicante,372,172,200
1998,03122,San Vicente del Raspeig/Sant Vicent del Raspeig,Alicante,282,197,85
1998,03133,Torrevieja,Alicante,2910,949,1961
1998,03139,Villajoyosa/La Vila Joiosa,Alicante,237,155,82
1998,03140,Villena,Alicante,154,159,-5
1998,04003,Adra,Almería,165,130,35
1998,04013,Almería,Almería,1483,1523,-40
1998,04029,Berja,Almería,115,74,41
1998,04053,Huércal-Overa,Almería,176,153,23
1998,04066,Níjar,Almería,152,120,32
1998,04079,Roquetas de Mar,Almería,952,684,268
1998,04102,Vícar,Almería,219,175,44
1998,04902,El Ejido,Almería,676,477,199
1998,05019,Ávila,Ávila,432,685,-253
1998,06011,Almendralejo,Badajoz,179,235,-56
1998,06015,Badajoz,Badajoz,1238,1635,-397
1998,06044,Don Benito,Badajoz,406,362,44
1998,06083,Mérida,Badajoz,438,592,-154
1998,06088,Montijo,Badajoz,93,155,-62
1998,06095,Olivenza,Badajoz,87,72,15
1998,06149,Villafranca de los Barros,Badajoz,66,72,-6
1998,06153,Villanueva de la Serena,Badajoz,135,259,-124
1998,06158,Zafra,Badajoz,124,172,-48
1998,07003,Alcúdia,Baleares,601,212,389
1998,07011,Calvià,Baleares,1063,386,677
1998,07015,Ciutadella de Menorca,Baleares,592,219,373
1998,07022,Felanitx,Baleares,229,79,150
1998,07026,Eivissa,Baleares,996,710,286
1998,07027,Inca,Baleares,332,112,220
1998,07031,Llucmajor,Baleares,443,133,310
1998,07032,Maó-Mahón,Baleares,561,351,210
1998,07033,Manacor,Baleares,738,223,515
1998,07036,Marratxí,Baleares,126,46,80
1998,07040,Palma,Baleares,6652,3282,3370
1998,07042,Pollença,Baleares,311,106,205
1998,07044,Sa Pobla,Baleares,74,19,55
1998,07046,Sant Antoni de Portmany,Baleares,364,96,268
1998,07048,Sant Josep de sa Talaia,Baleares,212,101,111
1998,07054,Santa Eulària des Riu,Baleares,549,213,336
1998,07061,Sóller,Baleares,71,46,25
1998,08006,Arenys de Mar,Barcelona,77,69,8
1998,08015,Badalona,Barcelona,754,1383,-629
1998,08019,Barcelona,Barcelona,8042,14132,-6090
1998,08022,Berga,Barcelona,45,81,-36
1998,08033,Caldes de Montbui,Barcelona,12,55,-43
1998,08035,Calella,Barcelona,83,104,-21
1998,08041,Canovelles,Barcelona,77,53,24
1998,08046,Cardedeu,Barcelona,67,47,20
1998,08051,Castellar del Vallès,Barcelona,70,66,4
1998,08056,Castelldefels,Barcelona,546,417,129
1998,08073,Cornellà de Llobregat,Barcelona,392,524,-132
1998,08076,Esparreguera,Barcelona,116,86,30
1998,08077,Esplugues de Llobregat,Barcelona,240,377,-137
1998,08086,Les Franqueses del Vallès,Barcelona,75,40,35
1998,08088,La Garriga,Barcelona,45,36,9
1998,08089,Gavà,Barcelona,249,277,-28
1998,08096,Granollers,Barcelona,346,334,12
1998,08101,L'Hospitalet de Llobregat,Barcelona,1144,1893,-749
1998,08102,Igualada,Barcelona,123,227,-104
1998,08105,La Llagosta,Barcelona,57,65,-8
1998,08110,Malgrat de Mar,Barcelona,126,127,-1
1998,08112,Manlleu,Barcelona,88,83,5
1998,08113,Manresa,Barcelona,189,383,-194
1998,08114,Martorell,Barcelona,126,118,8
1998,08118,El Masnou,Barcelona,124,134,-10
1998,08121,Mataró,Barcelona,507,606,-99
1998,08123,Molins de Rei,Barcelona,58,95,-37
1998,08124,Mollet del Vallès,Barcelona,269,256,13
1998,08125,Montcada i Reixac,Barcelona,115,182,-67
1998,08136,Montornès del Vallès,Barcelona,70,83,-13
1998,08147,Olesa de Montserrat,Barcelona,97,78,19
1998,08159,Parets del Vallès,Barcelona,60,74,-14
1998,08163,Pineda de Mar,Barcelona,229,207,22
1998,08169,El Prat de Llobregat,Barcelona,372,497,-125
1998,08172,Premià de Mar,Barcelona,126,230,-104
1998,08180,Ripollet,Barcelona,175,165,10
1998,08184,Rubí,Barcelona,319,349,-30
1998,08187,Sabadell,Barcelona,740,1074,-334
1998,08194,Sant Adrià de Besòs,Barcelona,146,239,-93
1998,08196,Sant Andreu de la Barca,Barcelona,151,230,-79
1998,08200,Sant Boi de Llobregat,Barcelona,356,519,-163
1998,08202,Sant Celoni,Barcelona,88,124,-36
1998,08205,Sant Cugat del Vallès,Barcelona,531,379,152
1998,08211,Sant Feliu de Llobregat,Barcelona,181,263,-82
1998,08217,Sant Joan Despí,Barcelona,159,172,-13
1998,08219,Vilassar de Mar,Barcelona,122,147,-25
1998,08221,Sant Just Desvern,Barcelona,60,67,-7
1998,08231,Sant Pere de Ribes,Barcelona,178,133,45
1998,08238,Sant Quirze del Vallès,Barcelona,80,54,26
1998,08245,Santa Coloma de Gramenet,Barcelona,522,930,-408
1998,08252,Barberà del Vallès,Barcelona,126,185,-59
1998,08260,Santa Perpètua de Mogoda,Barcelona,97,120,-23
1998,08263,Sant Vicenç dels Horts,Barcelona,130,146,-16
1998,08266,Cerdanyola del Vallès,Barcelona,378,385,-7
1998,08270,Sitges,Barcelona,155,172,-17
1998,08279,Terrassa,Barcelona,693,857,-164
1998,08285,Torelló,Barcelona,46,45,1
1998,08298,Vic,Barcelona,184,175,9
1998,08301,Viladecans,Barcelona,294,476,-182
1998,08302,Vilanova del Camí,Barcelona,39,62,-23
1998,08305,Vilafranca del Penedès,Barcelona,230,200,30
1998,08307,Vilanova i la Geltrú,Barcelona,504,350,154
1998,08904,Badia del Vallès,Barcelona,74,88,-14
1998,09018,Aranda de Duero,Burgos,307,356,-49
1998,09059,Burgos,Burgos,1474,1827,-353
1998,09219,Miranda de Ebro,Burgos,548,587,-39
1998,10037,Cáceres,Cáceres,901,838,63
1998,10067,Coria,Cáceres,122,170,-48
1998,10131,Navalmoral de la Mata,Cáceres,212,389,-177
1998,10148,Plasencia,Cáceres,369,482,-113
1998,11004,Algeciras,Cádiz,1070,1268,-198
1998,11006,Arcos de la Frontera,Cádiz,168,342,-174
1998,11007,Barbate,Cádiz,172,292,-120
1998,11008,Los Barrios,Cádiz,134,146,-12
1998,11012,Cádiz,Cádiz,778,1528,-750
1998,11014,Conil de la Frontera,Cádiz,86,64,22
1998,11015,Chiclana de la Frontera,Cádiz,622,468,154
1998,11016,Chipiona,Cádiz,107,84,23
1998,11020,Jerez de la Frontera,Cádiz,1389,2587,-1198
1998,11022,La Línea de la Concepción,Cádiz,426,714,-288
1998,11023,Medina-Sidonia,Cádiz,29,74,-45
1998,11027,El Puerto de Santa María,Cádiz,997,1095,-98
1998,11028,Puerto Real,Cádiz,198,153,45
1998,11030,Rota,Cádiz,357,438,-81
1998,11031,San Fernando,Cádiz,733,891,-158
1998,11032,Sanlúcar de Barrameda,Cádiz,237,322,-85
1998,11033,San Roque,Cádiz,265,220,45
1998,11035,Tarifa,Cádiz,125,147,-22
1998,11038,Ubrique,Cádiz,40,102,-62
1998,11039,Vejer de la Frontera,Cádiz,55,50,5
1998,11041,Villamartín,Cádiz,129,194,-65
1998,12009,Almassora,Castellón,94,90,4
1998,12027,Benicarló,Castellón,276,197,79
1998,12032,Borriana/Burriana,Castellón,203,147,56
1998,12040,Castellón de la Plana/Castelló de la Plana,Castellón,1472,1219,253
1998,12082,Nules,Castellón,54,72,-18
1998,12084,Onda,Castellón,147,58,89
1998,12126,La Vall d'Uixó,Castellón,161,179,-18
1998,12135,Vila-real,Castellón,405,194,211
1998,12138,Vinaròs,Castellón,489,307,182
1998,13005,Alcázar de San Juan,Ciudad Real,292,293,-1
1998,13023,Bolaños de Calatrava,Ciudad Real,35,25,10
1998,13028,Campo de Criptana,Ciudad Real,50,125,-75
1998,13034,Ciudad Real,Ciudad Real,684,767,-83
1998,13039,Daimiel,Ciudad Real,101,124,-23
1998,13053,Manzanares,Ciudad Real,183,187,-4
1998,13071,Puertollano,Ciudad Real,379,776,-397
1998,13078,Socuéllamos,Ciudad Real,77,142,-65
1998,13079,La Solana,Ciudad Real,34,57,-23
1998,13082,Tomelloso,Ciudad Real,129,190,-61
1998,13087,Valdepeñas,Ciudad Real,190,246,-56
1998,14002,Aguilar de la Frontera,Córdoba,73,79,-6
1998,14007,Baena,Córdoba,92,238,-146
1998,14013,Cabra,Córdoba,115,122,-7
1998,14017,La Carlota,Córdoba,99,95,4
1998,14021,Córdoba,Córdoba,1948,3617,-1669
1998,14038,Lucena,Córdoba,285,198,87
1998,14042,Montilla,Córdoba,96,100,-4
1998,14049,Palma del Río,Córdoba,217,239,-22
1998,14052,Peñarroya-Pueblonuevo,Córdoba,94,292,-198
1998,14054,Pozoblanco,Córdoba,79,111,-32
1998,14055,Priego de Córdoba,Córdoba,199,172,27
1998,14056,Puente Genil,Córdoba,168,293,-125
1998,14058,Rute,Córdoba,62,68,-6
1998,14069,Villanueva de Córdoba,Córdoba,51,102,-51
1998,15002,Ames,A Coruña,285,97,188
1998,15005,Arteixo,A Coruña,112,121,-9
1998,15009,Betanzos,A Coruña,58,71,-13
1998,15011,Boiro,A Coruña,82,144,-62
1998,15017,Cambre,A Coruña,142,92,50
1998,15019,Carballo,A Coruña,109,154,-45
1998,15030,A Coruña,A Coruña,2171,2170,1
1998,15031,Culleredo,A Coruña,159,64,95
1998,15035,Fene,A Coruña,51,89,-38
1998,15036,Ferrol,A Coruña,738,1002,-264
1998,15041,A Laracha,A Coruña,18,11,7
1998,15053,Muros,A Coruña,86,175,-89
1998,15054,Narón,A Coruña,239,275,-36
1998,15057,Noia,A Coruña,56,129,-73
1998,15058,Oleiros,A Coruña,276,184,92
1998,15059,Ordes,A Coruña,35,30,5
1998,15065,Padrón,A Coruña,57,91,-34
1998,15067,A Pobra do Caramiñal,A Coruña,39,64,-25
1998,15070,As Pontes de García Rodríguez,A Coruña,66,106,-40
1998,15071,Porto do Son,A Coruña,48,83,-35
1998,15072,Rianxo,A Coruña,28,76,-48
1998,15073,Ribeira,A Coruña,101,138,-37
1998,15077,Santa Comba,A Coruña,19,54,-35
1998,15078,Santiago de Compostela,A Coruña,856,935,-79
1998,15082,Teo,A Coruña,113,79,34
1998,16078,Cuenca,Cuenca,454,558,-104
1998,16203,Tarancón,Cuenca,124,135,-11
1998,17015,Banyoles,Girona,150,101,49
1998,17023,Blanes,Girona,915,612,303
1998,17066,Figueres,Girona,369,426,-57
1998,17079,Girona,Girona,804,824,-20
1998,17095,Lloret de Mar,Girona,669,367,302
1998,17114,Olot,Girona,227,197,30
1998,17117,Palafrugell,Girona,259,168,91
1998,17118,Palamós,Girona,229,193,36
1998,17147,Ripoll,Girona,127,213,-86
1998,17152,Roses,Girona,236,183,53
1998,17155,Salt,Girona,211,174,37
1998,17160,Sant Feliu de Guíxols,Girona,196,224,-28
1998,18003,Albolote,Granada,132,99,33
1998,18017,Almuñécar,Granada,197,269,-72
1998,18021,Armilla,Granada,172,126,46
1998,18022,Atarfe,Granada,73,94,-21
1998,18023,Baza,Granada,197,214,-17
1998,18087,Granada,Granada,2590,3264,-674
1998,18089,Guadix,Granada,161,275,-114
1998,18102,Illora,Granada,81,92,-11
1998,18122,Loja,Granada,140,159,-19
1998,18127,Maracena,Granada,136,82,54
1998,18140,Motril,Granada,390,447,-57
1998,18158,Pinos Puente,Granada,72,120,-48
1998,18173,Salobreña,Granada,112,114,-2
1998,18175,Santa Fe,Granada,109,79,30
1998,18193,La Zubia,Granada,104,80,24
1998,19046,Azuqueca de Henares,Guadalajara,1226,336,890
1998,19130,Guadalajara,Guadalajara,1135,777,358
1998,20009,Andoain,Guipúzcoa,80,111,-31
1998,20017,Azkoitia,Guipúzcoa,60,28,32
1998,20018,Azpeitia,Guipúzcoa,54,57,-3
1998,20019,Beasain,Guipúzcoa,83,95,-12
1998,20030,Eibar,Guipúzcoa,221,432,-211
1998,20032,Elgoibar,Guipúzcoa,57,94,-37
1998,20036,Hondarribia,Guipúzcoa,113,103,10
1998,20040,Hernani,Guipúzcoa,94,155,-61
1998,20045,Irun,Guipúzcoa,550,586,-36
1998,20055,Arrasate/Mondragón,Guipúzcoa,143,234,-91
1998,20059,Oñati,Guipúzcoa,50,43,7
1998,20064,Pasaia,Guipúzcoa,95,105,-10
1998,20067,Errenteria,Guipúzcoa,181,271,-90
1998,20069,Donostia/San Sebastián,Guipúzcoa,1489,1627,-138
1998,20071,Tolosa,Guipúzcoa,81,101,-20
1998,20074,Bergara,Guipúzcoa,71,111,-40
1998,20079,Zarautz,Guipúzcoa,212,162,50
1998,20080,Zumarraga,Guipúzcoa,69,78,-9
1998,20902,Lasarte-Oria,Guipúzcoa,119,166,-47
1998,21005,Almonte,Huelva,204,170,34
1998,21010,Ayamonte,Huelva,118,125,-7
1998,21013,Bollullos Par del Condado,Huelva,49,54,-5
1998,21021,Cartaya,Huelva,115,98,17
1998,21035,Gibraleón,Huelva,22,49,-27
1998,21041,Huelva,Huelva,776,936,-160
1998,21042,Isla Cristina,Huelva,144,139,5
1998,21044,Lepe,Huelva,235,170,65
1998,21050,Moguer,Huelva,185,85,100
1998,21060,Punta Umbría,Huelva,100,118,-18
1998,21072,Valverde del Camino,Huelva,30,69,-39
1998,22048,Barbastro,Huesca,152,146,6
1998,22112,Fraga,Huesca,172,151,21
1998,22125,Huesca,Huesca,432,572,-140
1998,22130,Jaca,Huesca,295,231,64
1998,22158,Monzón,Huesca,107,106,1
1998,23002,Alcalá la Real,Jaén,200,224,-24
1998,23003,Alcaudete,Jaén,102,103,-1
1998,23005,Andújar,Jaén,251,366,-115
1998,23009,Baeza,Jaén,142,108,34
1998,23010,Bailén,Jaén,49,169,-120
1998,23024,La Carolina,Jaén,165,227,-62
1998,23050,Jaén,Jaén,671,1024,-353
1998,23053,Jódar,Jaén,92,160,-68
1998,23055,Linares,Jaén,431,900,-469
1998,23060,Martos,Jaén,107,117,-10
1998,23086,Torredelcampo,Jaén,61,35,26
1998,23087,Torredonjimeno,Jaén,66,77,-11
1998,23092,Úbeda,Jaén,234,400,-166
1998,23095,Villacarrillo,Jaén,106,114,-8
1998,24008,Astorga,León,134,119,15
1998,24010,La Bañeza,León,100,100,0
1998,24014,Bembibre,León,103,185,-82
1998,24089,León,León,1282,1674,-392
1998,24115,Ponferrada,León,559,697,-138
1998,24142,San Andrés del Rabanedo,León,171,225,-54
1998,24202,Villablino,León,98,325,-227
1998,25040,Balaguer,Lleida,81,108,-27
1998,25120,Lleida,Lleida,989,1254,-265
1998,25203,La Seu d'Urgell,Lleida,205,242,-37
1998,25217,Tàrrega,Lleida,175,168,7
1998,26018,Arnedo,La Rioja,105,84,21
1998,26036,Calahorra,La Rioja,325,251,74
1998,26089,Logroño,La Rioja,1692,1410,282
1998,27016,Chantada,Lugo,88,98,-10
1998,27028,Lugo,Lugo,799,787,12
1998,27031,Monforte de Lemos,Lugo,197,207,-10
1998,27057,Sarria,Lugo,94,78,16
1998,27065,Vilalba,Lugo,90,84,6
1998,27066,Viveiro,Lugo,113,118,-5
1998,28005,Alcalá de Henares,Madrid,1591,2197,-606
1998,28006,Alcobendas,Madrid,674,693,-19
1998,28007,Alcorcón,Madrid,1032,1226,-194
1998,28009,Algete,Madrid,125,146,-21
1998,28013,Aranjuez,Madrid,421,432,-11
1998,28014,Arganda del Rey,Madrid,161,180,-19
1998,28022,Boadilla del Monte,Madrid,112,139,-27
1998,28040,Ciempozuelos,Madrid,91,84,7
1998,28045,Colmenar Viejo,Madrid,294,229,65
1998,28047,Collado Villalba,Madrid,473,394,79
1998,28049,Coslada,Madrid,352,451,-99
1998,28058,Fuenlabrada,Madrid,1186,1582,-396
1998,28061,Galapagar,Madrid,249,212,37
1998,28065,Getafe,Madrid,947,1140,-193
1998,28074,Leganés,Madrid,967,1330,-363
1998,28079,Madrid,Madrid,21601,27594,-5993
1998,28080,Majadahonda,Madrid,571,370,201
1998,28084,Mejorada del Campo,Madrid,107,98,9
1998,28092,Móstoles,Madrid,1293,1818,-525
1998,28096,Navalcarnero,Madrid,108,103,5
1998,28106,Parla,Madrid,541,814,-273
1998,28113,Pinto,Madrid,259,226,33
1998,28115,Pozuelo de Alarcón,Madrid,493,362,131
1998,28123,Rivas-Vaciamadrid,Madrid,131,111,20
1998,28127,Las Rozas de Madrid,Madrid,695,394,301
1998,28130,San Fernando de Henares,Madrid,228,255,-27
1998,28131,San Lorenzo de El Escorial,Madrid,100,107,-7
1998,28134,San Sebastián de los Reyes,Madrid,364,407,-43
1998,28148,Torrejón de Ardoz,Madrid,648,837,-189
1998,28152,Torrelodones,Madrid,169,106,63
1998,28161,Valdemoro,Madrid,485,264,221
1998,28181,Villaviciosa de Odón,Madrid,151,134,17
1998,28903,Tres Cantos,Madrid,540,259,281
1998,29007,Alhaurín de la Torre,Málaga,169,104,65
1998,29008,Alhaurín el Grande,Málaga,51,36,15
1998,29012,Álora,Málaga,62,62,0
1998,29015,Antequera,Málaga,252,215,37
1998,29025,Benalmádena,Málaga,533,301,232
1998,29038,Cártama,Málaga,37,25,12
1998,29042,Coín,Málaga,71,75,-4
1998,29051,Estepona,Málaga,940,421,519
1998,29054,Fuengirola,Málaga,942,461,481
1998,29067,Málaga,Málaga,3305,3111,194
1998,29069,Marbella,Málaga,2012,776,1236
1998,29070,Mijas,Málaga,547,185,362
1998,29075,Nerja,Málaga,120,81,39
1998,29082,Rincón de la Victoria,Málaga,347,139,208
1998,29084,Ronda,Málaga,301,377,-76
1998,29091,Torrox,Málaga,67,50,17
1998,29094,Vélez-Málaga,Málaga,308,377,-69
1998,29901,Torremolinos,Málaga,928,556,372
1998,30002,Abarán,Murcia,39,46,-7
1998,30003,Águilas,Murcia,631,290,341
1998,30005,Alcantarilla,Murcia,183,196,-13
1998,30008,Alhama de Murcia,Murcia,105,79,26
1998,30009,Archena,Murcia,91,64,27
1998,30012,Bullas,Murcia,48,36,12
1998,30015,Caravaca de la Cruz,Murcia,232,143,89
1998,30016,Cartagena,Murcia,1716,1719,-3
1998,30017,Cehegín,Murcia,104,74,30
1998,30019,Cieza (Murcia),Murcia,149,108,41
1998,30022,Jumilla,Murcia,128,105,23
1998,30024,Lorca,Murcia,463,398,65
1998,30026,Mazarrón,Murcia,439,222,217
1998,30027,Molina de Segura,Murcia,279,196,83
1998,30029,Mula,Murcia,41,37,4
1998,30030,Murcia,Murcia,2224,2185,39
1998,30033,Puerto Lumbreras,Murcia,93,95,-2
1998,30035,San Javier,Murcia,577,443,134
1998,30036,San Pedro del Pinatar,Murcia,460,303,157
1998,30037,Torre-Pacheco,Murcia,317,305,12
1998,30038,Las Torres de Cotillas,Murcia,128,88,40
1998,30039,Totana,Murcia,117,74,43
1998,30041,La Unión,Murcia,120,76,44
1998,30043,Yecla,Murcia,284,190,94
1998,31060,Burlada/Burlata,Navarra,149,99,50
1998,31097,Estella-Lizarra,Navarra,123,110,13
1998,31201,Pamplona/Iruña,Navarra,1613,1322,291
1998,31227,Tafalla,Navarra,71,67,4
1998,31232,Tudela,Navarra,325,285,40
1998,31901,Barañain,Navarra,257,114,143
1998,32009,O Barco de Valdeorras,Ourense,139,185,-46
1998,32019,O Carballiño,Ourense,79,126,-47
1998,32054,Ourense,Ourense,826,1249,-423
1998,32085,Verín,Ourense,178,149,29
1998,33002,Aller,Asturias,37,84,-47
1998,33004,Avilés,Asturias,347,748,-401
1998,33011,Cangas del Narcea,Asturias,66,153,-87
1998,33014,Carreño,Asturias,49,59,-10
1998,33016,Castrillón,Asturias,76,128,-52
1998,33020,Corvera de Asturias,Asturias,67,87,-20
1998,33024,Gijón,Asturias,1810,2194,-384
1998,33025,Gozón,Asturias,35,55,-20
1998,33026,Grado,Asturias,32,49,-17
1998,33031,Langreo,Asturias,126,270,-144
1998,33032,Laviana,Asturias,50,53,-3
1998,33033,Lena,Asturias,105,117,-12
1998,33034,Valdés,Asturias,46,103,-57
1998,33035,Llanera,Asturias,60,55,5
1998,33036,Llanes,Asturias,88,125,-37
1998,33037,Mieres (Asturias),Asturias,134,289,-155
1998,33044,Oviedo,Asturias,1041,1648,-607
1998,33060,San Martín del Rey Aurelio,Asturias,40,86,-46
1998,33066,Siero,Asturias,165,197,-32
1998,33073,Tineo,Asturias,47,45,2
1998,33076,Villaviciosa,Asturias,39,42,-3
1998,34120,Palencia,Palencia,787,1007,-220
1998,35002,Agüimes,Las Palmas,246,173,73
1998,35004,Arrecife,Las Palmas,1508,840,668
1998,35006,Arucas,Las Palmas,100,66,34
1998,35009,Gáldar,Las Palmas,75,47,28
1998,35011,Ingenio,Las Palmas,83,69,14
1998,35012,Mogán,Las Palmas,315,161,154
1998,35016,Las Palmas de Gran Canaria,Las Palmas,4075,3482,593
1998,35017,Puerto del Rosario,Las Palmas,1026,515,511
1998,35019,San Bartolomé de Tirajana,Las Palmas,523,404,119
1998,35021,Santa Brígida,Las Palmas,83,89,-6
1998,35022,Santa Lucía de Tirajana,Las Palmas,660,232,428
1998,35023,Santa María de Guía de Gran Canaria,Las Palmas,49,43,6
1998,35026,Telde,Las Palmas,540,363,177
1998,35027,Teror,Las Palmas,28,11,17
1998,35028,Tías,Las Palmas,553,268,285
1998,36003,Baiona,Pontevedra,78,41,37
1998,36004,Bueu,Pontevedra,39,61,-22
1998,36006,Cambados,Pontevedra,63,100,-37
1998,36008,Cangas,Pontevedra,101,147,-46
1998,36017,A Estrada,Pontevedra,144,211,-67
1998,36021,Gondomar,Pontevedra,38,25,13
1998,36022,O Grove,Pontevedra,62,71,-9
1998,36024,Lalín,Pontevedra,123,163,-40
1998,36026,Marín,Pontevedra,204,218,-14
1998,36029,Moaña,Pontevedra,23,93,-70
1998,36033,Mos,Pontevedra,25,55,-30
1998,36035,Nigrán,Pontevedra,103,84,19
1998,36038,Pontevedra,Pontevedra,624,908,-284
1998,36039,O Porriño,Pontevedra,76,85,-9
1998,36041,Poio,Pontevedra,70,88,-18
1998,36042,Ponteareas,Pontevedra,142,182,-40
1998,36045,Redondela,Pontevedra,109,132,-23
1998,36051,Sanxenxo,Pontevedra,82,105,-23
1998,36054,Tomiño,Pontevedra,42,65,-23
1998,36055,Tui,Pontevedra,93,125,-32
1998,36057,Vigo,Pontevedra,1967,2261,-294
1998,36060,Vilagarcía de Arousa,Pontevedra,304,366,-62
1998,36061,Vilanova de Arousa,Pontevedra,47,85,-38
1998,37046,Béjar,Salamanca,136,240,-104
1998,37107,Ciudad Rodrigo,Salamanca,101,182,-81
1998,37274,Salamanca,Salamanca,1881,2121,-240
1998,38001,Adeje,Santa Cruz de Tenerife,687,351,336
1998,38006,Arona,Santa Cruz de Tenerife,1914,964,950
1998,38011,Candelaria,Santa Cruz de Tenerife,193,137,56
1998,38017,Granadilla de Abona,Santa Cruz de Tenerife,605,286,319
1998,38019,Guía de Isora,Santa Cruz de Tenerife,190,97,93
1998,38020,Güímar,Santa Cruz de Tenerife,83,42,41
1998,38022,Icod de los Vinos,Santa Cruz de Tenerife,56,40,16
1998,38023,San Cristóbal de La Laguna,Santa Cruz de Tenerife,409,543,-134
1998,38024,Los Llanos de Aridane,Santa Cruz de Tenerife,234,119,115
1998,38026,La Orotava,Santa Cruz de Tenerife,111,84,27
1998,38028,Puerto de la Cruz,Santa Cruz de Tenerife,378,251,127
1998,38031,Los Realejos,Santa Cruz de Tenerife,69,86,-17
1998,38032,El Rosario,Santa Cruz de Tenerife,213,145,68
1998,38037,Santa Cruz de la Palma,Santa Cruz de Tenerife,307,178,129
1998,38038,Santa Cruz de Tenerife,Santa Cruz de Tenerife,1927,1980,-53
1998,38043,Tacoronte,Santa Cruz de Tenerife,86,47,39
1998,39008,El Astillero,Cantabria,85,55,30
1998,39016,Camargo,Cantabria,153,94,59
1998,39020,Castro-Urdiales,Cantabria,1465,520,945
1998,39025,Los Corrales de Buelna,Cantabria,46,28,18
1998,39035,Laredo,Cantabria,275,211,64
1998,39052,Piélagos,Cantabria,108,56,52
1998,39059,Reinosa,Cantabria,65,108,-43
1998,39075,Santander,Cantabria,1531,1839,-308
1998,39079,Santoña,Cantabria,140,144,-4
1998,39087,Torrelavega,Cantabria,264,410,-146
1998,40194,Segovia,Segovia,448,675,-227
1998,41004,Alcalá de Guadaíra,Sevilla,238,345,-107
1998,41007,La Algaba,Sevilla,40,41,-1
1998,41011,Arahal,Sevilla,38,70,-32
1998,41018,Brenes,Sevilla,43,69,-26
1998,41020,Las Cabezas de San Juan,Sevilla,69,187,-118
1998,41021,Camas,Sevilla,117,167,-50
1998,41024,Carmona,Sevilla,97,135,-38
1998,41029,Castilleja de la Cuesta,Sevilla,104,122,-18
1998,41034,Coria del Río,Sevilla,70,132,-62
1998,41038,Dos Hermanas,Sevilla,562,693,-131
1998,41039,Écija,Sevilla,249,256,-7
1998,41041,Estepa,Sevilla,58,70,-12
1998,41053,Lebrija,Sevilla,139,183,-44
1998,41055,Lora del Río,Sevilla,114,150,-36
1998,41058,Mairena del Alcor,Sevilla,68,50,18
1998,41059,Mairena del Aljarafe,Sevilla,401,322,79
1998,41060,Marchena,Sevilla,43,59,-16
1998,41065,Morón de la Frontera,Sevilla,163,407,-244
1998,41068,Osuna,Sevilla,73,113,-40
1998,41069,Los Palacios y Villafranca,Sevilla,138,248,-110
1998,41075,Pilas,Sevilla,26,34,-8
1998,41077,La Puebla de Cazalla,Sevilla,86,206,-120
1998,41079,La Puebla del Río,Sevilla,33,74,-41
1998,41081,La Rinconada,Sevilla,116,205,-89
1998,41086,San Juan de Aznalfarache,Sevilla,118,153,-35
1998,41087,Sanlúcar la Mayor,Sevilla,61,52,9
1998,41091,Sevilla,Sevilla,4536,5692,-1156
1998,41093,Tomares,Sevilla,205,160,45
1998,41095,Utrera,Sevilla,234,298,-64
1998,41102,El Viso del Alcor,Sevilla,18,29,-11
1998,42173,Soria,Soria,395,467,-72
1998,43014,Amposta,Tarragona,164,98,66
1998,43038,Cambrils,Tarragona,457,275,182
1998,43123,Reus,Tarragona,691,675,16
1998,43136,Sant Carles de la Ràpita,Tarragona,153,88,65
1998,43148,Tarragona,Tarragona,1148,1045,103
1998,43155,Tortosa,Tarragona,204,286,-82
1998,43161,Valls,Tarragona,160,147,13
1998,43163,El Vendrell,Tarragona,1097,428,669
1998,43171,Vila-seca,Tarragona,259,141,118
1998,43901,Deltebre,Tarragona,46,27,19
1998,43905,Salou,Tarragona,543,219,324
1998,44013,Alcañiz,Teruel,188,136,52
1998,44216,Teruel,Teruel,351,446,-95
1998,45053,Consuegra,Toledo,20,54,-34
1998,45087,Madridejos,Toledo,60,99,-39
1998,45165,Talavera de la Reina,Toledo,766,874,-108
1998,45168,Toledo,Toledo,1046,971,75
1998,46005,Alaquàs,Valencia,103,112,-9
1998,46007,Albal,Valencia,31,33,-2
1998,46013,Alboraya,Valencia,165,90,75
1998,46017,Alzira,Valencia,188,162,26
1998,46019,L'Alcúdia,Valencia,13,21,-8
1998,46021,Aldaia,Valencia,108,101,7
1998,46022,Alfafar,Valencia,56,79,-23
1998,46029,Algemesí,Valencia,64,74,-10
1998,46031,Alginet,Valencia,43,72,-29
1998,46054,Benetússer,Valencia,63,64,-1
1998,46060,Benifaió,Valencia,33,39,-6
1998,46070,Bétera,Valencia,121,67,54
1998,46078,Burjassot,Valencia,188,164,24
1998,46081,Canals,Valencia,51,38,13
1998,46083,Carcaixent,Valencia,65,79,-14
1998,46085,Carlet,Valencia,42,55,-13
1998,46094,Catarroja,Valencia,82,64,18
1998,46102,Quart de Poblet,Valencia,128,134,-6
1998,46105,Cullera,Valencia,149,137,12
1998,46110,Xirivella,Valencia,120,110,10
1998,46116,L'Eliana,Valencia,101,78,23
1998,46131,Gandia,Valencia,803,486,317
1998,46135,Godella,Valencia,85,51,34
1998,46145,Xátiva,Valencia,112,165,-53
1998,46147,Llíria,Valencia,106,108,-2
1998,46159,Manises,Valencia,113,115,-2
1998,46164,Massamagrell,Valencia,82,61,21
1998,46169,Mislata,Valencia,224,236,-12
1998,46171,Moncada,Valencia,59,67,-8
1998,46181,Oliva,Valencia,142,125,17
1998,46184,Ontinyent,Valencia,169,165,4
1998,46186,Paiporta,Valencia,91,57,34
1998,46190,Paterna,Valencia,327,315,12
1998,46194,Picassent,Valencia,61,76,-15
1998,46205,Puçol,Valencia,77,42,35
1998,46213,Requena,Valencia,122,91,31
1998,46214,Riba-roja de Túria,Valencia,80,68,12
1998,46220,Sagunto/Sagunt,Valencia,370,391,-21
1998,46230,Silla,Valencia,65,84,-19
1998,46235,Sueca,Valencia,52,65,-13
1998,46238,Tavernes de la Valldigna,Valencia,58,30,28
1998,46244,Torrent (Valencia),Valencia,350,291,59
1998,46249,Utiel,Valencia,42,51,-9
1998,46250,València,Valencia,4880,5593,-713
1998,47076,Laguna de Duero,Valladolid,191,123,68
1998,47085,Medina del Campo,Valladolid,132,197,-65
1998,47186,Valladolid,Valladolid,2647,3575,-928
1998,48003,Amorebieta-Etxano,Vizcaya,79,108,-29
1998,48011,Arrigorriaga,Vizcaya,37,73,-36
1998,48013,Barakaldo,Vizcaya,645,1212,-567
1998,48015,Basauri,Vizcaya,243,486,-243
1998,48017,Bermeo,Vizcaya,67,63,4
1998,48020,Bilbao,Vizcaya,2751,4268,-1517
1998,48027,Durango,Vizcaya,194,192,2
1998,48034,Ermua,Vizcaya,200,286,-86
1998,48036,Galdakao,Vizcaya,123,246,-123
1998,48044,Getxo,Vizcaya,680,801,-121
1998,48046,Gernika-Lumo,Vizcaya,61,78,-17
1998,48054,Leioa,Vizcaya,180,201,-21
1998,48069,Mungia,Vizcaya,91,79,12
1998,48073,Ondarroa,Vizcaya,79,164,-85
1998,48078,Portugalete,Vizcaya,290,574,-284
1998,48080,Valle de Trápaga-Trapagaran,Vizcaya,55,84,-29
1998,48082,Santurtzi,Vizcaya,317,526,-209
1998,48084,Sestao,Vizcaya,187,346,-159
1998,48902,Erandio,Vizcaya,137,195,-58
1998,49021,Benavente,Zamora,261,233,28
1998,49275,Zamora,Zamora,586,855,-269
1998,50095,Ejea de los Caballeros,Zaragoza,80,75,5
1998,50251,Tarazona,Zaragoza,150,178,-28
1998,50297,Zaragoza,Zaragoza,4179,4981,-802
1998,51001,Ceuta,Ceuta,2114,1695,419
1998,52001,Melilla,Melilla,2409,1948,461
1999,01036,Laudio/Llodio,Álava,144,345,-201
1999,01059,Vitoria-Gasteiz,Álava,2456,2610,-154
1999,02003,Albacete,Albacete,1703,1725,-22
1999,02009,Almansa,Albacete,232,259,-27
1999,02037,Hellín,Albacete,388,304,84
1999,02069,La Roda,Albacete,133,125,8
1999,02081,Villarrobledo,Albacete,188,236,-48
1999,03009,Alcoy/Alcoi,Alicante,304,377,-73
1999,03011,L'Alfàs del Pi,Alicante,231,140,91
1999,03014,Alicante/Alacant,Alicante,3829,2668,1161
1999,03015,Almoradí,Alicante,154,76,78
1999,03018,Altea,Alicante,257,142,115
1999,03019,Aspe,Alicante,66,46,20
1999,03031,Benidorm,Alicante,1772,939,833
1999,03047,Calp,Alicante,312,128,184
1999,03049,Callosa de Segura,Alicante,106,75,31
1999,03050,El Campello,Alicante,381,225,156
1999,03056,Cocentaina,Alicante,36,60,-24
1999,03059,Crevillent,Alicante,147,74,73
1999,03063,Dénia,Alicante,574,328,246
1999,03065,Elche/Elx,Alicante,1211,865,346
1999,03066,Elda,Alicante,323,228,95
1999,03079,Ibi,Alicante,130,79,51
1999,03082,Jávea/Xàbia,Alicante,333,196,137
1999,03089,Monóvar/Monòver,Alicante,29,35,-6
1999,03090,Mutxamel,Alicante,190,64,126
1999,03093,Novelda,Alicante,119,97,22
1999,03099,Orihuela,Alicante,850,492,358
1999,03102,Pego,Alicante,75,67,8
1999,03104,Petrer,Alicante,118,80,38
1999,03119,Sant Joan d'Alacant,Alicante,193,144,49
1999,03121,Santa Pola,Alicante,363,186,177
1999,03122,San Vicente del Raspeig/Sant Vicent del Raspeig,Alicante,302,180,122
1999,03133,Torrevieja,Alicante,3931,1202,2729
1999,03139,Villajoyosa/La Vila Joiosa,Alicante,260,185,75
1999,03140,Villena,Alicante,192,199,-7
1999,04003,Adra,Almería,167,121,46
1999,04013,Almería,Almería,1504,1566,-62
1999,04029,Berja,Almería,118,114,4
1999,04053,Huércal-Overa,Almería,160,225,-65
1999,04066,Níjar,Almería,95,147,-52
1999,04079,Roquetas de Mar,Almería,994,790,204
1999,04102,Vícar,Almería,216,211,5
1999,04902,El Ejido,Almería,727,676,51
1999,05019,Ávila,Ávila,526,685,-159
1999,06011,Almendralejo,Badajoz,225,291,-66
1999,06015,Badajoz,Badajoz,1435,1680,-245
1999,06044,Don Benito,Badajoz,268,333,-65
1999,06083,Mérida,Badajoz,498,638,-140
1999,06088,Montijo,Badajoz,130,149,-19
1999,06095,Olivenza,Badajoz,93,76,17
1999,06149,Villafranca de los Barros,Badajoz,105,84,21
1999,06153,Villanueva de la Serena,Badajoz,139,246,-107
1999,06158,Zafra,Badajoz,137,145,-8
1999,07003,Alcúdia,Baleares,636,238,398
1999,07011,Calvià,Baleares,1185,479,706
1999,07015,Ciutadella de Menorca,Baleares,636,297,339
1999,07022,Felanitx,Baleares,289,69,220
1999,07026,Eivissa,Baleares,1071,803,268
1999,07027,Inca,Baleares,422,153,269
1999,07031,Llucmajor,Baleares,633,169,464
1999,07032,Maó-Mahón,Baleares,693,453,240
1999,07033,Manacor,Baleares,644,280,364
1999,07036,Marratxí,Baleares,128,65,63
1999,07040,Palma,Baleares,7709,4057,3652
1999,07042,Pollença,Baleares,248,139,109
1999,07044,Sa Pobla,Baleares,125,40,85
1999,07046,Sant Antoni de Portmany,Baleares,418,159,259
1999,07048,Sant Josep de sa Talaia,Baleares,364,101,263
1999,07054,Santa Eulària des Riu,Baleares,765,270,495
1999,07061,Sóller,Baleares,98,50,48
1999,08006,Arenys de Mar,Barcelona,96,90,6
1999,08015,Badalona,Barcelona,833,1406,-573
1999,08019,Barcelona,Barcelona,8965,14919,-5954
1999,08022,Berga,Barcelona,63,91,-28
1999,08033,Caldes de Montbui,Barcelona,42,58,-16
1999,08035,Calella,Barcelona,149,123,26
1999,08041,Canovelles,Barcelona,81,81,0
1999,08046,Cardedeu,Barcelona,51,56,-5
1999,08051,Castellar del Vallès,Barcelona,72,82,-10
1999,08056,Castelldefels,Barcelona,542,571,-29
1999,08073,Cornellà de Llobregat,Barcelona,378,571,-193
1999,08076,Esparreguera,Barcelona,108,102,6
1999,08077,Esplugues de Llobregat,Barcelona,281,371,-90
1999,08086,Les Franqueses del Vallès,Barcelona,87,47,40
1999,08088,La Garriga,Barcelona,57,52,5
1999,08089,Gavà,Barcelona,237,345,-108
1999,08096,Granollers,Barcelona,396,381,15
1999,08101,L'Hospitalet de Llobregat,Barcelona,1314,1940,-626
1999,08102,Igualada,Barcelona,205,253,-48
1999,08105,La Llagosta,Barcelona,69,99,-30
1999,08110,Malgrat de Mar,Barcelona,154,130,24
1999,08112,Manlleu,Barcelona,96,100,-4
1999,08113,Manresa,Barcelona,240,339,-99
1999,08114,Martorell,Barcelona,151,155,-4
1999,08118,El Masnou,Barcelona,88,146,-58
1999,08121,Mataró,Barcelona,534,633,-99
1999,08123,Molins de Rei,Barcelona,80,83,-3
1999,08124,Mollet del Vallès,Barcelona,275,312,-37
1999,08125,Montcada i Reixac,Barcelona,99,139,-40
1999,08136,Montornès del Vallès,Barcelona,74,74,0
1999,08147,Olesa de Montserrat,Barcelona,118,137,-19
1999,08159,Parets del Vallès,Barcelona,116,100,16
1999,08163,Pineda de Mar,Barcelona,194,211,-17
1999,08169,El Prat de Llobregat,Barcelona,407,550,-143
1999,08172,Premià de Mar,Barcelona,154,236,-82
1999,08180,Ripollet,Barcelona,198,217,-19
1999,08184,Rubí,Barcelona,314,438,-124
1999,08187,Sabadell,Barcelona,827,1143,-316
1999,08194,Sant Adrià de Besòs,Barcelona,136,216,-80
1999,08196,Sant Andreu de la Barca,Barcelona,177,161,16
1999,08200,Sant Boi de Llobregat,Barcelona,401,582,-181
1999,08202,Sant Celoni,Barcelona,109,168,-59
1999,08205,Sant Cugat del Vallès,Barcelona,560,403,157
1999,08211,Sant Feliu de Llobregat,Barcelona,217,243,-26
1999,08217,Sant Joan Despí,Barcelona,154,194,-40
1999,08219,Vilassar de Mar,Barcelona,104,118,-14
1999,08221,Sant Just Desvern,Barcelona,91,123,-32
1999,08231,Sant Pere de Ribes,Barcelona,157,187,-30
1999,08238,Sant Quirze del Vallès,Barcelona,45,60,-15
1999,08245,Santa Coloma de Gramenet,Barcelona,537,862,-325
1999,08252,Barberà del Vallès,Barcelona,163,163,0
1999,08260,Santa Perpètua de Mogoda,Barcelona,133,155,-22
1999,08263,Sant Vicenç dels Horts,Barcelona,107,187,-80
1999,08266,Cerdanyola del Vallès,Barcelona,320,455,-135
1999,08270,Sitges,Barcelona,204,160,44
1999,08279,Terrassa,Barcelona,883,912,-29
1999,08285,Torelló,Barcelona,57,57,0
1999,08298,Vic,Barcelona,171,220,-49
1999,08301,Viladecans,Barcelona,308,546,-238
1999,08302,Vilanova del Camí,Barcelona,48,58,-10
1999,08305,Vilafranca del Penedès,Barcelona,263,220,43
1999,08307,Vilanova i la Geltrú,Barcelona,510,433,77
1999,08904,Badia del Vallès,Barcelona,68,117,-49
1999,09018,Aranda de Duero,Burgos,297,400,-103
1999,09059,Burgos,Burgos,1524,1776,-252
1999,09219,Miranda de Ebro,Burgos,582,705,-123
1999,10037,Cáceres,Cáceres,996,1042,-46
1999,10067,Coria,Cáceres,137,147,-10
1999,10131,Navalmoral de la Mata,Cáceres,197,406,-209
1999,10148,Plasencia,Cáceres,433,508,-75
1999,11004,Algeciras,Cádiz,1132,1381,-249
1999,11006,Arcos de la Frontera,Cádiz,212,295,-83
1999,11007,Barbate,Cádiz,225,267,-42
1999,11008,Los Barrios,Cádiz,167,182,-15
1999,11012,Cádiz,Cádiz,902,1749,-847
1999,11014,Conil de la Frontera,Cádiz,117,68,49
1999,11015,Chiclana de la Frontera,Cádiz,734,464,270
1999,11016,Chipiona,Cádiz,159,125,34
1999,11020,Jerez de la Frontera,Cádiz,1678,2884,-1206
1999,11022,La Línea de la Concepción,Cádiz,586,774,-188
1999,11023,Medina-Sidonia,Cádiz,30,108,-78
1999,11027,El Puerto de Santa María,Cádiz,984,1122,-138
1999,11028,Puerto Real,Cádiz,177,196,-19
1999,11030,Rota,Cádiz,400,353,47
1999,11031,San Fernando,Cádiz,811,954,-143
1999,11032,Sanlúcar de Barrameda,Cádiz,300,361,-61
1999,11033,San Roque,Cádiz,196,314,-118
1999,11035,Tarifa,Cádiz,162,189,-27
1999,11038,Ubrique,Cádiz,49,167,-118
1999,11039,Vejer de la Frontera,Cádiz,44,91,-47
1999,11041,Villamartín,Cádiz,114,215,-101
1999,12009,Almassora,Castellón,104,80,24
1999,12027,Benicarló,Castellón,343,204,139
1999,12032,Borriana/Burriana,Castellón,221,156,65
1999,12040,Castellón de la Plana/Castelló de la Plana,Castellón,1972,1245,727
1999,12082,Nules,Castellón,81,71,10
1999,12084,Onda,Castellón,165,75,90
1999,12126,La Vall d'Uixó,Castellón,203,152,51
1999,12135,Vila-real,Castellón,443,202,241
1999,12138,Vinaròs,Castellón,407,311,96
1999,13005,Alcázar de San Juan,Ciudad Real,340,412,-72
1999,13023,Bolaños de Calatrava,Ciudad Real,26,40,-14
1999,13028,Campo de Criptana,Ciudad Real,98,125,-27
1999,13034,Ciudad Real,Ciudad Real,767,864,-97
1999,13039,Daimiel,Ciudad Real,92,126,-34
1999,13053,Manzanares,Ciudad Real,154,195,-41
1999,13071,Puertollano,Ciudad Real,386,828,-442
1999,13078,Socuéllamos,Ciudad Real,99,126,-27
1999,13079,La Solana,Ciudad Real,40,81,-41
1999,13082,Tomelloso,Ciudad Real,127,202,-75
1999,13087,Valdepeñas,Ciudad Real,246,283,-37
1999,14002,Aguilar de la Frontera,Córdoba,74,100,-26
1999,14007,Baena,Córdoba,136,203,-67
1999,14013,Cabra,Córdoba,133,159,-26
1999,14017,La Carlota,Córdoba,120,103,17
1999,14021,Córdoba,Córdoba,2371,3903,-1532
1999,14038,Lucena,Córdoba,355,236,119
1999,14042,Montilla,Córdoba,134,118,16
1999,14049,Palma del Río,Córdoba,271,301,-30
1999,14052,Peñarroya-Pueblonuevo,Córdoba,134,357,-223
1999,14054,Pozoblanco,Córdoba,129,134,-5
1999,14055,Priego de Córdoba,Córdoba,219,250,-31
1999,14056,Puente Genil,Córdoba,257,340,-83
1999,14058,Rute,Córdoba,95,86,9
1999,14069,Villanueva de Córdoba,Córdoba,50,99,-49
1999,15002,Ames,A Coruña,339,109,230
1999,15005,Arteixo,A Coruña,113,111,2
1999,15009,Betanzos,A Coruña,61,71,-10
1999,15011,Boiro,A Coruña,96,148,-52
1999,15017,Cambre,A Coruña,115,92,23
1999,15019,Carballo,A Coruña,84,166,-82
1999,15030,A Coruña,A Coruña,1845,2443,-598
1999,15031,Culleredo,A Coruña,217,114,103
1999,15035,Fene,A Coruña,68,87,-19
1999,15036,Ferrol,A Coruña,618,986,-368
1999,15041,A Laracha,A Coruña,28,25,3
1999,15053,Muros,A Coruña,85,159,-74
1999,15054,Narón,A Coruña,42,217,-175
1999,15057,Noia,A Coruña,56,181,-125
1999,15058,Oleiros,A Coruña,289,239,50
1999,15059,Ordes,A Coruña,35,41,-6
1999,15065,Padrón,A Coruña,101,98,3
1999,15067,A Pobra do Caramiñal,A Coruña,26,56,-30
1999,15070,As Pontes de García Rodríguez,A Coruña,112,107,5
1999,15071,Porto do Son,A Coruña,54,91,-37
1999,15072,Rianxo,A Coruña,56,124,-68
1999,15073,Ribeira,A Coruña,138,250,-112
1999,15077,Santa Comba,A Coruña,13,58,-45
1999,15078,Santiago de Compostela,A Coruña,930,937,-7
1999,15082,Teo,A Coruña,144,92,52
1999,16078,Cuenca,Cuenca,521,659,-138
1999,16203,Tarancón,Cuenca,147,197,-50
1999,17015,Banyoles,Girona,115,110,5
1999,17023,Blanes,Girona,952,619,333
1999,17066,Figueres,Girona,452,371,81
1999,17079,Girona,Girona,941,847,94
1999,17095,Lloret de Mar,Girona,681,425,256
1999,17114,Olot,Girona,268,182,86
1999,17117,Palafrugell,Girona,248,181,67
1999,17118,Palamós,Girona,276,193,83
1999,17147,Ripoll,Girona,116,144,-28
1999,17152,Roses,Girona,239,208,31
1999,17155,Salt,Girona,209,170,39
1999,17160,Sant Feliu de Guíxols,Girona,348,174,174
1999,18003,Albolote,Granada,120,112,8
1999,18017,Almuñécar,Granada,240,221,19
1999,18021,Armilla,Granada,177,137,40
1999,18022,Atarfe,Granada,67,91,-24
1999,18023,Baza,Granada,234,313,-79
1999,18087,Granada,Granada,2901,3686,-785
1999,18089,Guadix,Granada,161,299,-138
1999,18102,Illora,Granada,52,104,-52
1999,18122,Loja,Granada,90,184,-94
1999,18127,Maracena,Granada,88,93,-5
1999,18140,Motril,Granada,459,489,-30
1999,18158,Pinos Puente,Granada,70,135,-65
1999,18173,Salobreña,Granada,126,124,2
1999,18175,Santa Fe,Granada,110,100,10
1999,18193,La Zubia,Granada,111,88,23
1999,19046,Azuqueca de Henares,Guadalajara,1059,428,631
1999,19130,Guadalajara,Guadalajara,1006,851,155
1999,20009,Andoain,Guipúzcoa,72,100,-28
1999,20017,Azkoitia,Guipúzcoa,42,35,7
1999,20018,Azpeitia,Guipúzcoa,52,44,8
1999,20019,Beasain,Guipúzcoa,71,94,-23
1999,20030,Eibar,Guipúzcoa,193,386,-193
1999,20032,Elgoibar,Guipúzcoa,75,79,-4
1999,20036,Hondarribia,Guipúzcoa,103,126,-23
1999,20040,Hernani,Guipúzcoa,102,137,-35
1999,20045,Irun,Guipúzcoa,575,630,-55
1999,20055,Arrasate/Mondragón,Guipúzcoa,163,261,-98
1999,20059,Oñati,Guipúzcoa,57,55,2
1999,20064,Pasaia,Guipúzcoa,67,118,-51
1999,20067,Errenteria,Guipúzcoa,181,272,-91
1999,20069,Donostia/San Sebastián,Guipúzcoa,1587,1844,-257
1999,20071,Tolosa,Guipúzcoa,97,139,-42
1999,20074,Bergara,Guipúzcoa,67,94,-27
1999,20079,Zarautz,Guipúzcoa,201,124,77
1999,20080,Zumarraga,Guipúzcoa,86,115,-29
1999,20902,Lasarte-Oria,Guipúzcoa,146,142,4
1999,21005,Almonte,Huelva,214,187,27
1999,21010,Ayamonte,Huelva,174,146,28
1999,21013,Bollullos Par del Condado,Huelva,50,54,-4
1999,21021,Cartaya,Huelva,178,100,78
1999,21035,Gibraleón,Huelva,46,51,-5
1999,21041,Huelva,Huelva,959,1149,-190
1999,21042,Isla Cristina,Huelva,166,198,-32
1999,21044,Lepe,Huelva,186,155,31
1999,21050,Moguer,Huelva,198,136,62
1999,21060,Punta Umbría,Huelva,88,181,-93
1999,21072,Valverde del Camino,Huelva,66,81,-15
1999,22048,Barbastro,Huesca,141,140,1
1999,22112,Fraga,Huesca,162,165,-3
1999,22125,Huesca,Huesca,440,599,-159
1999,22130,Jaca,Huesca,275,272,3
1999,22158,Monzón,Huesca,151,139,12
1999,23002,Alcalá la Real,Jaén,160,251,-91
1999,23003,Alcaudete,Jaén,109,152,-43
1999,23005,Andújar,Jaén,295,480,-185
1999,23009,Baeza,Jaén,119,135,-16
1999,23010,Bailén,Jaén,81,187,-106
1999,23024,La Carolina,Jaén,203,178,25
1999,23050,Jaén,Jaén,714,1123,-409
1999,23053,Jódar,Jaén,96,126,-30
1999,23055,Linares,Jaén,542,975,-433
1999,23060,Martos,Jaén,155,119,36
1999,23086,Torredelcampo,Jaén,70,37,33
1999,23087,Torredonjimeno,Jaén,93,56,37
1999,23092,Úbeda,Jaén,273,376,-103
1999,23095,Villacarrillo,Jaén,102,171,-69
1999,24008,Astorga,León,194,185,9
1999,24010,La Bañeza,León,92,137,-45
1999,24014,Bembibre,León,87,212,-125
1999,24089,León,León,1417,1836,-419
1999,24115,Ponferrada,León,581,776,-195
1999,24142,San Andrés del Rabanedo,León,238,228,10
1999,24202,Villablino,León,149,401,-252
1999,25040,Balaguer,Lleida,120,95,25
1999,25120,Lleida,Lleida,1140,1405,-265
1999,25203,La Seu d'Urgell,Lleida,228,258,-30
1999,25217,Tàrrega,Lleida,233,180,53
1999,26018,Arnedo,La Rioja,103,124,-21
1999,26036,Calahorra,La Rioja,361,233,128
1999,26089,Logroño,La Rioja,2041,1435,606
1999,27016,Chantada,Lugo,88,87,1
1999,27028,Lugo,Lugo,819,869,-50
1999,27031,Monforte de Lemos,Lugo,180,276,-96
1999,27057,Sarria,Lugo,78,100,-22
1999,27065,Vilalba,Lugo,87,126,-39
1999,27066,Viveiro,Lugo,109,164,-55
1999,28005,Alcalá de Henares,Madrid,1819,2418,-599
1999,28006,Alcobendas,Madrid,788,712,76
1999,28007,Alcorcón,Madrid,1018,1249,-231
1999,28009,Algete,Madrid,152,197,-45
1999,28013,Aranjuez,Madrid,519,410,109
1999,28014,Arganda del Rey,Madrid,214,245,-31
1999,28022,Boadilla del Monte,Madrid,184,140,44
1999,28040,Ciempozuelos,Madrid,111,97,14
1999,28045,Colmenar Viejo,Madrid,306,221,85
1999,28047,Collado Villalba,Madrid,573,357,216
1999,28049,Coslada,Madrid,358,545,-187
1999,28058,Fuenlabrada,Madrid,1387,1783,-396
1999,28061,Galapagar,Madrid,235,221,14
1999,28065,Getafe,Madrid,964,1152,-188
1999,28074,Leganés,Madrid,938,1292,-354
1999,28079,Madrid,Madrid,24151,31362,-7211
1999,28080,Majadahonda,Madrid,528,403,125
1999,28084,Mejorada del Campo,Madrid,96,113,-17
1999,28092,Móstoles,Madrid,1337,2176,-839
1999,28096,Navalcarnero,Madrid,128,114,14
1999,28106,Parla,Madrid,557,765,-208
1999,28113,Pinto,Madrid,337,181,156
1999,28115,Pozuelo de Alarcón,Madrid,580,506,74
1999,28123,Rivas-Vaciamadrid,Madrid,159,139,20
1999,28127,Las Rozas de Madrid,Madrid,801,453,348
1999,28130,San Fernando de Henares,Madrid,208,290,-82
1999,28131,San Lorenzo de El Escorial,Madrid,119,106,13
1999,28134,San Sebastián de los Reyes,Madrid,370,476,-106
1999,28148,Torrejón de Ardoz,Madrid,704,902,-198
1999,28152,Torrelodones,Madrid,131,103,28
1999,28161,Valdemoro,Madrid,611,403,208
1999,28181,Villaviciosa de Odón,Madrid,136,130,6
1999,28903,Tres Cantos,Madrid,579,245,334
1999,29007,Alhaurín de la Torre,Málaga,220,139,81
1999,29008,Alhaurín el Grande,Málaga,46,26,20
1999,29012,Álora,Málaga,62,56,6
1999,29015,Antequera,Málaga,263,250,13
1999,29025,Benalmádena,Málaga,660,348,312
1999,29038,Cártama,Málaga,46,49,-3
1999,29042,Coín,Málaga,103,52,51
1999,29051,Estepona,Málaga,947,455,492
1999,29054,Fuengirola,Málaga,1009,523,486
1999,29067,Málaga,Málaga,4010,3584,426
1999,29069,Marbella,Málaga,2617,960,1657
1999,29070,Mijas,Málaga,537,203,334
1999,29075,Nerja,Málaga,167,108,59
1999,29082,Rincón de la Victoria,Málaga,373,175,198
1999,29084,Ronda,Málaga,361,374,-13
1999,29091,Torrox,Málaga,85,46,39
1999,29094,Vélez-Málaga,Málaga,466,303,163
1999,29901,Torremolinos,Málaga,977,538,439
1999,30002,Abarán,Murcia,55,48,7
1999,30003,Águilas,Murcia,582,331,251
1999,30005,Alcantarilla,Murcia,245,243,2
1999,30008,Alhama de Murcia,Murcia,111,88,23
1999,30009,Archena,Murcia,106,78,28
1999,30012,Bullas,Murcia,43,26,17
1999,30015,Caravaca de la Cruz,Murcia,158,190,-32
1999,30016,Cartagena,Murcia,1762,1726,36
1999,30017,Cehegín,Murcia,92,53,39
1999,30019,Cieza (Murcia),Murcia,200,151,49
1999,30022,Jumilla,Murcia,153,172,-19
1999,30024,Lorca,Murcia,587,399,188
1999,30026,Mazarrón,Murcia,612,251,361
1999,30027,Molina de Segura,Murcia,327,202,125
1999,30029,Mula,Murcia,75,49,26
1999,30030,Murcia,Murcia,2400,2496,-96
1999,30033,Puerto Lumbreras,Murcia,141,109,32
1999,30035,San Javier,Murcia,622,532,90
1999,30036,San Pedro del Pinatar,Murcia,516,354,162
1999,30037,Torre-Pacheco,Murcia,357,359,-2
1999,30038,Las Torres de Cotillas,Murcia,212,79,133
1999,30039,Totana,Murcia,145,87,58
1999,30041,La Unión,Murcia,121,109,12
1999,30043,Yecla,Murcia,332,239,93
1999,31060,Burlada/Burlata,Navarra,120,81,39
1999,31097,Estella-Lizarra,Navarra,140,120,20
1999,31201,Pamplona/Iruña,Navarra,1847,1446,401
1999,31227,Tafalla,Navarra,59,57,2
1999,31232,Tudela,Navarra,315,294,21
1999,31901,Barañain,Navarra,266,139,127
1999,32009,O Barco de Valdeorras,Ourense,162,164,-2
1999,32019,O Carballiño,Ourense,94,163,-69
1999,32054,Ourense,Ourense,702,1533,-831
1999,32085,Verín,Ourense,200,245,-45
1999,33002,Aller,Asturias,35,100,-65
1999,33004,Avilés,Asturias,423,711,-288
1999,33011,Cangas del Narcea,Asturias,65,156,-91
1999,33014,Carreño,Asturias,49,56,-7
1999,33016,Castrillón,Asturias,110,161,-51
1999,33020,Corvera de Asturias,Asturias,76,92,-16
1999,33024,Gijón,Asturias,1940,2335,-395
1999,33025,Gozón,Asturias,43,52,-9
1999,33026,Grado,Asturias,36,52,-16
1999,33031,Langreo,Asturias,138,256,-118
1999,33032,Laviana,Asturias,35,61,-26
1999,33033,Lena,Asturias,65,123,-58
1999,33034,Valdés,Asturias,71,88,-17
1999,33035,Llanera,Asturias,67,57,10
1999,33036,Llanes,Asturias,111,92,19
1999,33037,Mieres (Asturias),Asturias,159,345,-186
1999,33044,Oviedo,Asturias,1215,1876,-661
1999,33060,San Martín del Rey Aurelio,Asturias,48,122,-74
1999,33066,Siero,Asturias,230,196,34
1999,33073,Tineo,Asturias,46,59,-13
1999,33076,Villaviciosa,Asturias,58,59,-1
1999,34120,Palencia,Palencia,854,1160,-306
1999,35002,Agüimes,Las Palmas,219,130,89
1999,35004,Arrecife,Las Palmas,1631,946,685
1999,35006,Arucas,Las Palmas,103,102,1
1999,35009,Gáldar,Las Palmas,61,40,21
1999,35011,Ingenio,Las Palmas,103,56,47
1999,35012,Mogán,Las Palmas,288,209,79
1999,35016,Las Palmas de Gran Canaria,Las Palmas,3803,4074,-271
1999,35017,Puerto del Rosario,Las Palmas,1249,610,639
1999,35019,San Bartolomé de Tirajana,Las Palmas,436,400,36
1999,35021,Santa Brígida,Las Palmas,106,74,32
1999,35022,Santa Lucía de Tirajana,Las Palmas,606,312,294
1999,35023,Santa María de Guía de Gran Canaria,Las Palmas,37,47,-10
1999,35026,Telde,Las Palmas,662,428,234
1999,35027,Teror,Las Palmas,24,34,-10
1999,35028,Tías,Las Palmas,577,320,257
1999,36003,Baiona,Pontevedra,65,80,-15
1999,36004,Bueu,Pontevedra,56,75,-19
1999,36006,Cambados,Pontevedra,59,127,-68
1999,36008,Cangas,Pontevedra,126,126,0
1999,36017,A Estrada,Pontevedra,152,209,-57
1999,36021,Gondomar,Pontevedra,37,59,-22
1999,36022,O Grove,Pontevedra,41,70,-29
1999,36024,Lalín,Pontevedra,124,159,-35
1999,36026,Marín,Pontevedra,147,234,-87
1999,36029,Moaña,Pontevedra,86,95,-9
1999,36033,Mos,Pontevedra,52,39,13
1999,36035,Nigrán,Pontevedra,94,86,8
1999,36038,Pontevedra,Pontevedra,698,823,-125
1999,36039,O Porriño,Pontevedra,60,127,-67
1999,36041,Poio,Pontevedra,95,80,15
1999,36042,Ponteareas,Pontevedra,148,149,-1
1999,36045,Redondela,Pontevedra,76,167,-91
1999,36051,Sanxenxo,Pontevedra,86,127,-41
1999,36054,Tomiño,Pontevedra,37,69,-32
1999,36055,Tui,Pontevedra,125,125,0
1999,36057,Vigo,Pontevedra,2212,2545,-333
1999,36060,Vilagarcía de Arousa,Pontevedra,274,413,-139
1999,36061,Vilanova de Arousa,Pontevedra,41,102,-61
1999,37046,Béjar,Salamanca,148,268,-120
1999,37107,Ciudad Rodrigo,Salamanca,103,231,-128
1999,37274,Salamanca,Salamanca,1921,2485,-564
1999,38001,Adeje,Santa Cruz de Tenerife,799,488,311
1999,38006,Arona,Santa Cruz de Tenerife,1865,997,868
1999,38011,Candelaria,Santa Cruz de Tenerife,245,178,67
1999,38017,Granadilla de Abona,Santa Cruz de Tenerife,65,367,-302
1999,38019,Guía de Isora,Santa Cruz de Tenerife,48,125,-77
1999,38020,Güímar,Santa Cruz de Tenerife,58,59,-1
1999,38022,Icod de los Vinos,Santa Cruz de Tenerife,70,58,12
1999,38023,San Cristóbal de La Laguna,Santa Cruz de Tenerife,837,689,148
1999,38024,Los Llanos de Aridane,Santa Cruz de Tenerife,210,163,47
1999,38026,La Orotava,Santa Cruz de Tenerife,103,105,-2
1999,38028,Puerto de la Cruz,Santa Cruz de Tenerife,430,282,148
1999,38031,Los Realejos,Santa Cruz de Tenerife,88,89,-1
1999,38032,El Rosario,Santa Cruz de Tenerife,179,116,63
1999,38037,Santa Cruz de la Palma,Santa Cruz de Tenerife,269,257,12
1999,38038,Santa Cruz de Tenerife,Santa Cruz de Tenerife,2069,2072,-3
1999,38043,Tacoronte,Santa Cruz de Tenerife,75,69,6
1999,39008,El Astillero,Cantabria,114,73,41
1999,39016,Camargo,Cantabria,195,103,92
1999,39020,Castro-Urdiales,Cantabria,1812,694,1118
1999,39025,Los Corrales de Buelna,Cantabria,47,35,12
1999,39035,Laredo,Cantabria,289,227,62
1999,39052,Piélagos,Cantabria,132,54,78
1999,39059,Reinosa,Cantabria,50,105,-55
1999,39075,Santander,Cantabria,1844,2058,-214
1999,39079,Santoña,Cantabria,128,146,-18
1999,39087,Torrelavega,Cantabria,322,343,-21
1999,40194,Segovia,Segovia,490,629,-139
1999,41004,Alcalá de Guadaíra,Sevilla,326,441,-115
1999,41007,La Algaba,Sevilla,48,49,-1
1999,41011,Arahal,Sevilla,39,78,-39
1999,41018,Brenes,Sevilla,36,64,-28
1999,41020,Las Cabezas de San Juan,Sevilla,97,237,-140
1999,41021,Camas,Sevilla,152,153,-1
1999,41024,Carmona,Sevilla,102,144,-42
1999,41029,Castilleja de la Cuesta,Sevilla,99,94,5
1999,41034,Coria del Río,Sevilla,123,165,-42
1999,41038,Dos Hermanas,Sevilla,870,797,73
1999,41039,Écija,Sevilla,199,325,-126
1999,41041,Estepa,Sevilla,73,43,30
1999,41053,Lebrija,Sevilla,155,214,-59
1999,41055,Lora del Río,Sevilla,91,198,-107
1999,41058,Mairena del Alcor,Sevilla,83,79,4
1999,41059,Mairena del Aljarafe,Sevilla,415,343,72
1999,41060,Marchena,Sevilla,55,83,-28
1999,41065,Morón de la Frontera,Sevilla,243,482,-239
1999,41068,Osuna,Sevilla,108,105,3
1999,41069,Los Palacios y Villafranca,Sevilla,138,195,-57
1999,41075,Pilas,Sevilla,42,41,1
1999,41077,La Puebla de Cazalla,Sevilla,99,217,-118
1999,41079,La Puebla del Río,Sevilla,24,63,-39
1999,41081,La Rinconada,Sevilla,188,205,-17
1999,41086,San Juan de Aznalfarache,Sevilla,154,175,-21
1999,41087,Sanlúcar la Mayor,Sevilla,67,80,-13
1999,41091,Sevilla,Sevilla,5752,6732,-980
1999,41093,Tomares,Sevilla,228,150,78
1999,41095,Utrera,Sevilla,249,342,-93
1999,41102,El Viso del Alcor,Sevilla,24,54,-30
1999,42173,Soria,Soria,403,520,-117
1999,43014,Amposta,Tarragona,147,92,55
1999,43038,Cambrils,Tarragona,535,327,208
1999,43123,Reus,Tarragona,891,815,76
1999,43136,Sant Carles de la Ràpita,Tarragona,126,125,1
1999,43148,Tarragona,Tarragona,1161,1096,65
1999,43155,Tortosa,Tarragona,257,246,11
1999,43161,Valls,Tarragona,171,133,38
1999,43163,El Vendrell,Tarragona,1336,469,867
1999,43171,Vila-seca,Tarragona,287,170,117
1999,43901,Deltebre,Tarragona,56,45,11
1999,43905,Salou,Tarragona,434,213,221
1999,44013,Alcañiz,Teruel,172,154,18
1999,44216,Teruel,Teruel,374,405,-31
1999,45053,Consuegra,Toledo,36,52,-16
1999,45087,Madridejos,Toledo,60,77,-17
1999,45165,Talavera de la Reina,Toledo,824,934,-110
1999,45168,Toledo,Toledo,1089,952,137
1999,46005,Alaquàs,Valencia,112,91,21
1999,46007,Albal,Valencia,49,27,22
1999,46013,Alboraya,Valencia,127,63,64
1999,46017,Alzira,Valencia,220,173,47
1999,46019,L'Alcúdia,Valencia,23,20,3
1999,46021,Aldaia,Valencia,92,182,-90
1999,46022,Alfafar,Valencia,97,83,14
1999,46029,Algemesí,Valencia,68,79,-11
1999,46031,Alginet,Valencia,41,33,8
1999,46054,Benetússer,Valencia,42,60,-18
1999,46060,Benifaió,Valencia,29,57,-28
1999,46070,Bétera,Valencia,166,95,71
1999,46078,Burjassot,Valencia,188,193,-5
1999,46081,Canals,Valencia,90,77,13
1999,46083,Carcaixent,Valencia,73,61,12
1999,46085,Carlet,Valencia,50,44,6
1999,46094,Catarroja,Valencia,78,78,0
1999,46102,Quart de Poblet,Valencia,130,170,-40
1999,46105,Cullera,Valencia,161,171,-10
1999,46110,Xirivella,Valencia,126,125,1
1999,46116,L'Eliana,Valencia,118,103,15
1999,46131,Gandia,Valencia,683,626,57
1999,46135,Godella,Valencia,71,75,-4
1999,46145,Xátiva,Valencia,139,130,9
1999,46147,Llíria,Valencia,160,113,47
1999,46159,Manises,Valencia,138,119,19
1999,46164,Massamagrell,Valencia,86,61,25
1999,46169,Mislata,Valencia,224,283,-59
1999,46171,Moncada,Valencia,73,61,12
1999,46181,Oliva,Valencia,168,107,61
1999,46184,Ontinyent,Valencia,214,127,87
1999,46186,Paiporta,Valencia,97,73,24
1999,46190,Paterna,Valencia,356,371,-15
1999,46194,Picassent,Valencia,93,71,22
1999,46205,Puçol,Valencia,73,49,24
1999,46213,Requena,Valencia,107,116,-9
1999,46214,Riba-roja de Túria,Valencia,88,50,38
1999,46220,Sagunto/Sagunt,Valencia,454,469,-15
1999,46230,Silla,Valencia,45,83,-38
1999,46235,Sueca,Valencia,77,84,-7
1999,46238,Tavernes de la Valldigna,Valencia,76,41,35
1999,46244,Torrent (Valencia),Valencia,330,320,10
1999,46249,Utiel,Valencia,62,57,5
1999,46250,València,Valencia,5638,6007,-369
1999,47076,Laguna de Duero,Valladolid,233,157,76
1999,47085,Medina del Campo,Valladolid,142,186,-44
1999,47186,Valladolid,Valladolid,2862,3768,-906
1999,48003,Amorebieta-Etxano,Vizcaya,75,115,-40
1999,48011,Arrigorriaga,Vizcaya,82,84,-2
1999,48013,Barakaldo,Vizcaya,685,1087,-402
1999,48015,Basauri,Vizcaya,263,495,-232
1999,48017,Bermeo,Vizcaya,60,73,-13
1999,48020,Bilbao,Vizcaya,2785,4424,-1639
1999,48027,Durango,Vizcaya,170,178,-8
1999,48034,Ermua,Vizcaya,188,298,-110
1999,48036,Galdakao,Vizcaya,161,229,-68
1999,48044,Getxo,Vizcaya,638,859,-221
1999,48046,Gernika-Lumo,Vizcaya,41,97,-56
1999,48054,Leioa,Vizcaya,177,237,-60
1999,48069,Mungia,Vizcaya,27,85,-58
1999,48073,Ondarroa,Vizcaya,102,123,-21
1999,48078,Portugalete,Vizcaya,205,589,-384
1999,48080,Valle de Trápaga-Trapagaran,Vizcaya,53,100,-47
1999,48082,Santurtzi,Vizcaya,309,590,-281
1999,48084,Sestao,Vizcaya,192,362,-170
1999,48902,Erandio,Vizcaya,109,198,-89
1999,49021,Benavente,Zamora,287,272,15
1999,49275,Zamora,Zamora,661,863,-202
1999,50067,Calatayud,Zaragoza,118,213,-95
1999,50251,Tarazona,Zaragoza,115,137,-22
1999,50297,Zaragoza,Zaragoza,4530,5083,-553
1999,51001,Ceuta,Ceuta,2449,2112,337
1999,52001,Melilla,Melilla,2460,2276,184
2000,01036,Laudio/Llodio,Álava,173,286,-113
2000,01059,Vitoria-Gasteiz,Álava,2741,2545,196
2000,02003,Albacete,Albacete,1698,1734,-36
2000,02009,Almansa,Albacete,174,242,-68
2000,02037,Hellín,Albacete,369,338,31
2000,02069,La Roda,Albacete,141,91,50
2000,02081,Villarrobledo,Albacete,208,207,1
2000,03009,Alcoy/Alcoi,Alicante,324,384,-60
2000,03011,L'Alfàs del Pi,Alicante,209,115,94
2000,03014,Alicante/Alacant,Alicante,4436,2808,1628
2000,03015,Almoradí,Alicante,121,111,10
2000,03018,Altea,Alicante,296,183,113
2000,03019,Aspe,Alicante,52,69,-17
2000,03031,Benidorm,Alicante,2055,1027,1028
2000,03047,Calp,Alicante,335,173,162
2000,03049,Callosa de Segura,Alicante,101,77,24
2000,03050,El Campello,Alicante,395,183,212
2000,03056,Cocentaina,Alicante,43,74,-31
2000,03059,Crevillent,Alicante,161,119,42
2000,03063,Dénia,Alicante,615,361,254
2000,03065,Elche/Elx,Alicante,1294,971,323
2000,03066,Elda,Alicante,361,288,73
2000,03079,Ibi,Alicante,153,99,54
2000,03082,Jávea/Xàbia,Alicante,317,217,100
2000,03089,Monóvar/Monòver,Alicante,67,42,25
2000,03090,Mutxamel,Alicante,149,93,56
2000,03093,Novelda,Alicante,139,84,55
2000,03099,Orihuela,Alicante,809,590,219
2000,03102,Pego,Alicante,56,80,-24
2000,03104,Petrer,Alicante,140,111,29
2000,03119,Sant Joan d'Alacant,Alicante,264,177,87
2000,03121,Santa Pola,Alicante,473,256,217
2000,03122,San Vicente del Raspeig/Sant Vicent del Raspeig,Alicante,371,188,183
2000,03133,Torrevieja,Alicante,3855,1554,2301
2000,03139,Villajoyosa/La Vila Joiosa,Alicante,399,191,208
2000,03140,Villena,Alicante,202,195,7
2000,03902,Pilar de la Horadada,Alicante,392,377,15
2000,04003,Adra,Almería,170,211,-41
2000,04013,Almería,Almería,1583,1662,-79
2000,04029,Berja,Almería,104,132,-28
2000,04053,Huércal-Overa,Almería,169,146,23
2000,04066,Níjar,Almería,162,246,-84
2000,04079,Roquetas de Mar,Almería,896,1260,-364
2000,04102,Vícar,Almería,176,311,-135
2000,04902,El Ejido,Almería,713,1161,-448
2000,05019,Ávila,Ávila,579,708,-129
2000,06011,Almendralejo,Badajoz,198,260,-62
2000,06015,Badajoz,Badajoz,1575,1619,-44
2000,06044,Don Benito,Badajoz,250,348,-98
2000,06083,Mérida,Badajoz,602,638,-36
2000,06088,Montijo,Badajoz,147,143,4
2000,06095,Olivenza,Badajoz,90,67,23
2000,06149,Villafranca de los Barros,Badajoz,103,139,-36
2000,06153,Villanueva de la Serena,Badajoz,226,271,-45
2000,06158,Zafra,Badajoz,114,162,-48
2000,07003,Alcúdia,Baleares,672,359,313
2000,07011,Calvià,Baleares,1310,604,706
2000,07015,Ciutadella de Menorca,Baleares,760,290,470
2000,07022,Felanitx,Baleares,312,112,200
2000,07026,Eivissa,Baleares,1198,845,353
2000,07027,Inca,Baleares,555,187,368
2000,07031,Llucmajor,Baleares,556,213,343
2000,07032,Maó-Mahón,Baleares,789,401,388
2000,07033,Manacor,Baleares,992,294,698
2000,07036,Marratxí,Baleares,180,94,86
2000,07040,Palma,Baleares,9015,4942,4073
2000,07042,Pollença,Baleares,216,129,87
2000,07044,Sa Pobla,Baleares,168,49,119
2000,07046,Sant Antoni de Portmany,Baleares,397,183,214
2000,07048,Sant Josep de sa Talaia,Baleares,157,179,-22
2000,07054,Santa Eulària des Riu,Baleares,573,286,287
2000,07061,Sóller,Baleares,134,66,68
2000,08006,Arenys de Mar,Barcelona,84,150,-66
2000,08015,Badalona,Barcelona,828,1512,-684
2000,08019,Barcelona,Barcelona,9235,15039,-5804
2000,08022,Berga,Barcelona,81,109,-28
2000,08033,Caldes de Montbui,Barcelona,64,67,-3
2000,08035,Calella,Barcelona,176,119,57
2000,08041,Canovelles,Barcelona,94,75,19
2000,08046,Cardedeu,Barcelona,80,47,33
2000,08051,Castellar del Vallès,Barcelona,51,80,-29
2000,08056,Castelldefels,Barcelona,562,732,-170
2000,08073,Cornellà de Llobregat,Barcelona,388,611,-223
2000,08076,Esparreguera,Barcelona,129,112,17
2000,08077,Esplugues de Llobregat,Barcelona,298,383,-85
2000,08086,Les Franqueses del Vallès,Barcelona,79,55,24
2000,08088,La Garriga,Barcelona,72,52,20
2000,08089,Gavà,Barcelona,277,331,-54
2000,08096,Granollers,Barcelona,357,385,-28
2000,08101,L'Hospitalet de Llobregat,Barcelona,1448,2086,-638
2000,08102,Igualada,Barcelona,224,210,14
2000,08105,La Llagosta,Barcelona,72,90,-18
2000,08110,Malgrat de Mar,Barcelona,203,177,26
2000,08112,Manlleu,Barcelona,96,90,6
2000,08113,Manresa,Barcelona,363,383,-20
2000,08114,Martorell,Barcelona,148,155,-7
2000,08118,El Masnou,Barcelona,79,184,-105
2000,08121,Mataró,Barcelona,684,746,-62
2000,08123,Molins de Rei,Barcelona,111,113,-2
2000,08124,Mollet del Vallès,Barcelona,267,332,-65
2000,08125,Montcada i Reixac,Barcelona,138,165,-27
2000,08136,Montornès del Vallès,Barcelona,81,59,22
2000,08147,Olesa de Montserrat,Barcelona,117,109,8
2000,08156,Palau-solità i Plegamans,Barcelona,51,67,-16
2000,08159,Parets del Vallès,Barcelona,58,63,-5
2000,08163,Pineda de Mar,Barcelona,194,225,-31
2000,08169,El Prat de Llobregat,Barcelona,410,599,-189
2000,08172,Premià de Mar,Barcelona,172,261,-89
2000,08180,Ripollet,Barcelona,233,228,5
2000,08184,Rubí,Barcelona,440,410,30
2000,08187,Sabadell,Barcelona,1001,1174,-173
2000,08194,Sant Adrià de Besòs,Barcelona,148,249,-101
2000,08196,Sant Andreu de la Barca,Barcelona,99,236,-137
2000,08200,Sant Boi de Llobregat,Barcelona,447,609,-162
2000,08202,Sant Celoni,Barcelona,164,151,13
2000,08205,Sant Cugat del Vallès,Barcelona,518,470,48
2000,08211,Sant Feliu de Llobregat,Barcelona,236,279,-43
2000,08217,Sant Joan Despí,Barcelona,203,189,14
2000,08219,Vilassar de Mar,Barcelona,108,111,-3
2000,08221,Sant Just Desvern,Barcelona,70,89,-19
2000,08231,Sant Pere de Ribes,Barcelona,199,169,30
2000,08238,Sant Quirze del Vallès,Barcelona,71,104,-33
2000,08245,Santa Coloma de Gramenet,Barcelona,518,894,-376
2000,08252,Barberà del Vallès,Barcelona,107,166,-59
2000,08260,Santa Perpètua de Mogoda,Barcelona,117,147,-30
2000,08263,Sant Vicenç dels Horts,Barcelona,146,160,-14
2000,08266,Cerdanyola del Vallès,Barcelona,319,443,-124
2000,08270,Sitges,Barcelona,209,189,20
2000,08279,Terrassa,Barcelona,929,952,-23
2000,08285,Torelló,Barcelona,46,38,8
2000,08298,Vic,Barcelona,233,211,22
2000,08301,Viladecans,Barcelona,306,560,-254
2000,08302,Vilanova del Camí,Barcelona,65,60,5
2000,08305,Vilafranca del Penedès,Barcelona,280,260,20
2000,08307,Vilanova i la Geltrú,Barcelona,451,496,-45
2000,08904,Badia del Vallès,Barcelona,75,135,-60
2000,09018,Aranda de Duero,Burgos,290,452,-162
2000,09059,Burgos,Burgos,1538,1844,-306
2000,09219,Miranda de Ebro,Burgos,188,651,-463
2000,10037,Cáceres,Cáceres,836,1128,-292
2000,10067,Coria,Cáceres,157,195,-38
2000,10131,Navalmoral de la Mata,Cáceres,228,393,-165
2000,10148,Plasencia,Cáceres,219,499,-280
2000,11004,Algeciras,Cádiz,1290,1295,-5
2000,11006,Arcos de la Frontera,Cádiz,310,301,9
2000,11007,Barbate,Cádiz,243,250,-7
2000,11008,Los Barrios,Cádiz,205,127,78
2000,11012,Cádiz,Cádiz,860,1916,-1056
2000,11014,Conil de la Frontera,Cádiz,118,79,39
2000,11015,Chiclana de la Frontera,Cádiz,817,504,313
2000,11016,Chipiona,Cádiz,197,146,51
2000,11020,Jerez de la Frontera,Cádiz,2241,2619,-378
2000,11022,La Línea de la Concepción,Cádiz,595,668,-73
2000,11023,Medina-Sidonia,Cádiz,85,69,16
2000,11027,El Puerto de Santa María,Cádiz,1003,980,23
2000,11028,Puerto Real,Cádiz,200,214,-14
2000,11030,Rota,Cádiz,444,244,200
2000,11031,San Fernando,Cádiz,958,1031,-73
2000,11032,Sanlúcar de Barrameda,Cádiz,321,361,-40
2000,11033,San Roque,Cádiz,399,278,121
2000,11035,Tarifa,Cádiz,242,183,59
2000,11038,Ubrique,Cádiz,70,176,-106
2000,11039,Vejer de la Frontera,Cádiz,86,60,26
2000,11041,Villamartín,Cádiz,112,234,-122
2000,12009,Almassora,Castellón,195,68,127
2000,12027,Benicarló,Castellón,368,303,65
2000,12028,Benicasim/Benicàssim,Castellón,352,184,168
2000,12032,Borriana/Burriana,Castellón,347,127,220
2000,12040,Castellón de la Plana/Castelló de la Plana,Castellón,2176,1253,923
2000,12082,Nules,Castellón,127,60,67
2000,12084,Onda,Castellón,233,81,152
2000,12126,La Vall d'Uixó,Castellón,222,160,62
2000,12135,Vila-real,Castellón,535,305,230
2000,12138,Vinaròs,Castellón,442,362,80
2000,13005,Alcázar de San Juan,Ciudad Real,394,352,42
2000,13023,Bolaños de Calatrava,Ciudad Real,45,69,-24
2000,13028,Campo de Criptana,Ciudad Real,73,116,-43
2000,13034,Ciudad Real,Ciudad Real,789,881,-92
2000,13039,Daimiel,Ciudad Real,105,112,-7
2000,13053,Manzanares,Ciudad Real,157,210,-53
2000,13071,Puertollano,Ciudad Real,416,944,-528
2000,13078,Socuéllamos,Ciudad Real,105,127,-22
2000,13079,La Solana,Ciudad Real,55,82,-27
2000,13082,Tomelloso,Ciudad Real,156,195,-39
2000,13087,Valdepeñas,Ciudad Real,170,294,-124
2000,14002,Aguilar de la Frontera,Córdoba,57,67,-10
2000,14007,Baena,Córdoba,133,196,-63
2000,14013,Cabra,Córdoba,111,163,-52
2000,14017,La Carlota,Córdoba,95,95,0
2000,14021,Córdoba,Córdoba,2367,3985,-1618
2000,14038,Lucena,Córdoba,310,267,43
2000,14042,Montilla,Córdoba,100,130,-30
2000,14049,Palma del Río,Córdoba,328,327,1
2000,14052,Peñarroya-Pueblonuevo,Córdoba,117,317,-200
2000,14054,Pozoblanco,Córdoba,154,99,55
2000,14055,Priego de Córdoba,Córdoba,252,219,33
2000,14056,Puente Genil,Córdoba,273,369,-96
2000,14058,Rute,Córdoba,80,111,-31
2000,15002,Ames,A Coruña,342,157,185
2000,15005,Arteixo,A Coruña,133,145,-12
2000,15009,Betanzos,A Coruña,54,86,-32
2000,15011,Boiro,A Coruña,86,177,-91
2000,15017,Cambre,A Coruña,161,125,36
2000,15019,Carballo,A Coruña,105,188,-83
2000,15030,A Coruña,A Coruña,2200,2389,-189
2000,15031,Culleredo,A Coruña,205,138,67
2000,15035,Fene,A Coruña,40,120,-80
2000,15036,Ferrol,A Coruña,685,1080,-395
2000,15041,A Laracha,A Coruña,29,34,-5
2000,15053,Muros,A Coruña,86,213,-127
2000,15054,Narón,A Coruña,4,211,-207
2000,15057,Noia,A Coruña,97,215,-118
2000,15058,Oleiros,A Coruña,327,250,77
2000,15059,Ordes,A Coruña,44,47,-3
2000,15067,A Pobra do Caramiñal,A Coruña,44,70,-26
2000,15070,As Pontes de García Rodríguez,A Coruña,97,127,-30
2000,15071,Porto do Son,A Coruña,51,147,-96
2000,15072,Rianxo,A Coruña,56,119,-63
2000,15073,Ribeira,A Coruña,139,253,-114
2000,15075,Sada (A Coruña),A Coruña,81,81,0
2000,15077,Santa Comba,A Coruña,33,64,-31
2000,15078,Santiago de Compostela,A Coruña,796,1012,-216
2000,15082,Teo,A Coruña,157,114,43
2000,16078,Cuenca,Cuenca,502,610,-108
2000,16203,Tarancón,Cuenca,154,196,-42
2000,17015,Banyoles,Girona,134,103,31
2000,17023,Blanes,Girona,1049,684,365
2000,17066,Figueres,Girona,436,373,63
2000,17079,Girona,Girona,1040,886,154
2000,17095,Lloret de Mar,Girona,784,447,337
2000,17114,Olot,Girona,316,222,94
2000,17117,Palafrugell,Girona,283,193,90
2000,17118,Palamós,Girona,234,167,67
2000,17147,Ripoll,Girona,136,130,6
2000,17152,Roses,Girona,281,154,127
2000,17155,Salt,Girona,248,167,81
2000,17160,Sant Feliu de Guíxols,Girona,342,169,173
2000,18003,Albolote,Granada,180,135,45
2000,18017,Almuñécar,Granada,241,256,-15
2000,18021,Armilla,Granada,199,151,48
2000,18022,Atarfe,Granada,100,77,23
2000,18023,Baza,Granada,206,272,-66
2000,18087,Granada,Granada,2493,3702,-1209
2000,18089,Guadix,Granada,240,287,-47
2000,18102,Illora,Granada,62,100,-38
2000,18122,Loja,Granada,139,197,-58
2000,18127,Maracena,Granada,155,118,37
2000,18140,Motril,Granada,416,431,-15
2000,18158,Pinos Puente,Granada,79,106,-27
2000,18173,Salobreña,Granada,126,104,22
2000,18175,Santa Fe,Granada,161,109,52
2000,18193,La Zubia,Granada,157,103,54
2000,19046,Azuqueca de Henares,Guadalajara,1148,455,693
2000,19130,Guadalajara,Guadalajara,1051,852,199
2000,20009,Andoain,Guipúzcoa,69,92,-23
2000,20017,Azkoitia,Guipúzcoa,39,48,-9
2000,20018,Azpeitia,Guipúzcoa,62,53,9
2000,20019,Beasain,Guipúzcoa,80,93,-13
2000,20030,Eibar,Guipúzcoa,257,406,-149
2000,20032,Elgoibar,Guipúzcoa,65,83,-18
2000,20036,Hondarribia,Guipúzcoa,134,130,4
2000,20040,Hernani,Guipúzcoa,120,132,-12
2000,20045,Irun,Guipúzcoa,512,631,-119
2000,20055,Arrasate/Mondragón,Guipúzcoa,141,299,-158
2000,20059,Oñati,Guipúzcoa,57,52,5
2000,20064,Pasaia,Guipúzcoa,61,110,-49
2000,20067,Errenteria,Guipúzcoa,183,317,-134
2000,20069,Donostia/San Sebastián,Guipúzcoa,1486,1810,-324
2000,20071,Tolosa,Guipúzcoa,78,131,-53
2000,20074,Bergara,Guipúzcoa,63,145,-82
2000,20079,Zarautz,Guipúzcoa,200,164,36
2000,20080,Zumarraga,Guipúzcoa,54,98,-44
2000,20902,Lasarte-Oria,Guipúzcoa,134,122,12
2000,21002,Aljaraque,Huelva,178,92,86
2000,21005,Almonte,Huelva,213,163,50
2000,21010,Ayamonte,Huelva,160,136,24
2000,21013,Bollullos Par del Condado,Huelva,41,54,-13
2000,21021,Cartaya,Huelva,167,120,47
2000,21035,Gibraleón,Huelva,56,75,-19
2000,21041,Huelva,Huelva,894,1261,-367
2000,21042,Isla Cristina,Huelva,235,178,57
2000,21044,Lepe,Huelva,265,183,82
2000,21050,Moguer,Huelva,208,166,42
2000,21060,Punta Umbría,Huelva,145,162,-17
2000,21072,Valverde del Camino,Huelva,31,68,-37
2000,22048,Barbastro,Huesca,21,154,-133
2000,22112,Fraga,Huesca,142,171,-29
2000,22125,Huesca,Huesca,453,571,-118
2000,22130,Jaca,Huesca,286,287,-1
2000,22158,Monzón,Huesca,151,153,-2
2000,23002,Alcalá la Real,Jaén,192,293,-101
2000,23003,Alcaudete,Jaén,76,138,-62
2000,23005,Andújar,Jaén,320,442,-122
2000,23009,Baeza,Jaén,117,187,-70
2000,23010,Bailén,Jaén,104,146,-42
2000,23024,La Carolina,Jaén,147,191,-44
2000,23050,Jaén,Jaén,793,1245,-452
2000,23053,Jódar,Jaén,79,152,-73
2000,23055,Linares,Jaén,535,844,-309
2000,23060,Martos,Jaén,157,143,14
2000,23086,Torredelcampo,Jaén,70,81,-11
2000,23087,Torredonjimeno,Jaén,75,75,0
2000,23092,Úbeda,Jaén,286,371,-85
2000,23095,Villacarrillo,Jaén,89,162,-73
2000,24008,Astorga,León,121,165,-44
2000,24010,La Bañeza,León,88,166,-78
2000,24014,Bembibre,León,76,214,-138
2000,24089,León,León,1358,1967,-609
2000,24115,Ponferrada,León,542,768,-226
2000,24142,San Andrés del Rabanedo,León,198,227,-29
2000,24202,Villablino,León,105,319,-214
2000,25040,Balaguer,Lleida,149,176,-27
2000,25120,Lleida,Lleida,737,1408,-671
2000,25203,La Seu d'Urgell,Lleida,291,288,3
2000,25217,Tàrrega,Lleida,174,224,-50
2000,26018,Arnedo,La Rioja,119,117,2
2000,26036,Calahorra,La Rioja,499,268,231
2000,26089,Logroño,La Rioja,2068,1518,550
2000,27028,Lugo,Lugo,812,1051,-239
2000,27031,Monforte de Lemos,Lugo,223,288,-65
2000,27057,Sarria,Lugo,85,75,10
2000,27065,Vilalba,Lugo,79,109,-30
2000,27066,Viveiro,Lugo,133,179,-46
2000,28005,Alcalá de Henares,Madrid,1960,2315,-355
2000,28006,Alcobendas,Madrid,810,780,30
2000,28007,Alcorcón,Madrid,990,1180,-190
2000,28009,Algete,Madrid,158,151,7
2000,28013,Aranjuez,Madrid,529,443,86
2000,28014,Arganda del Rey,Madrid,121,187,-66
2000,28022,Boadilla del Monte,Madrid,261,136,125
2000,28040,Ciempozuelos,Madrid,76,103,-27
2000,28045,Colmenar Viejo,Madrid,366,270,96
2000,28047,Collado Villalba,Madrid,510,499,11
2000,28049,Coslada,Madrid,322,474,-152
2000,28054,El Escorial,Madrid,107,95,12
2000,28058,Fuenlabrada,Madrid,1479,1677,-198
2000,28061,Galapagar,Madrid,151,198,-47
2000,28065,Getafe,Madrid,972,1197,-225
2000,28074,Leganés,Madrid,998,1205,-207
2000,28079,Madrid,Madrid,25279,31165,-5886
2000,28080,Majadahonda,Madrid,130,410,-280
2000,28084,Mejorada del Campo,Madrid,122,123,-1
2000,28092,Móstoles,Madrid,1472,1819,-347
2000,28096,Navalcarnero,Madrid,145,95,50
2000,28106,Parla,Madrid,616,869,-253
2000,28113,Pinto,Madrid,342,206,136
2000,28115,Pozuelo de Alarcón,Madrid,584,482,102
2000,28123,Rivas-Vaciamadrid,Madrid,237,138,99
2000,28127,Las Rozas de Madrid,Madrid,960,529,431
2000,28130,San Fernando de Henares,Madrid,217,241,-24
2000,28131,San Lorenzo de El Escorial,Madrid,125,101,24
2000,28132,San Martín de la Vega,Madrid,104,109,-5
2000,28134,San Sebastián de los Reyes,Madrid,367,460,-93
2000,28148,Torrejón de Ardoz,Madrid,826,1013,-187
2000,28152,Torrelodones,Madrid,152,74,78
2000,28161,Valdemoro,Madrid,708,442,266
2000,28181,Villaviciosa de Odón,Madrid,185,103,82
2000,28903,Tres Cantos,Madrid,570,275,295
2000,29007,Alhaurín de la Torre,Málaga,204,162,42
2000,29008,Alhaurín el Grande,Málaga,65,45,20
2000,29012,Álora,Málaga,35,54,-19
2000,29015,Antequera,Málaga,277,200,77
2000,29025,Benalmádena,Málaga,657,329,328
2000,29038,Cártama,Málaga,43,42,1
2000,29042,Coín,Málaga,104,71,33
2000,29051,Estepona,Málaga,901,489,412
2000,29054,Fuengirola,Málaga,999,530,469
2000,29067,Málaga,Málaga,3722,3679,43
2000,29069,Marbella,Málaga,2532,1134,1398
2000,29070,Mijas,Málaga,573,226,347
2000,29075,Nerja,Málaga,174,93,81
2000,29082,Rincón de la Victoria,Málaga,438,134,304
2000,29084,Ronda,Málaga,401,300,101
2000,29091,Torrox,Málaga,82,46,36
2000,29094,Vélez-Málaga,Málaga,502,321,181
2000,29901,Torremolinos,Málaga,989,528,461
2000,30002,Abarán,Murcia,46,69,-23
2000,30003,Águilas,Murcia,411,399,12
2000,30005,Alcantarilla,Murcia,313,208,105
2000,30008,Alhama de Murcia,Murcia,88,75,13
2000,30009,Archena,Murcia,66,58,8
2000,30012,Bullas,Murcia,54,46,8
2000,30015,Caravaca de la Cruz,Murcia,228,183,45
2000,30016,Cartagena,Murcia,1903,1902,1
2000,30017,Cehegín,Murcia,86,83,3
2000,30019,Cieza (Murcia),Murcia,162,167,-5
2000,30022,Jumilla,Murcia,170,251,-81
2000,30024,Lorca,Murcia,699,637,62
2000,30026,Mazarrón,Murcia,562,367,195
2000,30027,Molina de Segura,Murcia,406,239,167
2000,30029,Mula,Murcia,41,114,-73
2000,30030,Murcia,Murcia,2636,2518,118
2000,30033,Puerto Lumbreras,Murcia,96,101,-5
2000,30035,San Javier,Murcia,576,554,22
2000,30036,San Pedro del Pinatar,Murcia,419,322,97
2000,30037,Torre-Pacheco,Murcia,264,366,-102
2000,30038,Las Torres de Cotillas,Murcia,136,104,32
2000,30039,Totana,Murcia,126,109,17
2000,30041,La Unión,Murcia,98,96,2
2000,30043,Yecla,Murcia,322,282,40
2000,30901,Santomera,Murcia,125,109,16
2000,31060,Burlada/Burlata,Navarra,138,85,53
2000,31097,Estella-Lizarra,Navarra,118,88,30
2000,31201,Pamplona/Iruña,Navarra,1821,1607,214
2000,31227,Tafalla,Navarra,84,62,22
2000,31232,Tudela,Navarra,367,352,15
2000,31901,Barañain,Navarra,244,140,104
2000,31907,Zizur Mayor/Zizur Nagusia,Navarra,123,42,81
2000,32009,O Barco de Valdeorras,Ourense,170,199,-29
2000,32019,O Carballiño,Ourense,104,179,-75
2000,32054,Ourense,Ourense,968,1535,-567
2000,32085,Verín,Ourense,204,267,-63
2000,33002,Aller,Asturias,35,77,-42
2000,33004,Avilés,Asturias,393,772,-379
2000,33011,Cangas del Narcea,Asturias,63,141,-78
2000,33014,Carreño,Asturias,49,28,21
2000,33016,Castrillón,Asturias,110,160,-50
2000,33020,Corvera de Asturias,Asturias,80,112,-32
2000,33024,Gijón,Asturias,2001,2444,-443
2000,33025,Gozón,Asturias,34,61,-27
2000,33026,Grado,Asturias,26,44,-18
2000,33031,Langreo,Asturias,161,310,-149
2000,33032,Laviana,Asturias,38,64,-26
2000,33033,Lena,Asturias,85,124,-39
2000,33034,Valdés,Asturias,63,87,-24
2000,33035,Llanera,Asturias,87,63,24
2000,33036,Llanes,Asturias,111,123,-12
2000,33037,Mieres (Asturias),Asturias,217,395,-178
2000,33044,Oviedo,Asturias,1277,1768,-491
2000,33060,San Martín del Rey Aurelio,Asturias,65,110,-45
2000,33066,Siero,Asturias,282,223,59
2000,33073,Tineo,Asturias,42,47,-5
2000,33076,Villaviciosa,Asturias,82,52,30
2000,34120,Palencia,Palencia,880,1084,-204
2000,35002,Agüimes,Las Palmas,279,140,139
2000,35004,Arrecife,Las Palmas,1352,1139,213
2000,35006,Arucas,Las Palmas,134,88,46
2000,35009,Gáldar,Las Palmas,64,32,32
2000,35011,Ingenio,Las Palmas,135,76,59
2000,35012,Mogán,Las Palmas,256,191,65
2000,35015,Pájara,Las Palmas,2240,972,1268
2000,35016,Las Palmas de Gran Canaria,Las Palmas,3849,4456,-607
2000,35017,Puerto del Rosario,Las Palmas,1262,800,462
2000,35018,San Bartolomé,Las Palmas,707,385,322
2000,35019,San Bartolomé de Tirajana,Las Palmas,382,416,-34
2000,35021,Santa Brígida,Las Palmas,76,89,-13
2000,35022,Santa Lucía de Tirajana,Las Palmas,669,364,305
2000,35023,Santa María de Guía de Gran Canaria,Las Palmas,41,28,13
2000,35024,Teguise,Las Palmas,334,216,118
2000,35026,Telde,Las Palmas,592,532,60
2000,35027,Teror,Las Palmas,32,19,13
2000,35028,Tías,Las Palmas,533,332,201
2000,36003,Baiona,Pontevedra,66,106,-40
2000,36004,Bueu,Pontevedra,60,108,-48
2000,36006,Cambados,Pontevedra,75,125,-50
2000,36008,Cangas,Pontevedra,93,179,-86
2000,36017,A Estrada,Pontevedra,150,243,-93
2000,36021,Gondomar,Pontevedra,70,84,-14
2000,36022,O Grove,Pontevedra,91,98,-7
2000,36024,Lalín,Pontevedra,133,177,-44
2000,36026,Marín,Pontevedra,235,300,-65
2000,36029,Moaña,Pontevedra,66,102,-36
2000,36033,Mos,Pontevedra,43,61,-18
2000,36035,Nigrán,Pontevedra,121,105,16
2000,36038,Pontevedra,Pontevedra,779,941,-162
2000,36039,O Porriño,Pontevedra,47,95,-48
2000,36041,Poio,Pontevedra,106,106,0
2000,36042,Ponteareas,Pontevedra,175,133,42
2000,36045,Redondela,Pontevedra,124,167,-43
2000,36051,Sanxenxo,Pontevedra,92,139,-47
2000,36054,Tomiño,Pontevedra,68,67,1
2000,36055,Tui,Pontevedra,143,152,-9
2000,36057,Vigo,Pontevedra,2243,2696,-453
2000,36060,Vilagarcía de Arousa,Pontevedra,258,404,-146
2000,36061,Vilanova de Arousa,Pontevedra,48,115,-67
2000,37046,Béjar,Salamanca,142,219,-77
2000,37107,Ciudad Rodrigo,Salamanca,145,258,-113
2000,37274,Salamanca,Salamanca,1810,2499,-689
2000,37294,Santa Marta de Tormes,Salamanca,207,153,54
2000,38001,Adeje,Santa Cruz de Tenerife,963,583,380
2000,38006,Arona,Santa Cruz de Tenerife,2135,1222,913
2000,38011,Candelaria,Santa Cruz de Tenerife,205,211,-6
2000,38017,Granadilla de Abona,Santa Cruz de Tenerife,496,437,59
2000,38019,Guía de Isora,Santa Cruz de Tenerife,228,85,143
2000,38020,Güímar,Santa Cruz de Tenerife,36,76,-40
2000,38022,Icod de los Vinos,Santa Cruz de Tenerife,35,40,-5
2000,38023,San Cristóbal de La Laguna,Santa Cruz de Tenerife,985,629,356
2000,38024,Los Llanos de Aridane,Santa Cruz de Tenerife,215,144,71
2000,38026,La Orotava,Santa Cruz de Tenerife,115,108,7
2000,38028,Puerto de la Cruz,Santa Cruz de Tenerife,408,296,112
2000,38031,Los Realejos,Santa Cruz de Tenerife,104,100,4
2000,38032,El Rosario,Santa Cruz de Tenerife,147,138,9
2000,38037,Santa Cruz de la Palma,Santa Cruz de Tenerife,326,283,43
2000,38038,Santa Cruz de Tenerife,Santa Cruz de Tenerife,2229,2305,-76
2000,38039,Santa Úrsula,Santa Cruz de Tenerife,102,51,51
2000,38043,Tacoronte,Santa Cruz de Tenerife,86,66,20
2000,39008,El Astillero,Cantabria,154,70,84
2000,39016,Camargo,Cantabria,160,101,59
2000,39020,Castro-Urdiales,Cantabria,1850,599,1251
2000,39025,Los Corrales de Buelna,Cantabria,49,52,-3
2000,39035,Laredo,Cantabria,272,237,35
2000,39052,Piélagos,Cantabria,156,65,91
2000,39059,Reinosa,Cantabria,44,149,-105
2000,39075,Santander,Cantabria,1801,1968,-167
2000,39079,Santoña,Cantabria,153,108,45
2000,39087,Torrelavega,Cantabria,348,379,-31
2000,40194,Segovia,Segovia,448,682,-234
2000,41004,Alcalá de Guadaíra,Sevilla,353,469,-116
2000,41007,La Algaba,Sevilla,35,33,2
2000,41011,Arahal,Sevilla,57,101,-44
2000,41018,Brenes,Sevilla,73,107,-34
2000,41020,Las Cabezas de San Juan,Sevilla,124,169,-45
2000,41021,Camas,Sevilla,137,186,-49
2000,41024,Carmona,Sevilla,120,160,-40
2000,41029,Castilleja de la Cuesta,Sevilla,141,129,12
2000,41034,Coria del Río,Sevilla,105,150,-45
2000,41038,Dos Hermanas,Sevilla,1160,887,273
2000,41039,Écija,Sevilla,278,283,-5
2000,41041,Estepa,Sevilla,77,53,24
2000,41053,Lebrija,Sevilla,125,188,-63
2000,41055,Lora del Río,Sevilla,112,222,-110
2000,41058,Mairena del Alcor,Sevilla,63,80,-17
2000,41059,Mairena del Aljarafe,Sevilla,555,320,235
2000,41060,Marchena,Sevilla,73,84,-11
2000,41065,Morón de la Frontera,Sevilla,168,349,-181
2000,41068,Osuna,Sevilla,102,163,-61
2000,41069,Los Palacios y Villafranca,Sevilla,192,199,-7
2000,41075,Pilas,Sevilla,30,49,-19
2000,41077,La Puebla de Cazalla,Sevilla,113,157,-44
2000,41079,La Puebla del Río,Sevilla,25,80,-55
2000,41081,La Rinconada,Sevilla,248,213,35
2000,41086,San Juan de Aznalfarache,Sevilla,166,221,-55
2000,41087,Sanlúcar la Mayor,Sevilla,63,61,2
2000,41091,Sevilla,Sevilla,5853,6810,-957
2000,41093,Tomares,Sevilla,243,153,90
2000,41095,Utrera,Sevilla,288,444,-156
2000,41102,El Viso del Alcor,Sevilla,27,41,-14
2000,42173,Soria,Soria,408,514,-106
2000,43014,Amposta,Tarragona,173,153,20
2000,43037,Calafell,Tarragona,1265,472,793
2000,43038,Cambrils,Tarragona,641,301,340
2000,43123,Reus,Tarragona,949,663,286
2000,43136,Sant Carles de la Ràpita,Tarragona,189,89,100
2000,43148,Tarragona,Tarragona,2504,1129,1375
2000,43153,Torredembarra,Tarragona,471,239,232
2000,43155,Tortosa,Tarragona,528,310,218
2000,43161,Valls,Tarragona,231,166,65
2000,43163,El Vendrell,Tarragona,1366,566,800
2000,43171,Vila-seca,Tarragona,294,166,128
2000,43901,Deltebre,Tarragona,70,32,38
2000,43905,Salou,Tarragona,536,280,256
2000,44013,Alcañiz,Teruel,209,187,22
2000,44216,Teruel,Teruel,351,467,-116
2000,45053,Consuegra,Toledo,19,50,-31
2000,45081,Illescas,Toledo,521,199,322
2000,45087,Madridejos,Toledo,75,75,0
2000,45165,Talavera de la Reina,Toledo,1112,968,144
2000,45168,Toledo,Toledo,1113,930,183
2000,46005,Alaquàs,Valencia,174,88,86
2000,46007,Albal,Valencia,53,32,21
2000,46013,Alboraya,Valencia,172,87,85
2000,46017,Alzira,Valencia,226,196,30
2000,46019,L'Alcúdia,Valencia,30,25,5
2000,46021,Aldaia,Valencia,118,145,-27
2000,46022,Alfafar,Valencia,101,96,5
2000,46029,Algemesí,Valencia,100,87,13
2000,46031,Alginet,Valencia,13,50,-37
2000,46054,Benetússer,Valencia,82,58,24
2000,46060,Benifaió,Valencia,45,57,-12
2000,46070,Bétera,Valencia,144,117,27
2000,46078,Burjassot,Valencia,214,188,26
2000,46081,Canals,Valencia,61,46,15
2000,46083,Carcaixent,Valencia,66,69,-3
2000,46085,Carlet,Valencia,14,55,-41
2000,46094,Catarroja,Valencia,121,116,5
2000,46102,Quart de Poblet,Valencia,146,135,11
2000,46105,Cullera,Valencia,195,159,36
2000,46110,Xirivella,Valencia,141,97,44
2000,46116,L'Eliana,Valencia,122,118,4
2000,46131,Gandia,Valencia,881,640,241
2000,46135,Godella,Valencia,58,55,3
2000,46145,Xátiva,Valencia,140,128,12
2000,46147,Llíria,Valencia,161,119,42
2000,46159,Manises,Valencia,81,117,-36
2000,46164,Massamagrell,Valencia,81,64,17
2000,46169,Mislata,Valencia,306,254,52
2000,46171,Moncada,Valencia,100,52,48
2000,46181,Oliva,Valencia,182,112,70
2000,46184,Ontinyent,Valencia,229,133,96
2000,46186,Paiporta,Valencia,114,90,24
2000,46190,Paterna,Valencia,278,333,-55
2000,46194,Picassent,Valencia,84,64,20
2000,46202,La Pobla de Vallbona,Valencia,96,67,29
2000,46205,Puçol,Valencia,85,55,30
2000,46213,Requena,Valencia,126,108,18
2000,46214,Riba-roja de Túria,Valencia,88,73,15
2000,46220,Sagunto/Sagunt,Valencia,491,433,58
2000,46230,Silla,Valencia,76,57,19
2000,46235,Sueca,Valencia,95,70,25
2000,46238,Tavernes de la Valldigna,Valencia,81,83,-2
2000,46244,Torrent (Valencia),Valencia,425,317,108
2000,46249,Utiel,Valencia,86,45,41
2000,46250,València,Valencia,7127,5816,1311
2000,47076,Laguna de Duero,Valladolid,225,169,56
2000,47085,Medina del Campo,Valladolid,198,205,-7
2000,47186,Valladolid,Valladolid,3269,3720,-451
2000,48003,Amorebieta-Etxano,Vizcaya,69,119,-50
2000,48011,Arrigorriaga,Vizcaya,67,108,-41
2000,48013,Barakaldo,Vizcaya,672,1174,-502
2000,48015,Basauri,Vizcaya,269,443,-174
2000,48017,Bermeo,Vizcaya,73,134,-61
2000,48020,Bilbao,Vizcaya,3113,4415,-1302
2000,48027,Durango,Vizcaya,178,186,-8
2000,48034,Ermua,Vizcaya,180,303,-123
2000,48036,Galdakao,Vizcaya,131,228,-97
2000,48044,Getxo,Vizcaya,679,908,-229
2000,48046,Gernika-Lumo,Vizcaya,70,91,-21
2000,48054,Leioa,Vizcaya,125,282,-157
2000,48069,Mungia,Vizcaya,96,79,17
2000,48073,Ondarroa,Vizcaya,81,156,-75
2000,48078,Portugalete,Vizcaya,292,563,-271
2000,48080,Valle de Trápaga-Trapagaran,Vizcaya,47,109,-62
2000,48082,Santurtzi,Vizcaya,231,526,-295
2000,48084,Sestao,Vizcaya,195,368,-173
2000,48902,Erandio,Vizcaya,131,227,-96
2000,49021,Benavente,Zamora,299,248,51
2000,49275,Zamora,Zamora,728,898,-170
2000,50067,Calatayud,Zaragoza,192,192,0
2000,50251,Tarazona,Zaragoza,128,82,46
2000,50297,Zaragoza,Zaragoza,5013,5195,-182
2000,51001,Ceuta,Ceuta,1998,2528,-530
2000,52001,Melilla,Melilla,1723,2585,-862
2001,01036,Laudio/Llodio,Álava,180,271,-91
2001,01059,Vitoria-Gasteiz,Álava,2448,2568,-120
2001,02003,Albacete,Albacete,1605,1790,-185
2001,02009,Almansa,Albacete,258,242,16
2001,02037,Hellín,Albacete,287,413,-126
2001,02069,La Roda,Albacete,179,141,38
2001,02081,Villarrobledo,Albacete,223,270,-47
2001,03009,Alcoy/Alcoi,Alicante,276,408,-132
2001,03011,L'Alfàs del Pi,Alicante,183,134,49
2001,03014,Alicante/Alacant,Alicante,4346,2529,1817
2001,03015,Almoradí,Alicante,125,107,18
2001,03018,Altea,Alicante,265,139,126
2001,03019,Aspe,Alicante,92,63,29
2001,03031,Benidorm,Alicante,1953,1141,812
2001,03041,Benissa,Alicante,93,72,21
2001,03047,Calp,Alicante,368,194,174
2001,03049,Callosa de Segura,Alicante,90,82,8
2001,03050,El Campello,Alicante,377,198,179
2001,03056,Cocentaina,Alicante,59,64,-5
2001,03059,Crevillent,Alicante,145,139,6
2001,03063,Dénia,Alicante,663,481,182
2001,03065,Elche/Elx,Alicante,1237,925,312
2001,03066,Elda,Alicante,353,269,84
2001,03079,Ibi,Alicante,193,91,102
2001,03082,Jávea/Xàbia,Alicante,321,218,103
2001,03089,Monóvar/Monòver,Alicante,99,44,55
2001,03090,Mutxamel,Alicante,252,117,135
2001,03093,Novelda,Alicante,122,96,26
2001,03099,Orihuela,Alicante,942,630,312
2001,03102,Pego,Alicante,75,69,6
2001,03104,Petrer,Alicante,166,117,49
2001,03119,Sant Joan d'Alacant,Alicante,286,143,143
2001,03121,Santa Pola,Alicante,519,281,238
2001,03122,San Vicente del Raspeig/Sant Vicent del Raspeig,Alicante,403,250,153
2001,03128,Teulada,Alicante,99,52,47
2001,03133,Torrevieja,Alicante,3495,1697,1798
2001,03139,Villajoyosa/La Vila Joiosa,Alicante,292,204,88
2001,03140,Villena,Alicante,286,174,112
2001,03902,Pilar de la Horadada,Alicante,423,346,77
2001,04003,Adra,Almería,151,188,-37
2001,04013,Almería,Almería,1482,1407,75
2001,04029,Berja,Almería,61,96,-35
2001,04035,Cuevas del Almanzora,Almería,148,151,-3
2001,04053,Huércal-Overa,Almería,163,175,-12
2001,04066,Níjar,Almería,158,323,-165
2001,04079,Roquetas de Mar,Almería,1040,946,94
2001,04102,Vícar,Almería,116,391,-275
2001,04902,El Ejido,Almería,656,1009,-353
2001,05019,Ávila,Ávila,620,568,52
2001,06011,Almendralejo,Badajoz,249,292,-43
2001,06015,Badajoz,Badajoz,1198,1529,-331
2001,06044,Don Benito,Badajoz,234,314,-80
2001,06083,Mérida,Badajoz,364,559,-195
2001,06088,Montijo,Badajoz,102,168,-66
2001,06095,Olivenza,Badajoz,82,81,1
2001,06149,Villafranca de los Barros,Badajoz,51,103,-52
2001,06153,Villanueva de la Serena,Badajoz,202,218,-16
2001,06158,Zafra,Badajoz,121,130,-9
2001,07003,Alcúdia,Baleares,538,328,210
2001,07011,Calvià,Baleares,1107,709,398
2001,07015,Ciutadella de Menorca,Baleares,900,445,455
2001,07022,Felanitx,Baleares,261,114,147
2001,07026,Eivissa,Baleares,1287,607,680
2001,07027,Inca,Baleares,390,282,108
2001,07031,Llucmajor,Baleares,561,247,314
2001,07032,Maó-Mahón,Baleares,800,422,378
2001,07033,Manacor,Baleares,801,372,429
2001,07036,Marratxí,Baleares,153,127,26
2001,07040,Palma,Baleares,7618,5249,2369
2001,07042,Pollença,Baleares,234,147,87
2001,07044,Sa Pobla,Baleares,121,95,26
2001,07046,Sant Antoni de Portmany,Baleares,411,181,230
2001,07048,Sant Josep de sa Talaia,Baleares,446,194,252
2001,07054,Santa Eulària des Riu,Baleares,731,369,362
2001,07061,Sóller,Baleares,119,61,58
2001,07062,Son Servera,Baleares,381,306,75
2001,08006,Arenys de Mar,Barcelona,112,99,13
2001,08015,Badalona,Barcelona,971,1537,-566
2001,08019,Barcelona,Barcelona,10318,13449,-3131
2001,08022,Berga,Barcelona,82,75,7
2001,08033,Caldes de Montbui,Barcelona,74,79,-5
2001,08035,Calella,Barcelona,180,141,39
2001,08040,Canet de Mar,Barcelona,46,75,-29
2001,08041,Canovelles,Barcelona,106,97,9
2001,08046,Cardedeu,Barcelona,79,73,6
2001,08051,Castellar del Vallès,Barcelona,71,100,-29
2001,08056,Castelldefels,Barcelona,542,695,-153
2001,08073,Cornellà de Llobregat,Barcelona,452,680,-228
2001,08076,Esparreguera,Barcelona,115,124,-9
2001,08077,Esplugues de Llobregat,Barcelona,242,382,-140
2001,08086,Les Franqueses del Vallès,Barcelona,59,76,-17
2001,08088,La Garriga,Barcelona,62,59,3
2001,08089,Gavà,Barcelona,287,391,-104
2001,08096,Granollers,Barcelona,334,406,-72
2001,08101,L'Hospitalet de Llobregat,Barcelona,1344,2126,-782
2001,08102,Igualada,Barcelona,255,257,-2
2001,08105,La Llagosta,Barcelona,69,87,-18
2001,08107,Lliçà d'Amunt,Barcelona,47,65,-18
2001,08110,Malgrat de Mar,Barcelona,147,181,-34
2001,08112,Manlleu,Barcelona,96,111,-15
2001,08113,Manresa,Barcelona,446,304,142
2001,08114,Martorell,Barcelona,155,229,-74
2001,08118,El Masnou,Barcelona,108,184,-76
2001,08121,Mataró,Barcelona,571,830,-259
2001,08123,Molins de Rei,Barcelona,88,132,-44
2001,08124,Mollet del Vallès,Barcelona,358,452,-94
2001,08125,Montcada i Reixac,Barcelona,124,176,-52
2001,08136,Montornès del Vallès,Barcelona,67,104,-37
2001,08147,Olesa de Montserrat,Barcelona,129,149,-20
2001,08156,Palau-solità i Plegamans,Barcelona,52,87,-35
2001,08159,Parets del Vallès,Barcelona,78,93,-15
2001,08163,Pineda de Mar,Barcelona,196,199,-3
2001,08169,El Prat de Llobregat,Barcelona,381,663,-282
2001,08172,Premià de Mar,Barcelona,159,238,-79
2001,08180,Ripollet,Barcelona,144,231,-87
2001,08184,Rubí,Barcelona,447,534,-87
2001,08187,Sabadell,Barcelona,929,1367,-438
2001,08194,Sant Adrià de Besòs,Barcelona,138,280,-142
2001,08196,Sant Andreu de la Barca,Barcelona,176,220,-44
2001,08200,Sant Boi de Llobregat,Barcelona,440,682,-242
2001,08202,Sant Celoni,Barcelona,144,160,-16
2001,08205,Sant Cugat del Vallès,Barcelona,560,422,138
2001,08211,Sant Feliu de Llobregat,Barcelona,294,325,-31
2001,08217,Sant Joan Despí,Barcelona,199,239,-40
2001,08219,Vilassar de Mar,Barcelona,92,132,-40
2001,08221,Sant Just Desvern,Barcelona,105,88,17
2001,08231,Sant Pere de Ribes,Barcelona,169,176,-7
2001,08238,Sant Quirze del Vallès,Barcelona,80,94,-14
2001,08245,Santa Coloma de Gramenet,Barcelona,542,998,-456
2001,08252,Barberà del Vallès,Barcelona,152,207,-55
2001,08260,Santa Perpètua de Mogoda,Barcelona,107,123,-16
2001,08263,Sant Vicenç dels Horts,Barcelona,117,190,-73
2001,08266,Cerdanyola del Vallès,Barcelona,359,475,-116
2001,08270,Sitges,Barcelona,172,192,-20
2001,08279,Terrassa,Barcelona,927,1023,-96
2001,08284,Tordera,Barcelona,122,162,-40
2001,08285,Torelló,Barcelona,59,76,-17
2001,08298,Vic,Barcelona,267,231,36
2001,08301,Viladecans,Barcelona,316,575,-259
2001,08302,Vilanova del Camí,Barcelona,59,56,3
2001,08305,Vilafranca del Penedès,Barcelona,365,262,103
2001,08307,Vilanova i la Geltrú,Barcelona,596,590,6
2001,08904,Badia del Vallès,Barcelona,68,141,-73
2001,09018,Aranda de Duero,Burgos,331,422,-91
2001,09059,Burgos,Burgos,1502,1798,-296
2001,09219,Miranda de Ebro,Burgos,612,619,-7
2001,10037,Cáceres,Cáceres,1046,908,138
2001,10067,Coria,Cáceres,103,186,-83
2001,10131,Navalmoral de la Mata,Cáceres,179,368,-189
2001,10148,Plasencia,Cáceres,346,471,-125
2001,10180,Talayuela,Cáceres,200,524,-324
2001,11004,Algeciras,Cádiz,1286,1081,205
2001,11006,Arcos de la Frontera,Cádiz,288,219,69
2001,11007,Barbate,Cádiz,212,219,-7
2001,11008,Los Barrios,Cádiz,240,153,87
2001,11012,Cádiz,Cádiz,987,1498,-511
2001,11014,Conil de la Frontera,Cádiz,112,89,23
2001,11015,Chiclana de la Frontera,Cádiz,713,442,271
2001,11016,Chipiona,Cádiz,188,98,90
2001,11020,Jerez de la Frontera,Cádiz,2122,2033,89
2001,11022,La Línea de la Concepción,Cádiz,497,482,15
2001,11023,Medina-Sidonia,Cádiz,40,56,-16
2001,11027,El Puerto de Santa María,Cádiz,809,925,-116
2001,11028,Puerto Real,Cádiz,215,296,-81
2001,11030,Rota,Cádiz,377,319,58
2001,11031,San Fernando,Cádiz,800,1000,-200
2001,11032,Sanlúcar de Barrameda,Cádiz,195,297,-102
2001,11033,San Roque,Cádiz,288,315,-27
2001,11035,Tarifa,Cádiz,206,161,45
2001,11038,Ubrique,Cádiz,60,121,-61
2001,11039,Vejer de la Frontera,Cádiz,84,69,15
2001,11041,Villamartín,Cádiz,116,141,-25
2001,12009,Almassora,Castellón,148,85,63
2001,12027,Benicarló,Castellón,346,277,69
2001,12028,Benicasim/Benicàssim,Castellón,384,188,196
2001,12032,Borriana/Burriana,Castellón,307,148,159
2001,12040,Castellón de la Plana/Castelló de la Plana,Castellón,2222,1324,898
2001,12082,Nules,Castellón,118,65,53
2001,12084,Onda,Castellón,274,117,157
2001,12126,La Vall d'Uixó,Castellón,256,187,69
2001,12135,Vila-real,Castellón,652,275,377
2001,12138,Vinaròs,Castellón,495,366,129
2001,13005,Alcázar de San Juan,Ciudad Real,283,319,-36
2001,13023,Bolaños de Calatrava,Ciudad Real,60,76,-16
2001,13028,Campo de Criptana,Ciudad Real,80,74,6
2001,13034,Ciudad Real,Ciudad Real,724,828,-104
2001,13039,Daimiel,Ciudad Real,148,133,15
2001,13053,Manzanares,Ciudad Real,210,229,-19
2001,13056,Miguelturra,Ciudad Real,103,85,18
2001,13071,Puertollano,Ciudad Real,473,823,-350
2001,13078,Socuéllamos,Ciudad Real,86,153,-67
2001,13079,La Solana,Ciudad Real,94,78,16
2001,13082,Tomelloso,Ciudad Real,194,235,-41
2001,13087,Valdepeñas,Ciudad Real,224,259,-35
2001,14002,Aguilar de la Frontera,Córdoba,83,79,4
2001,14007,Baena,Córdoba,174,158,16
2001,14013,Cabra,Córdoba,142,174,-32
2001,14017,La Carlota,Córdoba,144,139,5
2001,14021,Córdoba,Córdoba,2027,3356,-1329
2001,14038,Lucena,Córdoba,306,279,27
2001,14042,Montilla,Córdoba,111,104,7
2001,14049,Palma del Río,Córdoba,240,295,-55
2001,14052,Peñarroya-Pueblonuevo,Córdoba,148,278,-130
2001,14054,Pozoblanco,Córdoba,81,112,-31
2001,14055,Priego de Córdoba,Córdoba,211,273,-62
2001,14056,Puente Genil,Córdoba,223,226,-3
2001,15002,Ames,A Coruña,310,226,84
2001,15005,Arteixo,A Coruña,137,158,-21
2001,15009,Betanzos,A Coruña,73,74,-1
2001,15011,Boiro,A Coruña,120,148,-28
2001,15017,Cambre,A Coruña,136,116,20
2001,15019,Carballo,A Coruña,96,165,-69
2001,15030,A Coruña,A Coruña,2098,2100,-2
2001,15031,Culleredo,A Coruña,205,144,61
2001,15035,Fene,A Coruña,84,84,0
2001,15036,Ferrol,A Coruña,723,927,-204
2001,15041,A Laracha,A Coruña,26,47,-21
2001,15053,Muros,A Coruña,90,143,-53
2001,15054,Narón,A Coruña,84,154,-70
2001,15057,Noia,A Coruña,93,160,-67
2001,15058,Oleiros,A Coruña,221,241,-20
2001,15059,Ordes,A Coruña,30,71,-41
2001,15067,A Pobra do Caramiñal,A Coruña,43,92,-49
2001,15070,As Pontes de García Rodríguez,A Coruña,81,114,-33
2001,15071,Porto do Son,A Coruña,55,140,-85
2001,15072,Rianxo,A Coruña,65,97,-32
2001,15073,Ribeira,A Coruña,136,211,-75
2001,15075,Sada (A Coruña),A Coruña,115,67,48
2001,15077,Santa Comba,A Coruña,33,55,-22
2001,15078,Santiago de Compostela,A Coruña,861,978,-117
2001,15082,Teo,A Coruña,165,121,44
2001,16078,Cuenca,Cuenca,488,595,-107
2001,16203,Tarancón,Cuenca,127,239,-112
2001,17015,Banyoles,Girona,145,106,39
2001,17023,Blanes,Girona,1089,657,432
2001,17066,Figueres,Girona,444,395,49
2001,17079,Girona,Girona,1149,741,408
2001,17095,Lloret de Mar,Girona,730,498,232
2001,17114,Olot,Girona,319,216,103
2001,17117,Palafrugell,Girona,273,208,65
2001,17118,Palamós,Girona,278,166,112
2001,17147,Ripoll,Girona,124,120,4
2001,17152,Roses,Girona,246,204,42
2001,17155,Salt,Girona,280,228,52
2001,17160,Sant Feliu de Guíxols,Girona,291,226,65
2001,18003,Albolote,Granada,157,102,55
2001,18017,Almuñécar,Granada,223,169,54
2001,18021,Armilla,Granada,307,131,176
2001,18022,Atarfe,Granada,127,94,33
2001,18023,Baza,Granada,219,242,-23
2001,18087,Granada,Granada,2465,2845,-380
2001,18089,Guadix,Granada,260,238,22
2001,18102,Illora,Granada,64,97,-33
2001,18122,Loja,Granada,122,171,-49
2001,18127,Maracena,Granada,188,89,99
2001,18140,Motril,Granada,465,447,18
2001,18158,Pinos Puente,Granada,90,116,-26
2001,18173,Salobreña,Granada,126,107,19
2001,18175,Santa Fe,Granada,120,98,22
2001,18193,La Zubia,Granada,130,76,54
2001,19046,Azuqueca de Henares,Guadalajara,1080,590,490
2001,19130,Guadalajara,Guadalajara,1131,888,243
2001,20009,Andoain,Guipúzcoa,77,60,17
2001,20017,Azkoitia,Guipúzcoa,67,37,30
2001,20018,Azpeitia,Guipúzcoa,55,44,11
2001,20019,Beasain,Guipúzcoa,90,88,2
2001,20030,Eibar,Guipúzcoa,329,382,-53
2001,20032,Elgoibar,Guipúzcoa,87,78,9
2001,20036,Hondarribia,Guipúzcoa,138,103,35
2001,20040,Hernani,Guipúzcoa,64,121,-57
2001,20045,Irun,Guipúzcoa,558,641,-83
2001,20055,Arrasate/Mondragón,Guipúzcoa,201,269,-68
2001,20059,Oñati,Guipúzcoa,48,74,-26
2001,20064,Pasaia,Guipúzcoa,78,97,-19
2001,20067,Errenteria,Guipúzcoa,198,265,-67
2001,20069,Donostia/San Sebastián,Guipúzcoa,1522,1631,-109
2001,20071,Tolosa,Guipúzcoa,115,91,24
2001,20074,Bergara,Guipúzcoa,126,117,9
2001,20079,Zarautz,Guipúzcoa,206,174,32
2001,20080,Zumarraga,Guipúzcoa,80,88,-8
2001,20902,Lasarte-Oria,Guipúzcoa,138,172,-34
2001,21002,Aljaraque,Huelva,113,120,-7
2001,21005,Almonte,Huelva,262,199,63
2001,21010,Ayamonte,Huelva,206,130,76
2001,21013,Bollullos Par del Condado,Huelva,53,50,3
2001,21021,Cartaya,Huelva,140,117,23
2001,21035,Gibraleón,Huelva,55,76,-21
2001,21041,Huelva,Huelva,794,1130,-336
2001,21042,Isla Cristina,Huelva,214,187,27
2001,21044,Lepe,Huelva,235,165,70
2001,21050,Moguer,Huelva,221,174,47
2001,21060,Punta Umbría,Huelva,164,102,62
2001,21072,Valverde del Camino,Huelva,58,46,12
2001,22048,Barbastro,Huesca,152,125,27
2001,22112,Fraga,Huesca,167,173,-6
2001,22125,Huesca,Huesca,537,487,50
2001,22130,Jaca,Huesca,365,248,117
2001,22158,Monzón,Huesca,133,155,-22
2001,23002,Alcalá la Real,Jaén,185,267,-82
2001,23003,Alcaudete,Jaén,64,118,-54
2001,23005,Andújar,Jaén,311,426,-115
2001,23009,Baeza,Jaén,119,118,1
2001,23010,Bailén,Jaén,101,155,-54
2001,23024,La Carolina,Jaén,89,170,-81
2001,23050,Jaén,Jaén,747,934,-187
2001,23053,Jódar,Jaén,85,93,-8
2001,23055,Linares,Jaén,434,729,-295
2001,23060,Martos,Jaén,138,111,27
2001,23086,Torredelcampo,Jaén,44,74,-30
2001,23087,Torredonjimeno,Jaén,58,73,-15
2001,23092,Úbeda,Jaén,242,344,-102
2001,23095,Villacarrillo,Jaén,92,121,-29
2001,24008,Astorga,León,102,192,-90
2001,24010,La Bañeza,León,89,99,-10
2001,24014,Bembibre,León,71,144,-73
2001,24089,León,León,1196,1821,-625
2001,24115,Ponferrada,León,618,728,-110
2001,24142,San Andrés del Rabanedo,León,240,288,-48
2001,24202,Villablino,León,64,319,-255
2001,25040,Balaguer,Lleida,144,136,8
2001,25120,Lleida,Lleida,1154,1071,83
2001,25203,La Seu d'Urgell,Lleida,304,224,80
2001,25217,Tàrrega,Lleida,209,167,42
2001,26018,Arnedo,La Rioja,94,105,-11
2001,26036,Calahorra,La Rioja,475,365,110
2001,26089,Logroño,La Rioja,2022,1637,385
2001,27028,Lugo,Lugo,785,903,-118
2001,27031,Monforte de Lemos,Lugo,213,249,-36
2001,27057,Sarria,Lugo,98,81,17
2001,27065,Vilalba,Lugo,55,81,-26
2001,27066,Viveiro,Lugo,173,190,-17
2001,28005,Alcalá de Henares,Madrid,2294,2592,-298
2001,28006,Alcobendas,Madrid,657,855,-198
2001,28007,Alcorcón,Madrid,1021,1318,-297
2001,28009,Algete,Madrid,137,184,-47
2001,28013,Aranjuez,Madrid,637,510,127
2001,28014,Arganda del Rey,Madrid,236,230,6
2001,28022,Boadilla del Monte,Madrid,327,162,165
2001,28040,Ciempozuelos,Madrid,153,125,28
2001,28045,Colmenar Viejo,Madrid,295,301,-6
2001,28047,Collado Villalba,Madrid,553,552,1
2001,28049,Coslada,Madrid,347,601,-254
2001,28054,El Escorial,Madrid,119,87,32
2001,28058,Fuenlabrada,Madrid,838,1841,-1003
2001,28061,Galapagar,Madrid,212,277,-65
2001,28065,Getafe,Madrid,1027,1323,-296
2001,28068,Guadarrama,Madrid,122,144,-22
2001,28074,Leganés,Madrid,907,1483,-576
2001,28079,Madrid,Madrid,24686,30963,-6277
2001,28080,Majadahonda,Madrid,728,527,201
2001,28084,Mejorada del Campo,Madrid,157,146,11
2001,28092,Móstoles,Madrid,1386,2191,-805
2001,28096,Navalcarnero,Madrid,117,146,-29
2001,28106,Parla,Madrid,574,972,-398
2001,28113,Pinto,Madrid,363,268,95
2001,28115,Pozuelo de Alarcón,Madrid,559,518,41
2001,28123,Rivas-Vaciamadrid,Madrid,226,160,66
2001,28127,Las Rozas de Madrid,Madrid,864,552,312
2001,28130,San Fernando de Henares,Madrid,252,303,-51
2001,28131,San Lorenzo de El Escorial,Madrid,118,125,-7
2001,28132,San Martín de la Vega,Madrid,137,137,0
2001,28134,San Sebastián de los Reyes,Madrid,332,483,-151
2001,28148,Torrejón de Ardoz,Madrid,715,1137,-422
2001,28152,Torrelodones,Madrid,116,121,-5
2001,28161,Valdemoro,Madrid,841,481,360
2001,28176,Villanueva de la Cañada,Madrid,127,124,3
2001,28181,Villaviciosa de Odón,Madrid,133,154,-21
2001,28903,Tres Cantos,Madrid,465,429,36
2001,29007,Alhaurín de la Torre,Málaga,199,109,90
2001,29008,Alhaurín el Grande,Málaga,74,45,29
2001,29012,Álora,Málaga,65,35,30
2001,29015,Antequera,Málaga,284,216,68
2001,29025,Benalmádena,Málaga,596,331,265
2001,29038,Cártama,Málaga,63,47,16
2001,29042,Coín,Málaga,72,61,11
2001,29051,Estepona,Málaga,989,360,629
2001,29054,Fuengirola,Málaga,998,455,543
2001,29067,Málaga,Málaga,3982,3158,824
2001,29069,Marbella,Málaga,1946,1074,872
2001,29070,Mijas,Málaga,454,221,233
2001,29075,Nerja,Málaga,117,124,-7
2001,29082,Rincón de la Victoria,Málaga,150,194,-44
2001,29084,Ronda,Málaga,326,351,-25
2001,29091,Torrox,Málaga,50,50,0
2001,29094,Vélez-Málaga,Málaga,449,323,126
2001,29901,Torremolinos,Málaga,881,490,391
2001,30002,Abarán,Murcia,53,74,-21
2001,30003,Águilas,Murcia,407,343,64
2001,30005,Alcantarilla,Murcia,271,262,9
2001,30008,Alhama de Murcia,Murcia,103,95,8
2001,30009,Archena,Murcia,86,99,-13
2001,30012,Bullas,Murcia,52,63,-11
2001,30015,Caravaca de la Cruz,Murcia,244,218,26
2001,30016,Cartagena,Murcia,1637,1818,-181
2001,30017,Cehegín,Murcia,79,96,-17
2001,30019,Cieza (Murcia),Murcia,104,138,-34
2001,30021,Fuente Álamo de Murcia,Murcia,140,163,-23
2001,30022,Jumilla,Murcia,205,294,-89
2001,30024,Lorca,Murcia,624,1194,-570
2001,30026,Mazarrón,Murcia,398,487,-89
2001,30027,Molina de Segura,Murcia,493,325,168
2001,30029,Mula,Murcia,80,163,-83
2001,30030,Murcia,Murcia,2731,2568,163
2001,30033,Puerto Lumbreras,Murcia,119,89,30
2001,30035,San Javier,Murcia,638,487,151
2001,30036,San Pedro del Pinatar,Murcia,427,381,46
2001,30037,Torre-Pacheco,Murcia,319,442,-123
2001,30038,Las Torres de Cotillas,Murcia,85,102,-17
2001,30039,Totana,Murcia,182,193,-11
2001,30041,La Unión,Murcia,78,69,9
2001,30043,Yecla,Murcia,288,347,-59
2001,30901,Santomera,Murcia,144,135,9
2001,31060,Burlada/Burlata,Navarra,121,142,-21
2001,31097,Estella-Lizarra,Navarra,133,102,31
2001,31201,Pamplona/Iruña,Navarra,1790,1584,206
2001,31227,Tafalla,Navarra,45,113,-68
2001,31232,Tudela,Navarra,495,433,62
2001,31901,Barañain,Navarra,215,222,-7
2001,31907,Zizur Mayor/Zizur Nagusia,Navarra,106,72,34
2001,32009,O Barco de Valdeorras,Ourense,187,194,-7
2001,32019,O Carballiño,Ourense,127,131,-4
2001,32054,Ourense,Ourense,940,1357,-417
2001,32085,Verín,Ourense,226,282,-56
2001,33002,Aller,Asturias,43,74,-31
2001,33004,Avilés,Asturias,382,745,-363
2001,33011,Cangas del Narcea,Asturias,82,118,-36
2001,33014,Carreño,Asturias,43,64,-21
2001,33016,Castrillón,Asturias,117,141,-24
2001,33020,Corvera de Asturias,Asturias,66,125,-59
2001,33024,Gijón,Asturias,1780,2363,-583
2001,33025,Gozón,Asturias,55,67,-12
2001,33026,Grado,Asturias,42,29,13
2001,33031,Langreo,Asturias,131,294,-163
2001,33032,Laviana,Asturias,29,67,-38
2001,33033,Lena,Asturias,80,101,-21
2001,33034,Valdés,Asturias,56,76,-20
2001,33035,Llanera,Asturias,74,67,7
2001,33036,Llanes,Asturias,103,100,3
2001,33037,Mieres (Asturias),Asturias,191,325,-134
2001,33044,Oviedo,Asturias,1247,1684,-437
2001,33060,San Martín del Rey Aurelio,Asturias,67,120,-53
2001,33066,Siero,Asturias,232,294,-62
2001,33073,Tineo,Asturias,35,24,11
2001,33076,Villaviciosa,Asturias,72,68,4
2001,34120,Palencia,Palencia,745,937,-192
2001,35002,Agüimes,Las Palmas,268,197,71
2001,35004,Arrecife,Las Palmas,1225,948,277
2001,35006,Arucas,Las Palmas,98,129,-31
2001,35009,Gáldar,Las Palmas,40,41,-1
2001,35011,Ingenio,Las Palmas,129,111,18
2001,35012,Mogán,Las Palmas,235,209,26
2001,35014,La Oliva,Las Palmas,799,420,379
2001,35015,Pájara,Las Palmas,1535,1249,286
2001,35016,Las Palmas de Gran Canaria,Las Palmas,3918,3638,280
2001,35017,Puerto del Rosario,Las Palmas,78,564,-486
2001,35018,San Bartolomé,Las Palmas,629,516,113
2001,35019,San Bartolomé de Tirajana,Las Palmas,438,404,34
2001,35021,Santa Brígida,Las Palmas,108,89,19
2001,35022,Santa Lucía de Tirajana,Las Palmas,623,474,149
2001,35023,Santa María de Guía de Gran Canaria,Las Palmas,23,25,-2
2001,35024,Teguise,Las Palmas,303,252,51
2001,35026,Telde,Las Palmas,555,455,100
2001,35027,Teror,Las Palmas,26,35,-9
2001,35028,Tías,Las Palmas,467,446,21
2001,35030,Tuineje,Las Palmas,422,371,51
2001,36003,Baiona,Pontevedra,65,75,-10
2001,36004,Bueu,Pontevedra,56,89,-33
2001,36006,Cambados,Pontevedra,78,99,-21
2001,36008,Cangas,Pontevedra,138,165,-27
2001,36017,A Estrada,Pontevedra,142,250,-108
2001,36021,Gondomar,Pontevedra,44,51,-7
2001,36022,O Grove,Pontevedra,60,94,-34
2001,36024,Lalín,Pontevedra,143,135,8
2001,36026,Marín,Pontevedra,220,290,-70
2001,36029,Moaña,Pontevedra,82,91,-9
2001,36033,Mos,Pontevedra,40,50,-10
2001,36035,Nigrán,Pontevedra,122,112,10
2001,36038,Pontevedra,Pontevedra,775,829,-54
2001,36039,O Porriño,Pontevedra,106,89,17
2001,36041,Poio,Pontevedra,109,137,-28
2001,36042,Ponteareas,Pontevedra,186,218,-32
2001,36045,Redondela,Pontevedra,86,168,-82
2001,36051,Sanxenxo,Pontevedra,81,154,-73
2001,36054,Tomiño,Pontevedra,72,64,8
2001,36055,Tui,Pontevedra,122,131,-9
2001,36057,Vigo,Pontevedra,2148,2551,-403
2001,36060,Vilagarcía de Arousa,Pontevedra,328,363,-35
2001,36061,Vilanova de Arousa,Pontevedra,64,79,-15
2001,37046,Béjar,Salamanca,104,265,-161
2001,37107,Ciudad Rodrigo,Salamanca,149,222,-73
2001,37274,Salamanca,Salamanca,826,2102,-1276
2001,37294,Santa Marta de Tormes,Salamanca,237,191,46
2001,38001,Adeje,Santa Cruz de Tenerife,1030,528,502
2001,38006,Arona,Santa Cruz de Tenerife,1922,1152,770
2001,38011,Candelaria,Santa Cruz de Tenerife,318,140,178
2001,38019,Guía de Isora,Santa Cruz de Tenerife,230,162,68
2001,38020,Güímar,Santa Cruz de Tenerife,91,45,46
2001,38023,San Cristóbal de La Laguna,Santa Cruz de Tenerife,994,591,403
2001,38024,Los Llanos de Aridane,Santa Cruz de Tenerife,147,173,-26
2001,38026,La Orotava,Santa Cruz de Tenerife,152,114,38
2001,38028,Puerto de la Cruz,Santa Cruz de Tenerife,498,325,173
2001,38031,Los Realejos,Santa Cruz de Tenerife,101,91,10
2001,38032,El Rosario,Santa Cruz de Tenerife,216,141,75
2001,38037,Santa Cruz de la Palma,Santa Cruz de Tenerife,301,253,48
2001,38038,Santa Cruz de Tenerife,Santa Cruz de Tenerife,1556,1847,-291
2001,38039,Santa Úrsula,Santa Cruz de Tenerife,99,63,36
2001,38043,Tacoronte,Santa Cruz de Tenerife,91,79,12
2001,39008,El Astillero,Cantabria,82,81,1
2001,39016,Camargo,Cantabria,136,109,27
2001,39020,Castro-Urdiales,Cantabria,1929,702,1227
2001,39025,Los Corrales de Buelna,Cantabria,53,52,1
2001,39035,Laredo,Cantabria,266,197,69
2001,39052,Piélagos,Cantabria,129,90,39
2001,39059,Reinosa,Cantabria,63,100,-37
2001,39075,Santander,Cantabria,1561,1792,-231
2001,39079,Santoña,Cantabria,153,153,0
2001,39087,Torrelavega,Cantabria,329,331,-2
2001,40194,Segovia,Segovia,539,616,-77
2001,41004,Alcalá de Guadaíra,Sevilla,322,377,-55
2001,41007,La Algaba,Sevilla,37,64,-27
2001,41011,Arahal,Sevilla,61,68,-7
2001,41017,Bormujos,Sevilla,128,75,53
2001,41018,Brenes,Sevilla,57,99,-42
2001,41020,Las Cabezas de San Juan,Sevilla,102,114,-12
2001,41021,Camas,Sevilla,132,148,-16
2001,41024,Carmona,Sevilla,136,137,-1
2001,41029,Castilleja de la Cuesta,Sevilla,125,138,-13
2001,41034,Coria del Río,Sevilla,130,153,-23
2001,41038,Dos Hermanas,Sevilla,772,738,34
2001,41039,Écija,Sevilla,314,285,29
2001,41041,Estepa,Sevilla,102,72,30
2001,41047,Gines,Sevilla,141,101,40
2001,41053,Lebrija,Sevilla,180,184,-4
2001,41055,Lora del Río,Sevilla,146,209,-63
2001,41058,Mairena del Alcor,Sevilla,81,90,-9
2001,41059,Mairena del Aljarafe,Sevilla,369,347,22
2001,41060,Marchena,Sevilla,88,69,19
2001,41065,Morón de la Frontera,Sevilla,217,295,-78
2001,41068,Osuna,Sevilla,107,94,13
2001,41069,Los Palacios y Villafranca,Sevilla,181,153,28
2001,41075,Pilas,Sevilla,38,40,-2
2001,41077,La Puebla de Cazalla,Sevilla,63,163,-100
2001,41079,La Puebla del Río,Sevilla,57,53,4
2001,41081,La Rinconada,Sevilla,216,206,10
2001,41086,San Juan de Aznalfarache,Sevilla,192,185,7
2001,41087,Sanlúcar la Mayor,Sevilla,68,60,8
2001,41091,Sevilla,Sevilla,5146,5489,-343
2001,41093,Tomares,Sevilla,225,148,77
2001,41095,Utrera,Sevilla,294,357,-63
2001,41102,El Viso del Alcor,Sevilla,33,42,-9
2001,42173,Soria,Soria,435,518,-83
2001,43014,Amposta,Tarragona,199,134,65
2001,43037,Calafell,Tarragona,1294,501,793
2001,43038,Cambrils,Tarragona,672,368,304
2001,43123,Reus,Tarragona,1002,704,298
2001,43136,Sant Carles de la Ràpita,Tarragona,159,142,17
2001,43148,Tarragona,Tarragona,1389,894,495
2001,43153,Torredembarra,Tarragona,467,225,242
2001,43155,Tortosa,Tarragona,354,300,54
2001,43161,Valls,Tarragona,303,149,154
2001,43163,El Vendrell,Tarragona,1160,538,622
2001,43171,Vila-seca,Tarragona,359,146,213
2001,43901,Deltebre,Tarragona,60,45,15
2001,43905,Salou,Tarragona,714,314,400
2001,44013,Alcañiz,Teruel,148,137,11
2001,44216,Teruel,Teruel,462,422,40
2001,45053,Consuegra,Toledo,68,53,15
2001,45081,Illescas,Toledo,565,215,350
2001,45087,Madridejos,Toledo,59,77,-18
2001,45165,Talavera de la Reina,Toledo,991,1001,-10
2001,45168,Toledo,Toledo,1291,862,429
2001,45173,Torrijos,Toledo,112,98,14
2001,46005,Alaquàs,Valencia,191,94,97
2001,46007,Albal,Valencia,19,47,-28
2001,46013,Alboraya,Valencia,174,158,16
2001,46017,Alzira,Valencia,200,248,-48
2001,46019,L'Alcúdia,Valencia,34,46,-12
2001,46021,Aldaia,Valencia,154,128,26
2001,46022,Alfafar,Valencia,78,100,-22
2001,46029,Algemesí,Valencia,96,86,10
2001,46054,Benetússer,Valencia,65,36,29
2001,46060,Benifaió,Valencia,50,32,18
2001,46070,Bétera,Valencia,116,140,-24
2001,46078,Burjassot,Valencia,244,227,17
2001,46081,Canals,Valencia,2,69,-67
2001,46083,Carcaixent,Valencia,78,79,-1
2001,46085,Carlet,Valencia,52,58,-6
2001,46094,Catarroja,Valencia,136,98,38
2001,46102,Quart de Poblet,Valencia,169,130,39
2001,46105,Cullera,Valencia,73,138,-65
2001,46110,Xirivella,Valencia,196,129,67
2001,46111,Chiva,Valencia,93,67,26
2001,46116,L'Eliana,Valencia,118,83,35
2001,46131,Gandia,Valencia,895,559,336
2001,46135,Godella,Valencia,85,45,40
2001,46145,Xátiva,Valencia,118,155,-37
2001,46147,Llíria,Valencia,253,134,119
2001,46159,Manises,Valencia,115,97,18
2001,46164,Massamagrell,Valencia,72,63,9
2001,46169,Mislata,Valencia,343,290,53
2001,46171,Moncada,Valencia,109,62,47
2001,46181,Oliva,Valencia,129,158,-29
2001,46184,Ontinyent,Valencia,242,177,65
2001,46186,Paiporta,Valencia,137,81,56
2001,46190,Paterna,Valencia,341,286,55
2001,46194,Picassent,Valencia,101,62,39
2001,46202,La Pobla de Vallbona,Valencia,76,49,27
2001,46205,Puçol,Valencia,110,85,25
2001,46213,Requena,Valencia,106,104,2
2001,46214,Riba-roja de Túria,Valencia,96,69,27
2001,46220,Sagunto/Sagunt,Valencia,619,436,183
2001,46230,Silla,Valencia,41,61,-20
2001,46235,Sueca,Valencia,111,97,14
2001,46238,Tavernes de la Valldigna,Valencia,69,60,9
2001,46244,Torrent (Valencia),Valencia,496,398,98
2001,46249,Utiel,Valencia,59,68,-9
2001,46250,València,Valencia,7279,5904,1375
2001,47076,Laguna de Duero,Valladolid,250,146,104
2001,47085,Medina del Campo,Valladolid,191,252,-61
2001,47186,Valladolid,Valladolid,3099,3401,-302
2001,48003,Amorebieta-Etxano,Vizcaya,80,119,-39
2001,48011,Arrigorriaga,Vizcaya,95,102,-7
2001,48013,Barakaldo,Vizcaya,554,1038,-484
2001,48015,Basauri,Vizcaya,120,495,-375
2001,48017,Bermeo,Vizcaya,94,105,-11
2001,48020,Bilbao,Vizcaya,3053,3878,-825
2001,48027,Durango,Vizcaya,192,208,-16
2001,48034,Ermua,Vizcaya,183,318,-135
2001,48036,Galdakao,Vizcaya,130,227,-97
2001,48044,Getxo,Vizcaya,605,963,-358
2001,48046,Gernika-Lumo,Vizcaya,58,98,-40
2001,48054,Leioa,Vizcaya,174,267,-93
2001,48069,Mungia,Vizcaya,77,85,-8
2001,48078,Portugalete,Vizcaya,287,505,-218
2001,48080,Valle de Trápaga-Trapagaran,Vizcaya,58,113,-55
2001,48082,Santurtzi,Vizcaya,296,549,-253
2001,48084,Sestao,Vizcaya,206,376,-170
2001,48085,Sopela,Vizcaya,60,90,-30
2001,48902,Erandio,Vizcaya,169,221,-52
2001,49021,Benavente,Zamora,218,239,-21
2001,49275,Zamora,Zamora,616,861,-245
2001,50067,Calatayud,Zaragoza,271,280,-9
2001,50251,Tarazona,Zaragoza,123,115,8
2001,50272,Utebo,Zaragoza,186,105,81
2001,50297,Zaragoza,Zaragoza,4834,5290,-456
2001,51001,Ceuta,Ceuta,1822,2141,-319
2001,52001,Melilla,Melilla,1560,2183,-623
2002,01036,Laudio/Llodio,Álava,210,280,-70
2002,01059,Vitoria-Gasteiz,Álava,3642,3085,557
2002,02003,Albacete,Albacete,2007,2323,-316
2002,02009,Almansa,Albacete,375,293,82
2002,02037,Hellín,Albacete,397,548,-151
2002,02069,La Roda,Albacete,252,232,20
2002,02081,Villarrobledo,Albacete,313,366,-53
2002,03009,Alcoy/Alcoi,Alicante,472,483,-11
2002,03011,L'Alfàs del Pi,Alicante,273,175,98
2002,03014,Alicante/Alacant,Alicante,6198,3981,2217
2002,03015,Almoradí,Alicante,156,110,46
2002,03018,Altea,Alicante,395,235,160
2002,03019,Aspe,Alicante,144,69,75
2002,03031,Benidorm,Alicante,2375,1557,818
2002,03041,Benissa,Alicante,139,131,8
2002,03047,Calp,Alicante,432,282,150
2002,03049,Callosa de Segura,Alicante,125,117,8
2002,03050,El Campello,Alicante,428,301,127
2002,03056,Cocentaina,Alicante,69,58,11
2002,03059,Crevillent,Alicante,204,170,34
2002,03063,Dénia,Alicante,870,568,302
2002,03065,Elche/Elx,Alicante,2093,1323,770
2002,03066,Elda,Alicante,419,404,15
2002,03076,Guardamar del Segura,Alicante,369,227,142
2002,03079,Ibi,Alicante,242,144,98
2002,03082,Jávea/Xàbia,Alicante,435,335,100
2002,03089,Monóvar/Monòver,Alicante,122,51,71
2002,03090,Mutxamel,Alicante,210,147,63
2002,03093,Novelda,Alicante,192,127,65
2002,03094,La Nucia,Alicante,218,113,105
2002,03099,Orihuela,Alicante,1183,986,197
2002,03102,Pego,Alicante,114,107,7
2002,03104,Petrer,Alicante,222,168,54
2002,03119,Sant Joan d'Alacant,Alicante,343,206,137
2002,03121,Santa Pola,Alicante,626,330,296
2002,03122,San Vicente del Raspeig/Sant Vicent del Raspeig,Alicante,480,224,256
2002,03128,Teulada,Alicante,179,109,70
2002,03133,Torrevieja,Alicante,3805,2426,1379
2002,03139,Villajoyosa/La Vila Joiosa,Alicante,517,270,247
2002,03140,Villena,Alicante,368,270,98
2002,03902,Pilar de la Horadada,Alicante,594,560,34
2002,04003,Adra,Almería,64,257,-193
2002,04013,Almería,Almería,1944,2191,-247
2002,04029,Berja,Almería,105,130,-25
2002,04035,Cuevas del Almanzora,Almería,145,197,-52
2002,04053,Huércal-Overa,Almería,215,213,2
2002,04066,Níjar,Almería,223,499,-276
2002,04079,Roquetas de Mar,Almería,1207,1809,-602
2002,04102,Vícar,Almería,198,486,-288
2002,04902,El Ejido,Almería,838,1531,-693
2002,05019,Ávila,Ávila,785,821,-36
2002,06011,Almendralejo,Badajoz,297,284,13
2002,06015,Badajoz,Badajoz,1328,1801,-473
2002,06044,Don Benito,Badajoz,408,348,60
2002,06083,Mérida,Badajoz,647,700,-53
2002,06088,Montijo,Badajoz,154,163,-9
2002,06095,Olivenza,Badajoz,141,95,46
2002,06149,Villafranca de los Barros,Badajoz,105,116,-11
2002,06153,Villanueva de la Serena,Badajoz,294,329,-35
2002,06158,Zafra,Badajoz,122,148,-26
2002,07003,Alcúdia,Baleares,582,504,78
2002,07011,Calvià,Baleares,1110,1058,52
2002,07015,Ciutadella de Menorca,Baleares,942,515,427
2002,07022,Felanitx,Baleares,240,243,-3
2002,07026,Eivissa,Baleares,2097,1099,998
2002,07027,Inca,Baleares,431,382,49
2002,07031,Llucmajor,Baleares,539,498,41
2002,07032,Maó-Mahón,Baleares,1027,602,425
2002,07033,Manacor,Baleares,689,611,78
2002,07036,Marratxí,Baleares,191,154,37
2002,07040,Palma,Baleares,9124,7681,1443
2002,07042,Pollença,Baleares,311,245,66
2002,07044,Sa Pobla,Baleares,105,97,8
2002,07046,Sant Antoni de Portmany,Baleares,575,338,237
2002,07048,Sant Josep de sa Talaia,Baleares,656,324,332
2002,07054,Santa Eulària des Riu,Baleares,941,662,279
2002,07057,Santanyí,Baleares,246,252,-6
2002,07061,Sóller,Baleares,130,83,47
2002,07062,Son Servera,Baleares,345,389,-44
2002,08006,Arenys de Mar,Barcelona,151,123,28
2002,08009,Argentona,Barcelona,49,84,-35
2002,08015,Badalona,Barcelona,1374,2259,-885
2002,08019,Barcelona,Barcelona,14907,19769,-4862
2002,08022,Berga,Barcelona,107,141,-34
2002,08033,Caldes de Montbui,Barcelona,95,89,6
2002,08035,Calella,Barcelona,228,217,11
2002,08040,Canet de Mar,Barcelona,95,88,7
2002,08041,Canovelles,Barcelona,133,150,-17
2002,08046,Cardedeu,Barcelona,104,114,-10
2002,08051,Castellar del Vallès,Barcelona,101,137,-36
2002,08056,Castelldefels,Barcelona,756,904,-148
2002,08072,Corbera de Llobregat,Barcelona,63,100,-37
2002,08073,Cornellà de Llobregat,Barcelona,499,939,-440
2002,08076,Esparreguera,Barcelona,168,205,-37
2002,08077,Esplugues de Llobregat,Barcelona,293,532,-239
2002,08086,Les Franqueses del Vallès,Barcelona,111,121,-10
2002,08088,La Garriga,Barcelona,89,102,-13
2002,08089,Gavà,Barcelona,359,518,-159
2002,08096,Granollers,Barcelona,566,534,32
2002,08101,L'Hospitalet de Llobregat,Barcelona,2056,2866,-810
2002,08102,Igualada,Barcelona,318,306,12
2002,08105,La Llagosta,Barcelona,127,89,38
2002,08107,Lliçà d'Amunt,Barcelona,63,64,-1
2002,08110,Malgrat de Mar,Barcelona,212,223,-11
2002,08112,Manlleu,Barcelona,163,153,10
2002,08113,Manresa,Barcelona,550,519,31
2002,08114,Martorell,Barcelona,292,289,3
2002,08118,El Masnou,Barcelona,149,219,-70
2002,08121,Mataró,Barcelona,790,1119,-329
2002,08123,Molins de Rei,Barcelona,113,170,-57
2002,08124,Mollet del Vallès,Barcelona,490,558,-68
2002,08125,Montcada i Reixac,Barcelona,210,313,-103
2002,08136,Montornès del Vallès,Barcelona,132,146,-14
2002,08147,Olesa de Montserrat,Barcelona,142,157,-15
2002,08156,Palau-solità i Plegamans,Barcelona,60,106,-46
2002,08159,Parets del Vallès,Barcelona,102,108,-6
2002,08161,Piera,Barcelona,60,107,-47
2002,08163,Pineda de Mar,Barcelona,305,345,-40
2002,08169,El Prat de Llobregat,Barcelona,470,738,-268
2002,08172,Premià de Mar,Barcelona,217,374,-157
2002,08180,Ripollet,Barcelona,232,343,-111
2002,08184,Rubí,Barcelona,494,725,-231
2002,08187,Sabadell,Barcelona,1427,1668,-241
2002,08194,Sant Adrià de Besòs,Barcelona,221,273,-52
2002,08196,Sant Andreu de la Barca,Barcelona,203,274,-71
2002,08200,Sant Boi de Llobregat,Barcelona,592,824,-232
2002,08202,Sant Celoni,Barcelona,181,221,-40
2002,08205,Sant Cugat del Vallès,Barcelona,594,587,7
2002,08211,Sant Feliu de Llobregat,Barcelona,323,451,-128
2002,08217,Sant Joan Despí,Barcelona,217,311,-94
2002,08219,Vilassar de Mar,Barcelona,122,164,-42
2002,08221,Sant Just Desvern,Barcelona,105,123,-18
2002,08231,Sant Pere de Ribes,Barcelona,240,307,-67
2002,08238,Sant Quirze del Vallès,Barcelona,83,126,-43
2002,08240,Sant Sadurní d'Anoia,Barcelona,89,82,7
2002,08245,Santa Coloma de Gramenet,Barcelona,922,1412,-490
2002,08252,Barberà del Vallès,Barcelona,187,284,-97
2002,08260,Santa Perpètua de Mogoda,Barcelona,125,229,-104
2002,08263,Sant Vicenç dels Horts,Barcelona,165,256,-91
2002,08266,Cerdanyola del Vallès,Barcelona,427,580,-153
2002,08270,Sitges,Barcelona,285,248,37
2002,08279,Terrassa,Barcelona,1456,1593,-137
2002,08284,Tordera,Barcelona,242,216,26
2002,08285,Torelló,Barcelona,51,90,-39
2002,08295,Vallirana,Barcelona,68,116,-48
2002,08298,Vic,Barcelona,470,333,137
2002,08301,Viladecans,Barcelona,422,801,-379
2002,08302,Vilanova del Camí,Barcelona,83,94,-11
2002,08305,Vilafranca del Penedès,Barcelona,375,367,8
2002,08307,Vilanova i la Geltrú,Barcelona,671,702,-31
2002,08904,Badia del Vallès,Barcelona,110,212,-102
2002,09018,Aranda de Duero,Burgos,393,522,-129
2002,09059,Burgos,Burgos,1761,2329,-568
2002,09219,Miranda de Ebro,Burgos,705,787,-82
2002,10037,Cáceres,Cáceres,1609,1263,346
2002,10067,Coria,Cáceres,172,194,-22
2002,10131,Navalmoral de la Mata,Cáceres,262,493,-231
2002,10148,Plasencia,Cáceres,542,593,-51
2002,10180,Talayuela,Cáceres,145,703,-558
2002,11004,Algeciras,Cádiz,1698,1463,235
2002,11006,Arcos de la Frontera,Cádiz,359,254,105
2002,11007,Barbate,Cádiz,297,340,-43
2002,11008,Los Barrios,Cádiz,289,193,96
2002,11012,Cádiz,Cádiz,1271,1776,-505
2002,11014,Conil de la Frontera,Cádiz,170,110,60
2002,11015,Chiclana de la Frontera,Cádiz,978,631,347
2002,11016,Chipiona,Cádiz,190,152,38
2002,11020,Jerez de la Frontera,Cádiz,2932,1958,974
2002,11022,La Línea de la Concepción,Cádiz,698,664,34
2002,11023,Medina-Sidonia,Cádiz,66,52,14
2002,11027,El Puerto de Santa María,Cádiz,1220,1119,101
2002,11028,Puerto Real,Cádiz,305,331,-26
2002,11030,Rota,Cádiz,484,348,136
2002,11031,San Fernando,Cádiz,941,1225,-284
2002,11032,Sanlúcar de Barrameda,Cádiz,448,383,65
2002,11033,San Roque,Cádiz,424,299,125
2002,11035,Tarifa,Cádiz,271,185,86
2002,11038,Ubrique,Cádiz,71,183,-112
2002,11039,Vejer de la Frontera,Cádiz,114,104,10
2002,11041,Villamartín,Cádiz,157,163,-6
2002,12009,Almassora,Castellón,163,121,42
2002,12027,Benicarló,Castellón,424,421,3
2002,12028,Benicasim/Benicàssim,Castellón,386,272,114
2002,12032,Borriana/Burriana,Castellón,511,245,266
2002,12040,Castellón de la Plana/Castelló de la Plana,Castellón,2464,1959,505
2002,12082,Nules,Castellón,92,100,-8
2002,12084,Onda,Castellón,299,145,154
2002,12126,La Vall d'Uixó,Castellón,321,229,92
2002,12135,Vila-real,Castellón,675,430,245
2002,12138,Vinaròs,Castellón,536,432,104
2002,13005,Alcázar de San Juan,Ciudad Real,691,446,245
2002,13023,Bolaños de Calatrava,Ciudad Real,149,178,-29
2002,13028,Campo de Criptana,Ciudad Real,133,127,6
2002,13034,Ciudad Real,Ciudad Real,901,1026,-125
2002,13039,Daimiel,Ciudad Real,147,138,9
2002,13053,Manzanares,Ciudad Real,302,304,-2
2002,13056,Miguelturra,Ciudad Real,102,80,22
2002,13071,Puertollano,Ciudad Real,614,958,-344
2002,13078,Socuéllamos,Ciudad Real,182,233,-51
2002,13079,La Solana,Ciudad Real,116,150,-34
2002,13082,Tomelloso,Ciudad Real,249,330,-81
2002,13087,Valdepeñas,Ciudad Real,302,389,-87
2002,14002,Aguilar de la Frontera,Córdoba,80,97,-17
2002,14007,Baena,Córdoba,186,215,-29
2002,14013,Cabra,Córdoba,209,152,57
2002,14017,La Carlota,Córdoba,161,124,37
2002,14021,Córdoba,Córdoba,2845,3933,-1088
2002,14038,Lucena,Córdoba,519,383,136
2002,14042,Montilla,Córdoba,126,113,13
2002,14049,Palma del Río,Córdoba,362,311,51
2002,14052,Peñarroya-Pueblonuevo,Córdoba,208,220,-12
2002,14054,Pozoblanco,Córdoba,136,145,-9
2002,14055,Priego de Córdoba,Córdoba,298,281,17
2002,14056,Puente Genil,Córdoba,328,359,-31
2002,14058,Rute,Córdoba,140,106,34
2002,15002,Ames,A Coruña,346,274,72
2002,15005,Arteixo,A Coruña,175,215,-40
2002,15009,Betanzos,A Coruña,78,104,-26
2002,15011,Boiro,A Coruña,137,148,-11
2002,15017,Cambre,A Coruña,194,124,70
2002,15019,Carballo,A Coruña,144,151,-7
2002,15030,A Coruña,A Coruña,2853,2749,104
2002,15031,Culleredo,A Coruña,289,190,99
2002,15035,Fene,A Coruña,69,93,-24
2002,15036,Ferrol,A Coruña,922,1024,-102
2002,15041,A Laracha,A Coruña,40,38,2
2002,15053,Muros,A Coruña,79,86,-7
2002,15054,Narón,A Coruña,206,219,-13
2002,15057,Noia,A Coruña,158,149,9
2002,15058,Oleiros,A Coruña,364,291,73
2002,15059,Ordes,A Coruña,85,61,24
2002,15067,A Pobra do Caramiñal,A Coruña,68,54,14
2002,15070,As Pontes de García Rodríguez,A Coruña,76,130,-54
2002,15071,Porto do Son,A Coruña,103,87,16
2002,15072,Rianxo,A Coruña,59,85,-26
2002,15073,Ribeira,A Coruña,247,215,32
2002,15075,Sada (A Coruña),A Coruña,122,99,23
2002,15077,Santa Comba,A Coruña,38,67,-29
2002,15078,Santiago de Compostela,A Coruña,1100,1196,-96
2002,15082,Teo,A Coruña,183,162,21
2002,16078,Cuenca,Cuenca,656,761,-105
2002,16203,Tarancón,Cuenca,247,303,-56
2002,17015,Banyoles,Girona,200,164,36
2002,17023,Blanes,Girona,1496,980,516
2002,17066,Figueres,Girona,636,421,215
2002,17079,Girona,Girona,1848,1091,757
2002,17095,Lloret de Mar,Girona,996,736,260
2002,17114,Olot,Girona,511,303,208
2002,17117,Palafrugell,Girona,387,241,146
2002,17118,Palamós,Girona,364,237,127
2002,17147,Ripoll,Girona,168,176,-8
2002,17152,Roses,Girona,282,215,67
2002,17155,Salt,Girona,573,290,283
2002,17160,Sant Feliu de Guíxols,Girona,445,222,223
2002,18003,Albolote,Granada,176,134,42
2002,18017,Almuñécar,Granada,498,268,230
2002,18021,Armilla,Granada,314,220,94
2002,18022,Atarfe,Granada,142,120,22
2002,18023,Baza,Granada,369,348,21
2002,18087,Granada,Granada,3201,3794,-593
2002,18089,Guadix,Granada,375,266,109
2002,18102,Illora,Granada,72,81,-9
2002,18122,Loja,Granada,218,251,-33
2002,18127,Maracena,Granada,193,110,83
2002,18140,Motril,Granada,658,645,13
2002,18158,Pinos Puente,Granada,97,139,-42
2002,18173,Salobreña,Granada,191,120,71
2002,18175,Santa Fe,Granada,168,121,47
2002,18193,La Zubia,Granada,201,153,48
2002,19046,Azuqueca de Henares,Guadalajara,1335,745,590
2002,19130,Guadalajara,Guadalajara,1518,1206,312
2002,20009,Andoain,Guipúzcoa,66,121,-55
2002,20017,Azkoitia,Guipúzcoa,57,54,3
2002,20018,Azpeitia,Guipúzcoa,69,52,17
2002,20019,Beasain,Guipúzcoa,124,114,10
2002,20030,Eibar,Guipúzcoa,302,419,-117
2002,20032,Elgoibar,Guipúzcoa,92,77,15
2002,20036,Hondarribia,Guipúzcoa,160,158,2
2002,20040,Hernani,Guipúzcoa,115,128,-13
2002,20045,Irun,Guipúzcoa,566,736,-170
2002,20055,Arrasate/Mondragón,Guipúzcoa,210,326,-116
2002,20059,Oñati,Guipúzcoa,71,75,-4
2002,20064,Pasaia,Guipúzcoa,92,130,-38
2002,20067,Errenteria,Guipúzcoa,235,362,-127
2002,20069,Donostia/San Sebastián,Guipúzcoa,1664,1972,-308
2002,20071,Tolosa,Guipúzcoa,117,107,10
2002,20074,Bergara,Guipúzcoa,114,153,-39
2002,20079,Zarautz,Guipúzcoa,187,187,0
2002,20080,Zumarraga,Guipúzcoa,62,95,-33
2002,20902,Lasarte-Oria,Guipúzcoa,197,174,23
2002,21002,Aljaraque,Huelva,266,169,97
2002,21005,Almonte,Huelva,272,328,-56
2002,21010,Ayamonte,Huelva,282,181,101
2002,21013,Bollullos Par del Condado,Huelva,67,94,-27
2002,21021,Cartaya,Huelva,263,237,26
2002,21035,Gibraleón,Huelva,77,77,0
2002,21041,Huelva,Huelva,1231,1495,-264
2002,21042,Isla Cristina,Huelva,288,196,92
2002,21044,Lepe,Huelva,383,366,17
2002,21050,Moguer,Huelva,267,281,-14
2002,21060,Punta Umbría,Huelva,183,139,44
2002,21072,Valverde del Camino,Huelva,40,94,-54
2002,22048,Barbastro,Huesca,243,186,57
2002,22112,Fraga,Huesca,243,250,-7
2002,22125,Huesca,Huesca,745,674,71
2002,22130,Jaca,Huesca,406,306,100
2002,22158,Monzón,Huesca,182,199,-17
2002,23002,Alcalá la Real,Jaén,352,313,39
2002,23003,Alcaudete,Jaén,122,125,-3
2002,23005,Andújar,Jaén,344,499,-155
2002,23009,Baeza,Jaén,188,195,-7
2002,23010,Bailén,Jaén,141,154,-13
2002,23024,La Carolina,Jaén,213,195,18
2002,23050,Jaén,Jaén,955,1336,-381
2002,23053,Jódar,Jaén,66,138,-72
2002,23055,Linares,Jaén,797,875,-78
2002,23060,Martos,Jaén,214,158,56
2002,23086,Torredelcampo,Jaén,107,78,29
2002,23087,Torredonjimeno,Jaén,88,121,-33
2002,23092,Úbeda,Jaén,403,447,-44
2002,23095,Villacarrillo,Jaén,142,180,-38
2002,24008,Astorga,León,136,183,-47
2002,24010,La Bañeza,León,90,182,-92
2002,24014,Bembibre,León,96,211,-115
2002,24089,León,León,1819,2305,-486
2002,24115,Ponferrada,León,792,864,-72
2002,24142,San Andrés del Rabanedo,León,437,311,126
2002,24202,Villablino,León,71,319,-248
2002,24222,Villaquilambre,León,176,111,65
2002,25040,Balaguer,Lleida,230,192,38
2002,25120,Lleida,Lleida,1712,1606,106
2002,25137,Mollerussa,Lleida,169,146,23
2002,25203,La Seu d'Urgell,Lleida,393,291,102
2002,25217,Tàrrega,Lleida,271,264,7
2002,26018,Arnedo,La Rioja,144,204,-60
2002,26036,Calahorra,La Rioja,524,473,51
2002,26089,Logroño,La Rioja,2306,2261,45
2002,27028,Lugo,Lugo,968,1104,-136
2002,27031,Monforte de Lemos,Lugo,170,291,-121
2002,27057,Sarria,Lugo,109,125,-16
2002,27065,Vilalba,Lugo,92,114,-22
2002,27066,Viveiro,Lugo,181,211,-30
2002,28005,Alcalá de Henares,Madrid,2826,3872,-1046
2002,28006,Alcobendas,Madrid,1055,1174,-119
2002,28007,Alcorcón,Madrid,1233,1859,-626
2002,28009,Algete,Madrid,158,261,-103
2002,28013,Aranjuez,Madrid,876,669,207
2002,28014,Arganda del Rey,Madrid,339,411,-72
2002,28022,Boadilla del Monte,Madrid,407,276,131
2002,28040,Ciempozuelos,Madrid,196,191,5
2002,28045,Colmenar Viejo,Madrid,394,419,-25
2002,28047,Collado Villalba,Madrid,645,740,-95
2002,28049,Coslada,Madrid,399,951,-552
2002,28054,El Escorial,Madrid,121,137,-16
2002,28058,Fuenlabrada,Madrid,1496,2835,-1339
2002,28061,Galapagar,Madrid,336,441,-105
2002,28065,Getafe,Madrid,1277,1948,-671
2002,28068,Guadarrama,Madrid,170,177,-7
2002,28073,Humanes de Madrid,Madrid,170,241,-71
2002,28074,Leganés,Madrid,1275,2068,-793
2002,28079,Madrid,Madrid,33943,44444,-10501
2002,28080,Majadahonda,Madrid,878,699,179
2002,28084,Mejorada del Campo,Madrid,151,241,-90
2002,28092,Móstoles,Madrid,1531,2952,-1421
2002,28096,Navalcarnero,Madrid,176,221,-45
2002,28106,Parla,Madrid,995,1484,-489
2002,28113,Pinto,Madrid,406,380,26
2002,28115,Pozuelo de Alarcón,Madrid,763,715,48
2002,28123,Rivas-Vaciamadrid,Madrid,299,268,31
2002,28127,Las Rozas de Madrid,Madrid,894,850,44
2002,28130,San Fernando de Henares,Madrid,251,403,-152
2002,28131,San Lorenzo de El Escorial,Madrid,201,178,23
2002,28132,San Martín de la Vega,Madrid,166,275,-109
2002,28134,San Sebastián de los Reyes,Madrid,487,682,-195
2002,28148,Torrejón de Ardoz,Madrid,1110,1604,-494
2002,28152,Torrelodones,Madrid,211,162,49
2002,28161,Valdemoro,Madrid,909,697,212
2002,28176,Villanueva de la Cañada,Madrid,154,192,-38
2002,28181,Villaviciosa de Odón,Madrid,203,205,-2
2002,28903,Tres Cantos,Madrid,476,462,14
2002,29007,Alhaurín de la Torre,Málaga,279,128,151
2002,29008,Alhaurín el Grande,Málaga,109,53,56
2002,29012,Álora,Málaga,85,35,50
2002,29015,Antequera,Málaga,364,259,105
2002,29025,Benalmádena,Málaga,787,463,324
2002,29038,Cártama,Málaga,79,40,39
2002,29042,Coín,Málaga,111,92,19
2002,29051,Estepona,Málaga,1460,688,772
2002,29054,Fuengirola,Málaga,1279,720,559
2002,29067,Málaga,Málaga,4429,4373,56
2002,29069,Marbella,Málaga,3140,1526,1614
2002,29070,Mijas,Málaga,705,386,319
2002,29075,Nerja,Málaga,273,128,145
2002,29082,Rincón de la Victoria,Málaga,545,229,316
2002,29084,Ronda,Málaga,441,435,6
2002,29091,Torrox,Málaga,129,65,64
2002,29094,Vélez-Málaga,Málaga,786,415,371
2002,29901,Torremolinos,Málaga,1392,734,658
2002,30002,Abarán,Murcia,80,80,0
2002,30003,Águilas,Murcia,561,423,138
2002,30005,Alcantarilla,Murcia,429,303,126
2002,30008,Alhama de Murcia,Murcia,173,132,41
2002,30009,Archena,Murcia,190,117,73
2002,30012,Bullas,Murcia,75,75,0
2002,30015,Caravaca de la Cruz,Murcia,275,318,-43
2002,30016,Cartagena,Murcia,2462,2473,-11
2002,30017,Cehegín,Murcia,128,105,23
2002,30019,Cieza (Murcia),Murcia,182,262,-80
2002,30021,Fuente Álamo de Murcia,Murcia,159,210,-51
2002,30022,Jumilla,Murcia,262,444,-182
2002,30024,Lorca,Murcia,1112,1399,-287
2002,30026,Mazarrón,Murcia,676,590,86
2002,30027,Molina de Segura,Murcia,588,509,79
2002,30029,Mula,Murcia,184,181,3
2002,30030,Murcia,Murcia,4119,3708,411
2002,30033,Puerto Lumbreras,Murcia,164,135,29
2002,30035,San Javier,Murcia,890,621,269
2002,30036,San Pedro del Pinatar,Murcia,611,434,177
2002,30037,Torre-Pacheco,Murcia,511,600,-89
2002,30038,Las Torres de Cotillas,Murcia,183,127,56
2002,30039,Totana,Murcia,254,271,-17
2002,30041,La Unión,Murcia,109,136,-27
2002,30043,Yecla,Murcia,440,402,38
2002,30901,Santomera,Murcia,121,141,-20
2002,31060,Burlada/Burlata,Navarra,164,174,-10
2002,31097,Estella-Lizarra,Navarra,159,160,-1
2002,31201,Pamplona/Iruña,Navarra,2229,2270,-41
2002,31227,Tafalla,Navarra,85,96,-11
2002,31232,Tudela,Navarra,654,649,5
2002,31901,Barañain,Navarra,295,274,21
2002,31907,Zizur Mayor/Zizur Nagusia,Navarra,127,117,10
2002,32009,O Barco de Valdeorras,Ourense,206,259,-53
2002,32019,O Carballiño,Ourense,126,163,-37
2002,32054,Ourense,Ourense,985,1690,-705
2002,32085,Verín,Ourense,311,329,-18
2002,33002,Aller,Asturias,36,98,-62
2002,33004,Avilés,Asturias,547,765,-218
2002,33011,Cangas del Narcea,Asturias,72,121,-49
2002,33014,Carreño,Asturias,51,58,-7
2002,33016,Castrillón,Asturias,137,151,-14
2002,33020,Corvera de Asturias,Asturias,112,136,-24
2002,33024,Gijón,Asturias,2216,2850,-634
2002,33025,Gozón,Asturias,66,60,6
2002,33026,Grado,Asturias,34,55,-21
2002,33031,Langreo,Asturias,210,380,-170
2002,33032,Laviana,Asturias,40,57,-17
2002,33033,Lena,Asturias,65,109,-44
2002,33034,Valdés,Asturias,83,117,-34
2002,33035,Llanera,Asturias,75,83,-8
2002,33036,Llanes,Asturias,110,140,-30
2002,33037,Mieres (Asturias),Asturias,200,381,-181
2002,33044,Oviedo,Asturias,1768,2218,-450
2002,33060,San Martín del Rey Aurelio,Asturias,69,145,-76
2002,33066,Siero,Asturias,274,352,-78
2002,33073,Tineo,Asturias,38,55,-17
2002,33076,Villaviciosa,Asturias,88,84,4
2002,34120,Palencia,Palencia,1019,1294,-275
2002,35002,Agüimes,Las Palmas,290,297,-7
2002,35004,Arrecife,Las Palmas,1353,1554,-201
2002,35006,Arucas,Las Palmas,132,187,-55
2002,35009,Gáldar,Las Palmas,74,72,2
2002,35011,Ingenio,Las Palmas,121,130,-9
2002,35012,Mogán,Las Palmas,213,301,-88
2002,35014,La Oliva,Las Palmas,783,604,179
2002,35015,Pájara,Las Palmas,1448,1412,36
2002,35016,Las Palmas de Gran Canaria,Las Palmas,5196,4787,409
2002,35017,Puerto del Rosario,Las Palmas,20,661,-641
2002,35018,San Bartolomé,Las Palmas,644,595,49
2002,35019,San Bartolomé de Tirajana,Las Palmas,697,603,94
2002,35021,Santa Brígida,Las Palmas,85,148,-63
2002,35022,Santa Lucía de Tirajana,Las Palmas,780,698,82
2002,35023,Santa María de Guía de Gran Canaria,Las Palmas,34,64,-30
2002,35024,Teguise,Las Palmas,335,308,27
2002,35026,Telde,Las Palmas,826,732,94
2002,35027,Teror,Las Palmas,21,42,-21
2002,35028,Tías,Las Palmas,429,568,-139
2002,35030,Tuineje,Las Palmas,455,431,24
2002,36003,Baiona,Pontevedra,77,88,-11
2002,36004,Bueu,Pontevedra,39,84,-45
2002,36006,Cambados,Pontevedra,98,105,-7
2002,36008,Cangas,Pontevedra,180,224,-44
2002,36017,A Estrada,Pontevedra,201,229,-28
2002,36021,Gondomar,Pontevedra,42,67,-25
2002,36022,O Grove,Pontevedra,85,136,-51
2002,36023,A Guarda,Pontevedra,83,70,13
2002,36024,Lalín,Pontevedra,212,221,-9
2002,36026,Marín,Pontevedra,217,345,-128
2002,36029,Moaña,Pontevedra,86,120,-34
2002,36033,Mos,Pontevedra,98,60,38
2002,36035,Nigrán,Pontevedra,131,92,39
2002,36038,Pontevedra,Pontevedra,867,1049,-182
2002,36039,O Porriño,Pontevedra,155,147,8
2002,36041,Poio,Pontevedra,135,147,-12
2002,36042,Ponteareas,Pontevedra,229,215,14
2002,36045,Redondela,Pontevedra,161,150,11
2002,36051,Sanxenxo,Pontevedra,137,145,-8
2002,36054,Tomiño,Pontevedra,78,63,15
2002,36055,Tui,Pontevedra,113,169,-56
2002,36057,Vigo,Pontevedra,2665,3289,-624
2002,36060,Vilagarcía de Arousa,Pontevedra,375,477,-102
2002,36061,Vilanova de Arousa,Pontevedra,75,92,-17
2002,37046,Béjar,Salamanca,178,264,-86
2002,37107,Ciudad Rodrigo,Salamanca,143,221,-78
2002,37274,Salamanca,Salamanca,2183,2710,-527
2002,37294,Santa Marta de Tormes,Salamanca,262,207,55
2002,38001,Adeje,Santa Cruz de Tenerife,1160,879,281
2002,38006,Arona,Santa Cruz de Tenerife,2117,1857,260
2002,38011,Candelaria,Santa Cruz de Tenerife,485,280,205
2002,38017,Granadilla de Abona,Santa Cruz de Tenerife,693,656,37
2002,38019,Guía de Isora,Santa Cruz de Tenerife,233,181,52
2002,38020,Güímar,Santa Cruz de Tenerife,97,79,18
2002,38022,Icod de los Vinos,Santa Cruz de Tenerife,104,59,45
2002,38023,San Cristóbal de La Laguna,Santa Cruz de Tenerife,1119,962,157
2002,38024,Los Llanos de Aridane,Santa Cruz de Tenerife,243,214,29
2002,38026,La Orotava,Santa Cruz de Tenerife,179,145,34
2002,38028,Puerto de la Cruz,Santa Cruz de Tenerife,668,473,195
2002,38031,Los Realejos,Santa Cruz de Tenerife,145,171,-26
2002,38032,El Rosario,Santa Cruz de Tenerife,179,263,-84
2002,38037,Santa Cruz de la Palma,Santa Cruz de Tenerife,351,322,29
2002,38038,Santa Cruz de Tenerife,Santa Cruz de Tenerife,2655,2443,212
2002,38039,Santa Úrsula,Santa Cruz de Tenerife,134,98,36
2002,38040,Santiago del Teide,Santa Cruz de Tenerife,143,110,33
2002,38043,Tacoronte,Santa Cruz de Tenerife,103,88,15
2002,39008,El Astillero,Cantabria,116,115,1
2002,39016,Camargo,Cantabria,208,190,18
2002,39020,Castro-Urdiales,Cantabria,2017,980,1037
2002,39025,Los Corrales de Buelna,Cantabria,64,70,-6
2002,39035,Laredo,Cantabria,277,189,88
2002,39052,Piélagos,Cantabria,226,153,73
2002,39059,Reinosa,Cantabria,121,121,0
2002,39075,Santander,Cantabria,1937,2288,-351
2002,39079,Santoña,Cantabria,213,151,62
2002,39087,Torrelavega,Cantabria,486,514,-28
2002,40194,Segovia,Segovia,675,927,-252
2002,41004,Alcalá de Guadaíra,Sevilla,470,434,36
2002,41007,La Algaba,Sevilla,63,56,7
2002,41011,Arahal,Sevilla,88,96,-8
2002,41017,Bormujos,Sevilla,203,91,112
2002,41018,Brenes,Sevilla,106,73,33
2002,41020,Las Cabezas de San Juan,Sevilla,149,167,-18
2002,41021,Camas,Sevilla,160,188,-28
2002,41024,Carmona,Sevilla,203,169,34
2002,41029,Castilleja de la Cuesta,Sevilla,199,167,32
2002,41034,Coria del Río,Sevilla,178,152,26
2002,41038,Dos Hermanas,Sevilla,1198,950,248
2002,41039,Écija,Sevilla,352,295,57
2002,41041,Estepa,Sevilla,89,77,12
2002,41047,Gines,Sevilla,136,76,60
2002,41053,Lebrija,Sevilla,191,184,7
2002,41055,Lora del Río,Sevilla,189,187,2
2002,41058,Mairena del Alcor,Sevilla,102,81,21
2002,41059,Mairena del Aljarafe,Sevilla,494,418,76
2002,41060,Marchena,Sevilla,97,78,19
2002,41065,Morón de la Frontera,Sevilla,257,342,-85
2002,41068,Osuna,Sevilla,130,127,3
2002,41069,Los Palacios y Villafranca,Sevilla,212,200,12
2002,41075,Pilas,Sevilla,70,47,23
2002,41077,La Puebla de Cazalla,Sevilla,156,173,-17
2002,41079,La Puebla del Río,Sevilla,62,84,-22
2002,41081,La Rinconada,Sevilla,288,207,81
2002,41086,San Juan de Aznalfarache,Sevilla,233,257,-24
2002,41087,Sanlúcar la Mayor,Sevilla,72,79,-7
2002,41091,Sevilla,Sevilla,7254,7353,-99
2002,41093,Tomares,Sevilla,288,247,41
2002,41095,Utrera,Sevilla,351,429,-78
2002,41102,El Viso del Alcor,Sevilla,63,37,26
2002,42173,Soria,Soria,533,647,-114
2002,43014,Amposta,Tarragona,215,240,-25
2002,43037,Calafell,Tarragona,1642,616,1026
2002,43038,Cambrils,Tarragona,742,434,308
2002,43123,Reus,Tarragona,1472,924,548
2002,43136,Sant Carles de la Ràpita,Tarragona,265,179,86
2002,43148,Tarragona,Tarragona,1890,1320,570
2002,43153,Torredembarra,Tarragona,609,320,289
2002,43155,Tortosa,Tarragona,528,389,139
2002,43161,Valls,Tarragona,355,238,117
2002,43163,El Vendrell,Tarragona,1588,699,889
2002,43171,Vila-seca,Tarragona,474,196,278
2002,43901,Deltebre,Tarragona,86,55,31
2002,43905,Salou,Tarragona,923,490,433
2002,44013,Alcañiz,Teruel,286,209,77
2002,44216,Teruel,Teruel,488,558,-70
2002,45053,Consuegra,Toledo,55,59,-4
2002,45081,Illescas,Toledo,748,276,472
2002,45087,Madridejos,Toledo,86,102,-16
2002,45165,Talavera de la Reina,Toledo,1477,1166,311
2002,45168,Toledo,Toledo,1484,1125,359
2002,45173,Torrijos,Toledo,187,150,37
2002,46005,Alaquàs,Valencia,223,173,50
2002,46007,Albal,Valencia,13,52,-39
2002,46013,Alboraya,Valencia,197,154,43
2002,46017,Alzira,Valencia,345,270,75
2002,46019,L'Alcúdia,Valencia,55,47,8
2002,46021,Aldaia,Valencia,218,186,32
2002,46022,Alfafar,Valencia,164,145,19
2002,46029,Algemesí,Valencia,228,152,76
2002,46031,Alginet,Valencia,21,56,-35
2002,46054,Benetússer,Valencia,98,93,5
2002,46060,Benifaió,Valencia,58,80,-22
2002,46070,Bétera,Valencia,214,109,105
2002,46078,Burjassot,Valencia,381,308,73
2002,46081,Canals,Valencia,46,80,-34
2002,46083,Carcaixent,Valencia,131,135,-4
2002,46085,Carlet,Valencia,66,66,0
2002,46094,Catarroja,Valencia,203,137,66
2002,46102,Quart de Poblet,Valencia,211,135,76
2002,46105,Cullera,Valencia,273,198,75
2002,46110,Xirivella,Valencia,260,235,25
2002,46111,Chiva,Valencia,139,60,79
2002,46116,L'Eliana,Valencia,196,109,87
2002,46131,Gandia,Valencia,966,826,140
2002,46135,Godella,Valencia,138,96,42
2002,46145,Xátiva,Valencia,223,220,3
2002,46147,Llíria,Valencia,240,179,61
2002,46159,Manises,Valencia,180,172,8
2002,46164,Massamagrell,Valencia,142,111,31
2002,46169,Mislata,Valencia,392,397,-5
2002,46171,Moncada,Valencia,155,129,26
2002,46181,Oliva,Valencia,301,220,81
2002,46184,Ontinyent,Valencia,259,274,-15
2002,46186,Paiporta,Valencia,184,102,82
2002,46190,Paterna,Valencia,491,403,88
2002,46194,Picassent,Valencia,105,98,7
2002,46202,La Pobla de Vallbona,Valencia,194,76,118
2002,46205,Puçol,Valencia,195,101,94
2002,46213,Requena,Valencia,123,189,-66
2002,46214,Riba-roja de Túria,Valencia,198,94,104
2002,46220,Sagunto/Sagunt,Valencia,852,550,302
2002,46230,Silla,Valencia,150,103,47
2002,46235,Sueca,Valencia,126,105,21
2002,46238,Tavernes de la Valldigna,Valencia,128,95,33
2002,46244,Torrent (Valencia),Valencia,731,535,196
2002,46249,Utiel,Valencia,81,74,7
2002,46250,València,Valencia,10670,8716,1954
2002,47076,Laguna de Duero,Valladolid,273,234,39
2002,47085,Medina del Campo,Valladolid,183,266,-83
2002,47186,Valladolid,Valladolid,4128,4793,-665
2002,48003,Amorebieta-Etxano,Vizcaya,72,118,-46
2002,48011,Arrigorriaga,Vizcaya,96,144,-48
2002,48013,Barakaldo,Vizcaya,684,1086,-402
2002,48015,Basauri,Vizcaya,273,480,-207
2002,48017,Bermeo,Vizcaya,89,136,-47
2002,48020,Bilbao,Vizcaya,3899,4601,-702
2002,48027,Durango,Vizcaya,237,193,44
2002,48034,Ermua,Vizcaya,211,339,-128
2002,48036,Galdakao,Vizcaya,189,274,-85
2002,48044,Getxo,Vizcaya,711,1049,-338
2002,48046,Gernika-Lumo,Vizcaya,73,92,-19
2002,48054,Leioa,Vizcaya,226,322,-96
2002,48069,Mungia,Vizcaya,121,120,1
2002,48078,Portugalete,Vizcaya,306,568,-262
2002,48080,Valle de Trápaga-Trapagaran,Vizcaya,49,109,-60
2002,48082,Santurtzi,Vizcaya,297,574,-277
2002,48084,Sestao,Vizcaya,192,372,-180
2002,48085,Sopela,Vizcaya,69,106,-37
2002,48902,Erandio,Vizcaya,141,285,-144
2002,49021,Benavente,Zamora,379,349,30
2002,49275,Zamora,Zamora,798,1064,-266
2002,50067,Calatayud,Zaragoza,265,396,-131
2002,50251,Tarazona,Zaragoza,138,127,11
2002,50272,Utebo,Zaragoza,189,164,25
2002,50297,Zaragoza,Zaragoza,6471,7725,-1254
2002,51001,Ceuta,Ceuta,1810,2624,-814
2002,52001,Melilla,Melilla,1727,2682,-955
2003,01036,Laudio/Llodio,Álava,263,332,-69
2003,01059,Vitoria-Gasteiz,Álava,3405,3227,178
2003,02003,Albacete,Albacete,2028,2241,-213
2003,02009,Almansa,Albacete,374,359,15
2003,02037,Hellín,Albacete,481,633,-152
2003,02069,La Roda,Albacete,201,196,5
2003,02081,Villarrobledo,Albacete,317,428,-111
2003,03009,Alcoy/Alcoi,Alicante,441,514,-73
2003,03011,L'Alfàs del Pi,Alicante,314,184,130
2003,03014,Alicante/Alacant,Alicante,6638,4412,2226
2003,03015,Almoradí,Alicante,239,124,115
2003,03018,Altea,Alicante,469,284,185
2003,03019,Aspe,Alicante,141,88,53
2003,03031,Benidorm,Alicante,2667,1755,912
2003,03041,Benissa,Alicante,131,90,41
2003,03047,Calp,Alicante,461,345,116
2003,03049,Callosa de Segura,Alicante,112,153,-41
2003,03050,El Campello,Alicante,519,295,224
2003,03056,Cocentaina,Alicante,89,101,-12
2003,03059,Crevillent,Alicante,203,165,38
2003,03063,Dénia,Alicante,973,728,245
2003,03065,Elche/Elx,Alicante,2268,1439,829
2003,03066,Elda,Alicante,498,477,21
2003,03076,Guardamar del Segura,Alicante,349,237,112
2003,03079,Ibi,Alicante,227,215,12
2003,03082,Jávea/Xàbia,Alicante,480,416,64
2003,03089,Monóvar/Monòver,Alicante,119,85,34
2003,03090,Mutxamel,Alicante,168,159,9
2003,03093,Novelda,Alicante,197,171,26
2003,03094,La Nucia,Alicante,283,142,141
2003,03099,Orihuela,Alicante,1133,1140,-7
2003,03102,Pego,Alicante,126,125,1
2003,03104,Petrer,Alicante,240,213,27
2003,03113,Rojales,Alicante,66,51,15
2003,03119,Sant Joan d'Alacant,Alicante,493,228,265
2003,03121,Santa Pola,Alicante,615,378,237
2003,03122,San Vicente del Raspeig/Sant Vicent del Raspeig,Alicante,535,332,203
2003,03128,Teulada,Alicante,131,158,-27
2003,03133,Torrevieja,Alicante,3980,2663,1317
2003,03139,Villajoyosa/La Vila Joiosa,Alicante,554,370,184
2003,03140,Villena,Alicante,389,291,98
2003,03902,Pilar de la Horadada,Alicante,571,462,109
2003,04003,Adra,Almería,173,214,-41
2003,04006,Albox,Almería,237,235,2
2003,04013,Almería,Almería,2205,2342,-137
2003,04029,Berja,Almería,122,127,-5
2003,04035,Cuevas del Almanzora,Almería,168,219,-51
2003,04053,Huércal-Overa,Almería,279,223,56
2003,04066,Níjar,Almería,310,507,-197
2003,04079,Roquetas de Mar,Almería,1588,1648,-60
2003,04102,Vícar,Almería,272,412,-140
2003,04902,El Ejido,Almería,862,1511,-649
2003,05019,Ávila,Ávila,805,852,-47
2003,06011,Almendralejo,Badajoz,364,307,57
2003,06015,Badajoz,Badajoz,1868,1703,165
2003,06044,Don Benito,Badajoz,550,435,115
2003,06083,Mérida,Badajoz,718,712,6
2003,06088,Montijo,Badajoz,193,164,29
2003,06095,Olivenza,Badajoz,103,76,27
2003,06149,Villafranca de los Barros,Badajoz,95,125,-30
2003,06153,Villanueva de la Serena,Badajoz,315,281,34
2003,06158,Zafra,Badajoz,176,189,-13
2003,07003,Alcúdia,Baleares,580,630,-50
2003,07011,Calvià,Baleares,853,1205,-352
2003,07015,Ciutadella de Menorca,Baleares,1055,746,309
2003,07022,Felanitx,Baleares,200,276,-76
2003,07026,Eivissa,Baleares,1569,1426,143
2003,07027,Inca,Baleares,367,432,-65
2003,07031,Llucmajor,Baleares,506,553,-47
2003,07032,Maó-Mahón,Baleares,890,726,164
2003,07033,Manacor,Baleares,629,837,-208
2003,07036,Marratxí,Baleares,198,200,-2
2003,07040,Palma,Baleares,7637,8660,-1023
2003,07042,Pollença,Baleares,245,300,-55
2003,07044,Sa Pobla,Baleares,120,130,-10
2003,07046,Sant Antoni de Portmany,Baleares,434,426,8
2003,07048,Sant Josep de sa Talaia,Baleares,662,431,231
2003,07054,Santa Eulària des Riu,Baleares,1001,733,268
2003,07057,Santanyí,Baleares,188,297,-109
2003,07061,Sóller,Baleares,123,150,-27
2003,07062,Son Servera,Baleares,275,410,-135
2003,08006,Arenys de Mar,Barcelona,142,188,-46
2003,08009,Argentona,Barcelona,55,105,-50
2003,08015,Badalona,Barcelona,1600,2806,-1206
2003,08019,Barcelona,Barcelona,16281,22954,-6673
2003,08022,Berga,Barcelona,149,161,-12
2003,08033,Caldes de Montbui,Barcelona,86,143,-57
2003,08035,Calella,Barcelona,226,277,-51
2003,08040,Canet de Mar,Barcelona,63,117,-54
2003,08041,Canovelles,Barcelona,125,168,-43
2003,08046,Cardedeu,Barcelona,105,110,-5
2003,08051,Castellar del Vallès,Barcelona,109,163,-54
2003,08056,Castelldefels,Barcelona,950,1129,-179
2003,08072,Corbera de Llobregat,Barcelona,63,99,-36
2003,08073,Cornellà de Llobregat,Barcelona,720,1047,-327
2003,08076,Esparreguera,Barcelona,177,267,-90
2003,08077,Esplugues de Llobregat,Barcelona,340,562,-222
2003,08086,Les Franqueses del Vallès,Barcelona,126,123,3
2003,08088,La Garriga,Barcelona,74,111,-37
2003,08089,Gavà,Barcelona,417,681,-264
2003,08096,Granollers,Barcelona,538,742,-204
2003,08101,L'Hospitalet de Llobregat,Barcelona,2868,3614,-746
2003,08102,Igualada,Barcelona,365,354,11
2003,08105,La Llagosta,Barcelona,92,174,-82
2003,08107,Lliçà d'Amunt,Barcelona,61,101,-40
2003,08110,Malgrat de Mar,Barcelona,268,281,-13
2003,08112,Manlleu,Barcelona,173,139,34
2003,08113,Manresa,Barcelona,623,576,47
2003,08114,Martorell,Barcelona,305,310,-5
2003,08118,El Masnou,Barcelona,152,213,-61
2003,08121,Mataró,Barcelona,905,1295,-390
2003,08123,Molins de Rei,Barcelona,144,196,-52
2003,08124,Mollet del Vallès,Barcelona,506,655,-149
2003,08125,Montcada i Reixac,Barcelona,219,350,-131
2003,08136,Montornès del Vallès,Barcelona,144,196,-52
2003,08147,Olesa de Montserrat,Barcelona,122,176,-54
2003,08156,Palau-solità i Plegamans,Barcelona,69,103,-34
2003,08159,Parets del Vallès,Barcelona,91,164,-73
2003,08161,Piera,Barcelona,86,122,-36
2003,08163,Pineda de Mar,Barcelona,290,407,-117
2003,08169,El Prat de Llobregat,Barcelona,552,880,-328
2003,08172,Premià de Mar,Barcelona,253,353,-100
2003,08180,Ripollet,Barcelona,298,492,-194
2003,08184,Rubí,Barcelona,538,828,-290
2003,08187,Sabadell,Barcelona,1541,1919,-378
2003,08194,Sant Adrià de Besòs,Barcelona,218,370,-152
2003,08196,Sant Andreu de la Barca,Barcelona,192,332,-140
2003,08200,Sant Boi de Llobregat,Barcelona,600,1003,-403
2003,08202,Sant Celoni,Barcelona,236,240,-4
2003,08205,Sant Cugat del Vallès,Barcelona,735,666,69
2003,08211,Sant Feliu de Llobregat,Barcelona,355,492,-137
2003,08217,Sant Joan Despí,Barcelona,215,343,-128
2003,08219,Vilassar de Mar,Barcelona,114,175,-61
2003,08221,Sant Just Desvern,Barcelona,129,116,13
2003,08231,Sant Pere de Ribes,Barcelona,277,357,-80
2003,08238,Sant Quirze del Vallès,Barcelona,127,133,-6
2003,08240,Sant Sadurní d'Anoia,Barcelona,124,85,39
2003,08245,Santa Coloma de Gramenet,Barcelona,997,1587,-590
2003,08252,Barberà del Vallès,Barcelona,201,301,-100
2003,08260,Santa Perpètua de Mogoda,Barcelona,125,276,-151
2003,08263,Sant Vicenç dels Horts,Barcelona,202,268,-66
2003,08266,Cerdanyola del Vallès,Barcelona,467,709,-242
2003,08270,Sitges,Barcelona,308,315,-7
2003,08279,Terrassa,Barcelona,1509,1838,-329
2003,08284,Tordera,Barcelona,317,283,34
2003,08285,Torelló,Barcelona,93,87,6
2003,08295,Vallirana,Barcelona,66,131,-65
2003,08298,Vic,Barcelona,558,416,142
2003,08301,Viladecans,Barcelona,523,990,-467
2003,08302,Vilanova del Camí,Barcelona,83,94,-11
2003,08305,Vilafranca del Penedès,Barcelona,490,399,91
2003,08307,Vilanova i la Geltrú,Barcelona,806,784,22
2003,08904,Badia del Vallès,Barcelona,105,226,-121
2003,09018,Aranda de Duero,Burgos,507,562,-55
2003,09059,Burgos,Burgos,1950,2429,-479
2003,09219,Miranda de Ebro,Burgos,699,932,-233
2003,10037,Cáceres,Cáceres,1288,1329,-41
2003,10067,Coria,Cáceres,177,230,-53
2003,10131,Navalmoral de la Mata,Cáceres,382,431,-49
2003,10148,Plasencia,Cáceres,571,621,-50
2003,10180,Talayuela,Cáceres,170,548,-378
2003,11004,Algeciras,Cádiz,1831,1563,268
2003,11006,Arcos de la Frontera,Cádiz,407,235,172
2003,11007,Barbate,Cádiz,402,297,105
2003,11008,Los Barrios,Cádiz,338,233,105
2003,11012,Cádiz,Cádiz,1380,1609,-229
2003,11014,Conil de la Frontera,Cádiz,242,137,105
2003,11015,Chiclana de la Frontera,Cádiz,1121,640,481
2003,11016,Chipiona,Cádiz,257,161,96
2003,11020,Jerez de la Frontera,Cádiz,2966,2198,768
2003,11022,La Línea de la Concepción,Cádiz,727,644,83
2003,11023,Medina-Sidonia,Cádiz,98,70,28
2003,11027,El Puerto de Santa María,Cádiz,1345,1185,160
2003,11028,Puerto Real,Cádiz,372,390,-18
2003,11030,Rota,Cádiz,520,340,180
2003,11031,San Fernando,Cádiz,1177,1127,50
2003,11032,Sanlúcar de Barrameda,Cádiz,577,335,242
2003,11033,San Roque,Cádiz,406,399,7
2003,11035,Tarifa,Cádiz,432,193,239
2003,11038,Ubrique,Cádiz,52,172,-120
2003,11039,Vejer de la Frontera,Cádiz,89,75,14
2003,11041,Villamartín,Cádiz,129,144,-15
2003,12009,Almassora,Castellón,203,142,61
2003,12027,Benicarló,Castellón,523,389,134
2003,12028,Benicasim/Benicàssim,Castellón,398,324,74
2003,12032,Borriana/Burriana,Castellón,447,349,98
2003,12040,Castellón de la Plana/Castelló de la Plana,Castellón,2305,2277,28
2003,12082,Nules,Castellón,144,122,22
2003,12084,Onda,Castellón,253,162,91
2003,12126,La Vall d'Uixó,Castellón,320,301,19
2003,12135,Vila-real,Castellón,635,492,143
2003,12138,Vinaròs,Castellón,572,536,36
2003,13005,Alcázar de San Juan,Ciudad Real,593,401,192
2003,13023,Bolaños de Calatrava,Ciudad Real,156,213,-57
2003,13028,Campo de Criptana,Ciudad Real,158,129,29
2003,13034,Ciudad Real,Ciudad Real,1264,986,278
2003,13039,Daimiel,Ciudad Real,159,149,10
2003,13053,Manzanares,Ciudad Real,303,290,13
2003,13056,Miguelturra,Ciudad Real,124,83,41
2003,13071,Puertollano,Ciudad Real,861,809,52
2003,13078,Socuéllamos,Ciudad Real,120,290,-170
2003,13079,La Solana,Ciudad Real,91,142,-51
2003,13082,Tomelloso,Ciudad Real,377,410,-33
2003,13087,Valdepeñas,Ciudad Real,497,392,105
2003,14002,Aguilar de la Frontera,Córdoba,92,113,-21
2003,14007,Baena,Córdoba,298,208,90
2003,14013,Cabra,Córdoba,176,202,-26
2003,14017,La Carlota,Córdoba,149,83,66
2003,14021,Córdoba,Córdoba,3530,4004,-474
2003,14030,Fuente Palmera,Córdoba,148,108,40
2003,14038,Lucena,Córdoba,474,387,87
2003,14042,Montilla,Córdoba,140,172,-32
2003,14049,Palma del Río,Córdoba,326,270,56
2003,14052,Peñarroya-Pueblonuevo,Córdoba,180,248,-68
2003,14054,Pozoblanco,Córdoba,141,179,-38
2003,14055,Priego de Córdoba,Córdoba,275,242,33
2003,14056,Puente Genil,Córdoba,379,346,33
2003,15002,Ames,A Coruña,366,292,74
2003,15005,Arteixo,A Coruña,237,211,26
2003,15009,Betanzos,A Coruña,94,95,-1
2003,15011,Boiro,A Coruña,149,183,-34
2003,15017,Cambre,A Coruña,216,172,44
2003,15019,Carballo,A Coruña,163,215,-52
2003,15030,A Coruña,A Coruña,2740,3158,-418
2003,15031,Culleredo,A Coruña,345,218,127
2003,15035,Fene,A Coruña,88,100,-12
2003,15036,Ferrol,A Coruña,1023,1113,-90
2003,15041,A Laracha,A Coruña,43,44,-1
2003,15053,Muros,A Coruña,123,112,11
2003,15054,Narón,A Coruña,303,309,-6
2003,15057,Noia,A Coruña,158,157,1
2003,15058,Oleiros,A Coruña,403,318,85
2003,15059,Ordes,A Coruña,56,86,-30
2003,15067,A Pobra do Caramiñal,A Coruña,79,78,1
2003,15070,As Pontes de García Rodríguez,A Coruña,73,123,-50
2003,15071,Porto do Son,A Coruña,94,128,-34
2003,15072,Rianxo,A Coruña,95,106,-11
2003,15073,Ribeira,A Coruña,233,255,-22
2003,15075,Sada (A Coruña),A Coruña,200,132,68
2003,15077,Santa Comba,A Coruña,48,74,-26
2003,15078,Santiago de Compostela,A Coruña,1277,1203,74
2003,15082,Teo,A Coruña,220,171,49
2003,16078,Cuenca,Cuenca,802,681,121
2003,16203,Tarancón,Cuenca,334,271,63
2003,17015,Banyoles,Girona,223,165,58
2003,17023,Blanes,Girona,1521,1156,365
2003,17066,Figueres,Girona,671,559,112
2003,17079,Girona,Girona,1949,1125,824
2003,17095,Lloret de Mar,Girona,1244,872,372
2003,17114,Olot,Girona,641,334,307
2003,17117,Palafrugell,Girona,413,290,123
2003,17118,Palamós,Girona,382,212,170
2003,17147,Ripoll,Girona,166,172,-6
2003,17152,Roses,Girona,384,280,104
2003,17155,Salt,Girona,745,389,356
2003,17160,Sant Feliu de Guíxols,Girona,429,234,195
2003,18003,Albolote,Granada,226,142,84
2003,18017,Almuñécar,Granada,304,315,-11
2003,18021,Armilla,Granada,378,233,145
2003,18022,Atarfe,Granada,174,124,50
2003,18023,Baza,Granada,367,405,-38
2003,18087,Granada,Granada,4550,3963,587
2003,18089,Guadix,Granada,275,320,-45
2003,18101,Huétor Vega,Granada,132,100,32
2003,18102,Illora,Granada,106,66,40
2003,18122,Loja,Granada,266,302,-36
2003,18127,Maracena,Granada,253,173,80
2003,18140,Motril,Granada,787,636,151
2003,18145,Ogíjares,Granada,194,92,102
2003,18158,Pinos Puente,Granada,101,72,29
2003,18173,Salobreña,Granada,248,132,116
2003,18175,Santa Fe,Granada,203,131,72
2003,18193,La Zubia,Granada,265,165,100
2003,19046,Azuqueca de Henares,Guadalajara,1441,841,600
2003,19130,Guadalajara,Guadalajara,1674,1243,431
2003,20009,Andoain,Guipúzcoa,111,113,-2
2003,20017,Azkoitia,Guipúzcoa,70,65,5
2003,20018,Azpeitia,Guipúzcoa,58,55,3
2003,20019,Beasain,Guipúzcoa,105,86,19
2003,20030,Eibar,Guipúzcoa,341,424,-83
2003,20032,Elgoibar,Guipúzcoa,88,104,-16
2003,20036,Hondarribia,Guipúzcoa,194,151,43
2003,20040,Hernani,Guipúzcoa,136,121,15
2003,20045,Irun,Guipúzcoa,741,714,27
2003,20055,Arrasate/Mondragón,Guipúzcoa,217,361,-144
2003,20059,Oñati,Guipúzcoa,63,62,1
2003,20064,Pasaia,Guipúzcoa,139,120,19
2003,20067,Errenteria,Guipúzcoa,246,317,-71
2003,20069,Donostia/San Sebastián,Guipúzcoa,1959,1824,135
2003,20071,Tolosa,Guipúzcoa,125,137,-12
2003,20074,Bergara,Guipúzcoa,108,159,-51
2003,20079,Zarautz,Guipúzcoa,223,194,29
2003,20080,Zumarraga,Guipúzcoa,63,95,-32
2003,20902,Lasarte-Oria,Guipúzcoa,164,198,-34
2003,21002,Aljaraque,Huelva,211,186,25
2003,21005,Almonte,Huelva,376,256,120
2003,21010,Ayamonte,Huelva,321,224,97
2003,21013,Bollullos Par del Condado,Huelva,70,82,-12
2003,21021,Cartaya,Huelva,308,231,77
2003,21035,Gibraleón,Huelva,95,61,34
2003,21041,Huelva,Huelva,1308,1589,-281
2003,21042,Isla Cristina,Huelva,284,235,49
2003,21044,Lepe,Huelva,372,338,34
2003,21050,Moguer,Huelva,258,303,-45
2003,21060,Punta Umbría,Huelva,133,119,14
2003,21072,Valverde del Camino,Huelva,76,86,-10
2003,22048,Barbastro,Huesca,215,228,-13
2003,22112,Fraga,Huesca,262,398,-136
2003,22125,Huesca,Huesca,810,789,21
2003,22130,Jaca,Huesca,452,362,90
2003,22158,Monzón,Huesca,165,248,-83
2003,23002,Alcalá la Real,Jaén,331,353,-22
2003,23003,Alcaudete,Jaén,120,146,-26
2003,23005,Andújar,Jaén,476,531,-55
2003,23009,Baeza,Jaén,211,180,31
2003,23010,Bailén,Jaén,146,152,-6
2003,23024,La Carolina,Jaén,249,217,32
2003,23050,Jaén,Jaén,1103,1422,-319
2003,23053,Jódar,Jaén,79,136,-57
2003,23055,Linares,Jaén,882,908,-26
2003,23060,Martos,Jaén,216,227,-11
2003,23086,Torredelcampo,Jaén,111,102,9
2003,23087,Torredonjimeno,Jaén,96,95,1
2003,23092,Úbeda,Jaén,435,481,-46
2003,23095,Villacarrillo,Jaén,116,171,-55
2003,24008,Astorga,León,180,191,-11
2003,24010,La Bañeza,León,166,167,-1
2003,24014,Bembibre,León,134,162,-28
2003,24089,León,León,1876,2415,-539
2003,24115,Ponferrada,León,821,900,-79
2003,24142,San Andrés del Rabanedo,León,330,326,4
2003,24202,Villablino,León,132,305,-173
2003,24222,Villaquilambre,León,231,117,114
2003,25040,Balaguer,Lleida,295,175,120
2003,25120,Lleida,Lleida,2295,2127,168
2003,25137,Mollerussa,Lleida,223,145,78
2003,25203,La Seu d'Urgell,Lleida,470,363,107
2003,25217,Tàrrega,Lleida,369,350,19
2003,26018,Arnedo,La Rioja,211,148,63
2003,26036,Calahorra,La Rioja,618,457,161
2003,26089,Logroño,La Rioja,2747,2532,215
2003,27028,Lugo,Lugo,1112,1205,-93
2003,27031,Monforte de Lemos,Lugo,276,341,-65
2003,27057,Sarria,Lugo,110,139,-29
2003,27065,Vilalba,Lugo,108,104,4
2003,27066,Viveiro,Lugo,224,237,-13
2003,28005,Alcalá de Henares,Madrid,2677,4585,-1908
2003,28006,Alcobendas,Madrid,1169,1346,-177
2003,28007,Alcorcón,Madrid,1859,2120,-261
2003,28009,Algete,Madrid,169,317,-148
2003,28013,Aranjuez,Madrid,594,729,-135
2003,28014,Arganda del Rey,Madrid,430,507,-77
2003,28022,Boadilla del Monte,Madrid,416,391,25
2003,28040,Ciempozuelos,Madrid,218,249,-31
2003,28045,Colmenar Viejo,Madrid,412,502,-90
2003,28047,Collado Villalba,Madrid,561,1011,-450
2003,28049,Coslada,Madrid,472,987,-515
2003,28054,El Escorial,Madrid,167,171,-4
2003,28058,Fuenlabrada,Madrid,1650,3770,-2120
2003,28061,Galapagar,Madrid,301,504,-203
2003,28065,Getafe,Madrid,1339,2210,-871
2003,28068,Guadarrama,Madrid,138,171,-33
2003,28073,Humanes de Madrid,Madrid,172,375,-203
2003,28074,Leganés,Madrid,1372,2241,-869
2003,28079,Madrid,Madrid,36177,51043,-14866
2003,28080,Majadahonda,Madrid,682,778,-96
2003,28084,Mejorada del Campo,Madrid,159,229,-70
2003,28092,Móstoles,Madrid,1961,3504,-1543
2003,28096,Navalcarnero,Madrid,236,214,22
2003,28106,Parla,Madrid,1018,1806,-788
2003,28113,Pinto,Madrid,431,474,-43
2003,28115,Pozuelo de Alarcón,Madrid,750,840,-90
2003,28123,Rivas-Vaciamadrid,Madrid,422,327,95
2003,28127,Las Rozas de Madrid,Madrid,851,969,-118
2003,28130,San Fernando de Henares,Madrid,255,466,-211
2003,28131,San Lorenzo de El Escorial,Madrid,190,193,-3
2003,28132,San Martín de la Vega,Madrid,149,372,-223
2003,28134,San Sebastián de los Reyes,Madrid,547,784,-237
2003,28148,Torrejón de Ardoz,Madrid,1245,2062,-817
2003,28152,Torrelodones,Madrid,153,244,-91
2003,28161,Valdemoro,Madrid,928,847,81
2003,28176,Villanueva de la Cañada,Madrid,247,200,47
2003,28181,Villaviciosa de Odón,Madrid,399,274,125
2003,28903,Tres Cantos,Madrid,533,619,-86
2003,29007,Alhaurín de la Torre,Málaga,380,182,198
2003,29008,Alhaurín el Grande,Málaga,148,68,80
2003,29012,Álora,Málaga,74,54,20
2003,29015,Antequera,Málaga,428,273,155
2003,29025,Benalmádena,Málaga,1121,556,565
2003,29038,Cártama,Málaga,105,68,37
2003,29042,Coín,Málaga,151,87,64
2003,29051,Estepona,Málaga,1629,844,785
2003,29054,Fuengirola,Málaga,1666,863,803
2003,29067,Málaga,Málaga,5076,4716,360
2003,29069,Marbella,Málaga,2994,1758,1236
2003,29070,Mijas,Málaga,925,407,518
2003,29075,Nerja,Málaga,215,192,23
2003,29082,Rincón de la Victoria,Málaga,613,333,280
2003,29084,Ronda,Málaga,347,450,-103
2003,29091,Torrox,Málaga,167,120,47
2003,29094,Vélez-Málaga,Málaga,884,477,407
2003,29901,Torremolinos,Málaga,1457,816,641
2003,30002,Abarán,Murcia,63,92,-29
2003,30003,Águilas,Murcia,563,448,115
2003,30005,Alcantarilla,Murcia,369,379,-10
2003,30008,Alhama de Murcia,Murcia,203,178,25
2003,30009,Archena,Murcia,210,139,71
2003,30012,Bullas,Murcia,108,95,13
2003,30015,Caravaca de la Cruz,Murcia,344,286,58
2003,30016,Cartagena,Murcia,2636,2671,-35
2003,30017,Cehegín,Murcia,119,112,7
2003,30019,Cieza (Murcia),Murcia,215,228,-13
2003,30021,Fuente Álamo de Murcia,Murcia,247,186,61
2003,30022,Jumilla,Murcia,383,438,-55
2003,30024,Lorca,Murcia,1292,1628,-336
2003,30026,Mazarrón,Murcia,673,657,16
2003,30027,Molina de Segura,Murcia,752,521,231
2003,30029,Mula,Murcia,175,264,-89
2003,30030,Murcia,Murcia,4225,4020,205
2003,30033,Puerto Lumbreras,Murcia,149,182,-33
2003,30035,San Javier,Murcia,795,699,96
2003,30036,San Pedro del Pinatar,Murcia,539,455,84
2003,30037,Torre-Pacheco,Murcia,300,682,-382
2003,30038,Las Torres de Cotillas,Murcia,173,139,34
2003,30039,Totana,Murcia,235,325,-90
2003,30041,La Unión,Murcia,118,152,-34
2003,30043,Yecla,Murcia,492,485,7
2003,30901,Santomera,Murcia,193,171,22
2003,30902,Los Alcázares,Murcia,394,346,48
2003,31060,Burlada/Burlata,Navarra,155,146,9
2003,31097,Estella-Lizarra,Navarra,184,210,-26
2003,31201,Pamplona/Iruña,Navarra,2328,2406,-78
2003,31227,Tafalla,Navarra,89,117,-28
2003,31232,Tudela,Navarra,607,640,-33
2003,31258,Villava/Atarrabia,Navarra,74,49,25
2003,31901,Barañain,Navarra,320,271,49
2003,31907,Zizur Mayor/Zizur Nagusia,Navarra,143,124,19
2003,32009,O Barco de Valdeorras,Ourense,196,298,-102
2003,32019,O Carballiño,Ourense,140,197,-57
2003,32054,Ourense,Ourense,1068,1793,-725
2003,32085,Verín,Ourense,247,347,-100
2003,33002,Aller,Asturias,69,71,-2
2003,33004,Avilés,Asturias,701,845,-144
2003,33011,Cangas del Narcea,Asturias,76,108,-32
2003,33014,Carreño,Asturias,56,61,-5
2003,33016,Castrillón,Asturias,183,168,15
2003,33020,Corvera de Asturias,Asturias,119,157,-38
2003,33024,Gijón,Asturias,2589,2817,-228
2003,33025,Gozón,Asturias,69,49,20
2003,33026,Grado,Asturias,28,58,-30
2003,33031,Langreo,Asturias,210,302,-92
2003,33032,Laviana,Asturias,90,64,26
2003,33033,Lena,Asturias,65,109,-44
2003,33034,Valdés,Asturias,63,80,-17
2003,33035,Llanera,Asturias,127,80,47
2003,33036,Llanes,Asturias,121,121,0
2003,33037,Mieres (Asturias),Asturias,204,363,-159
2003,33044,Oviedo,Asturias,2112,2367,-255
2003,33060,San Martín del Rey Aurelio,Asturias,88,117,-29
2003,33066,Siero,Asturias,256,285,-29
2003,33073,Tineo,Asturias,30,55,-25
2003,33076,Villaviciosa,Asturias,109,72,37
2003,34120,Palencia,Palencia,978,1234,-256
2003,35002,Agüimes,Las Palmas,366,281,85
2003,35004,Arrecife,Las Palmas,1414,1596,-182
2003,35006,Arucas,Las Palmas,121,175,-54
2003,35009,Gáldar,Las Palmas,69,82,-13
2003,35011,Ingenio,Las Palmas,149,119,30
2003,35012,Mogán,Las Palmas,232,309,-77
2003,35014,La Oliva,Las Palmas,914,653,261
2003,35015,Pájara,Las Palmas,1668,1278,390
2003,35016,Las Palmas de Gran Canaria,Las Palmas,4580,5017,-437
2003,35017,Puerto del Rosario,Las Palmas,1486,938,548
2003,35018,San Bartolomé,Las Palmas,529,622,-93
2003,35019,San Bartolomé de Tirajana,Las Palmas,547,684,-137
2003,35021,Santa Brígida,Las Palmas,129,133,-4
2003,35022,Santa Lucía de Tirajana,Las Palmas,672,742,-70
2003,35023,Santa María de Guía de Gran Canaria,Las Palmas,43,50,-7
2003,35024,Teguise,Las Palmas,309,352,-43
2003,35026,Telde,Las Palmas,699,757,-58
2003,35027,Teror,Las Palmas,31,47,-16
2003,35028,Tías,Las Palmas,527,505,22
2003,35030,Tuineje,Las Palmas,520,383,137
2003,36003,Baiona,Pontevedra,116,93,23
2003,36004,Bueu,Pontevedra,84,85,-1
2003,36006,Cambados,Pontevedra,136,105,31
2003,36008,Cangas,Pontevedra,180,209,-29
2003,36017,A Estrada,Pontevedra,187,269,-82
2003,36021,Gondomar,Pontevedra,53,93,-40
2003,36022,O Grove,Pontevedra,86,118,-32
2003,36023,A Guarda,Pontevedra,92,86,6
2003,36024,Lalín,Pontevedra,233,250,-17
2003,36026,Marín,Pontevedra,313,361,-48
2003,36029,Moaña,Pontevedra,115,101,14
2003,36033,Mos,Pontevedra,56,94,-38
2003,36035,Nigrán,Pontevedra,116,113,3
2003,36038,Pontevedra,Pontevedra,974,1057,-83
2003,36039,O Porriño,Pontevedra,118,163,-45
2003,36041,Poio,Pontevedra,161,149,12
2003,36042,Ponteareas,Pontevedra,296,304,-8
2003,36045,Redondela,Pontevedra,165,235,-70
2003,36051,Sanxenxo,Pontevedra,169,172,-3
2003,36054,Tomiño,Pontevedra,76,91,-15
2003,36055,Tui,Pontevedra,127,173,-46
2003,36057,Vigo,Pontevedra,2824,3592,-768
2003,36060,Vilagarcía de Arousa,Pontevedra,546,453,93
2003,36061,Vilanova de Arousa,Pontevedra,94,95,-1
2003,37046,Béjar,Salamanca,235,301,-66
2003,37107,Ciudad Rodrigo,Salamanca,225,216,9
2003,37274,Salamanca,Salamanca,2199,3047,-848
2003,37294,Santa Marta de Tormes,Salamanca,236,201,35
2003,38001,Adeje,Santa Cruz de Tenerife,1211,900,311
2003,38006,Arona,Santa Cruz de Tenerife,2464,2056,408
2003,38011,Candelaria,Santa Cruz de Tenerife,373,320,53
2003,38017,Granadilla de Abona,Santa Cruz de Tenerife,952,798,154
2003,38019,Guía de Isora,Santa Cruz de Tenerife,259,227,32
2003,38020,Güímar,Santa Cruz de Tenerife,76,115,-39
2003,38022,Icod de los Vinos,Santa Cruz de Tenerife,91,81,10
2003,38023,San Cristóbal de La Laguna,Santa Cruz de Tenerife,1152,1059,93
2003,38024,Los Llanos de Aridane,Santa Cruz de Tenerife,245,237,8
2003,38026,La Orotava,Santa Cruz de Tenerife,174,174,0
2003,38028,Puerto de la Cruz,Santa Cruz de Tenerife,621,553,68
2003,38031,Los Realejos,Santa Cruz de Tenerife,178,130,48
2003,38032,El Rosario,Santa Cruz de Tenerife,199,193,6
2003,38037,Santa Cruz de la Palma,Santa Cruz de Tenerife,325,371,-46
2003,38038,Santa Cruz de Tenerife,Santa Cruz de Tenerife,2658,2831,-173
2003,38039,Santa Úrsula,Santa Cruz de Tenerife,100,76,24
2003,38040,Santiago del Teide,Santa Cruz de Tenerife,123,103,20
2003,38043,Tacoronte,Santa Cruz de Tenerife,103,106,-3
2003,39008,El Astillero,Cantabria,190,96,94
2003,39016,Camargo,Cantabria,284,186,98
2003,39020,Castro-Urdiales,Cantabria,2433,1035,1398
2003,39025,Los Corrales de Buelna,Cantabria,82,106,-24
2003,39035,Laredo,Cantabria,322,230,92
2003,39052,Piélagos,Cantabria,178,119,59
2003,39059,Reinosa,Cantabria,106,143,-37
2003,39075,Santander,Cantabria,2276,2307,-31
2003,39079,Santoña,Cantabria,203,180,23
2003,39087,Torrelavega,Cantabria,425,537,-112
2003,40194,Segovia,Segovia,838,1055,-217
2003,41004,Alcalá de Guadaíra,Sevilla,553,457,96
2003,41007,La Algaba,Sevilla,85,63,22
2003,41011,Arahal,Sevilla,57,76,-19
2003,41017,Bormujos,Sevilla,271,85,186
2003,41018,Brenes,Sevilla,94,76,18
2003,41020,Las Cabezas de San Juan,Sevilla,137,147,-10
2003,41021,Camas,Sevilla,256,213,43
2003,41024,Carmona,Sevilla,187,173,14
2003,41029,Castilleja de la Cuesta,Sevilla,181,170,11
2003,41034,Coria del Río,Sevilla,186,136,50
2003,41038,Dos Hermanas,Sevilla,1229,917,312
2003,41039,Écija,Sevilla,409,331,78
2003,41041,Estepa,Sevilla,84,81,3
2003,41047,Gines,Sevilla,154,120,34
2003,41053,Lebrija,Sevilla,183,162,21
2003,41055,Lora del Río,Sevilla,174,184,-10
2003,41058,Mairena del Alcor,Sevilla,114,79,35
2003,41059,Mairena del Aljarafe,Sevilla,434,346,88
2003,41060,Marchena,Sevilla,136,82,54
2003,41065,Morón de la Frontera,Sevilla,316,280,36
2003,41068,Osuna,Sevilla,137,116,21
2003,41069,Los Palacios y Villafranca,Sevilla,248,183,65
2003,41075,Pilas,Sevilla,62,46,16
2003,41077,La Puebla de Cazalla,Sevilla,211,153,58
2003,41079,La Puebla del Río,Sevilla,86,68,18
2003,41081,La Rinconada,Sevilla,338,218,120
2003,41086,San Juan de Aznalfarache,Sevilla,257,189,68
2003,41087,Sanlúcar la Mayor,Sevilla,108,82,26
2003,41091,Sevilla,Sevilla,6999,7568,-569
2003,41093,Tomares,Sevilla,315,254,61
2003,41095,Utrera,Sevilla,427,317,110
2003,41102,El Viso del Alcor,Sevilla,75,71,4
2003,42173,Soria,Soria,779,791,-12
2003,43014,Amposta,Tarragona,309,226,83
2003,43037,Calafell,Tarragona,1890,781,1109
2003,43038,Cambrils,Tarragona,873,541,332
2003,43123,Reus,Tarragona,1818,1136,682
2003,43136,Sant Carles de la Ràpita,Tarragona,318,181,137
2003,43148,Tarragona,Tarragona,2280,1552,728
2003,43153,Torredembarra,Tarragona,673,354,319
2003,43155,Tortosa,Tarragona,666,478,188
2003,43161,Valls,Tarragona,473,268,205
2003,43163,El Vendrell,Tarragona,1906,895,1011
2003,43171,Vila-seca,Tarragona,472,291,181
2003,43901,Deltebre,Tarragona,90,68,22
2003,43905,Salou,Tarragona,985,578,407
2003,44013,Alcañiz,Teruel,302,269,33
2003,44216,Teruel,Teruel,515,591,-76
2003,45053,Consuegra,Toledo,75,81,-6
2003,45081,Illescas,Toledo,684,323,361
2003,45087,Madridejos,Toledo,97,152,-55
2003,45142,Quintanar de la Orden,Toledo,189,181,8
2003,45163,Sonseca,Toledo,164,170,-6
2003,45165,Talavera de la Reina,Toledo,1110,1237,-127
2003,45168,Toledo,Toledo,1586,1228,358
2003,45173,Torrijos,Toledo,254,115,139
2003,46005,Alaquàs,Valencia,249,190,59
2003,46007,Albal,Valencia,115,89,26
2003,46013,Alboraya,Valencia,265,168,97
2003,46017,Alzira,Valencia,368,299,69
2003,46019,L'Alcúdia,Valencia,52,69,-17
2003,46021,Aldaia,Valencia,174,165,9
2003,46022,Alfafar,Valencia,206,158,48
2003,46029,Algemesí,Valencia,237,160,77
2003,46031,Alginet,Valencia,70,65,5
2003,46054,Benetússer,Valencia,112,71,41
2003,46060,Benifaió,Valencia,84,82,2
2003,46070,Bétera,Valencia,246,150,96
2003,46078,Burjassot,Valencia,413,323,90
2003,46081,Canals,Valencia,47,71,-24
2003,46083,Carcaixent,Valencia,114,127,-13
2003,46085,Carlet,Valencia,98,75,23
2003,46094,Catarroja,Valencia,246,132,114
2003,46102,Quart de Poblet,Valencia,209,200,9
2003,46105,Cullera,Valencia,301,252,49
2003,46110,Xirivella,Valencia,326,228,98
2003,46111,Chiva,Valencia,181,130,51
2003,46116,L'Eliana,Valencia,174,133,41
2003,46131,Gandia,Valencia,554,821,-267
2003,46135,Godella,Valencia,120,85,35
2003,46145,Xátiva,Valencia,236,179,57
2003,46147,Llíria,Valencia,298,208,90
2003,46159,Manises,Valencia,291,168,123
2003,46164,Massamagrell,Valencia,87,83,4
2003,46169,Mislata,Valencia,565,426,139
2003,46171,Moncada,Valencia,182,122,60
2003,46181,Oliva,Valencia,428,317,111
2003,46184,Ontinyent,Valencia,282,357,-75
2003,46186,Paiporta,Valencia,168,145,23
2003,46190,Paterna,Valencia,707,427,280
2003,46194,Picassent,Valencia,107,88,19
2003,46202,La Pobla de Vallbona,Valencia,154,104,50
2003,46205,Puçol,Valencia,217,134,83
2003,46213,Requena,Valencia,137,180,-43
2003,46214,Riba-roja de Túria,Valencia,265,136,129
2003,46220,Sagunto/Sagunt,Valencia,1072,602,470
2003,46230,Silla,Valencia,168,111,57
2003,46235,Sueca,Valencia,136,159,-23
2003,46238,Tavernes de la Valldigna,Valencia,137,111,26
2003,46244,Torrent (Valencia),Valencia,789,469,320
2003,46249,Utiel,Valencia,92,96,-4
2003,46250,València,Valencia,12073,9631,2442
2003,47076,Laguna de Duero,Valladolid,221,231,-10
2003,47085,Medina del Campo,Valladolid,265,261,4
2003,47186,Valladolid,Valladolid,3790,4963,-1173
2003,48003,Amorebieta-Etxano,Vizcaya,107,109,-2
2003,48011,Arrigorriaga,Vizcaya,121,129,-8
2003,48013,Barakaldo,Vizcaya,882,1038,-156
2003,48015,Basauri,Vizcaya,296,538,-242
2003,48017,Bermeo,Vizcaya,100,122,-22
2003,48020,Bilbao,Vizcaya,4045,4815,-770
2003,48027,Durango,Vizcaya,281,245,36
2003,48034,Ermua,Vizcaya,211,334,-123
2003,48036,Galdakao,Vizcaya,183,289,-106
2003,48044,Getxo,Vizcaya,842,1154,-312
2003,48046,Gernika-Lumo,Vizcaya,93,104,-11
2003,48054,Leioa,Vizcaya,205,392,-187
2003,48069,Mungia,Vizcaya,116,154,-38
2003,48078,Portugalete,Vizcaya,363,633,-270
2003,48080,Valle de Trápaga-Trapagaran,Vizcaya,66,137,-71
2003,48082,Santurtzi,Vizcaya,353,608,-255
2003,48084,Sestao,Vizcaya,241,443,-202
2003,48085,Sopela,Vizcaya,98,149,-51
2003,48902,Erandio,Vizcaya,171,218,-47
2003,49021,Benavente,Zamora,403,365,38
2003,49275,Zamora,Zamora,827,1023,-196
2003,50067,Calatayud,Zaragoza,364,441,-77
2003,50095,Ejea de los Caballeros,Zaragoza,177,192,-15
2003,50251,Tarazona,Zaragoza,207,165,42
2003,50272,Utebo,Zaragoza,185,202,-17
2003,50297,Zaragoza,Zaragoza,7379,7948,-569
2003,51001,Ceuta,Ceuta,1959,2755,-796
2003,52001,Melilla,Melilla,1990,2705,-715
2004,01036,Laudio/Llodio,Álava,223,328,-105
2004,01059,Vitoria-Gasteiz,Álava,3680,3454,226
2004,02003,Albacete,Albacete,2251,2421,-170
2004,02009,Almansa,Albacete,451,441,10
2004,02037,Hellín,Albacete,550,690,-140
2004,02069,La Roda,Albacete,224,216,8
2004,02081,Villarrobledo,Albacete,268,458,-190
2004,03005,Albatera,Alicante,108,95,13
2004,03009,Alcoy/Alcoi,Alicante,545,543,2
2004,03011,L'Alfàs del Pi,Alicante,326,182,144
2004,03014,Alicante/Alacant,Alicante,6602,4723,1879
2004,03015,Almoradí,Alicante,243,124,119
2004,03018,Altea,Alicante,476,341,135
2004,03019,Aspe,Alicante,150,131,19
2004,03031,Benidorm,Alicante,2543,1872,671
2004,03041,Benissa,Alicante,115,94,21
2004,03047,Calp,Alicante,473,396,77
2004,03049,Callosa de Segura,Alicante,195,119,76
2004,03050,El Campello,Alicante,481,326,155
2004,03056,Cocentaina,Alicante,83,109,-26
2004,03059,Crevillent,Alicante,276,191,85
2004,03063,Dénia,Alicante,916,766,150
2004,03065,Elche/Elx,Alicante,2602,1842,760
2004,03066,Elda,Alicante,463,525,-62
2004,03076,Guardamar del Segura,Alicante,370,228,142
2004,03079,Ibi,Alicante,196,183,13
2004,03082,Jávea/Xàbia,Alicante,557,449,108
2004,03089,Monóvar/Monòver,Alicante,102,100,2
2004,03090,Mutxamel,Alicante,229,165,64
2004,03093,Novelda,Alicante,242,168,74
2004,03094,La Nucia,Alicante,276,186,90
2004,03099,Orihuela,Alicante,1217,1233,-16
2004,03102,Pego,Alicante,93,149,-56
2004,03104,Petrer,Alicante,219,253,-34
2004,03113,Rojales,Alicante,145,79,66
2004,03119,Sant Joan d'Alacant,Alicante,384,241,143
2004,03121,Santa Pola,Alicante,753,411,342
2004,03122,San Vicente del Raspeig/Sant Vicent del Raspeig,Alicante,504,400,104
2004,03128,Teulada,Alicante,197,171,26
2004,03133,Torrevieja,Alicante,4212,2784,1428
2004,03139,Villajoyosa/La Vila Joiosa,Alicante,554,324,230
2004,03140,Villena,Alicante,377,343,34
2004,03902,Pilar de la Horadada,Alicante,643,559,84
2004,04003,Adra,Almería,264,241,23
2004,04006,Albox,Almería,345,293,52
2004,04013,Almería,Almería,2629,2607,22
2004,04029,Berja,Almería,128,146,-18
2004,04035,Cuevas del Almanzora,Almería,200,185,15
2004,04052,Huércal de Almería,Almería,139,111,28
2004,04053,Huércal-Overa,Almería,262,228,34
2004,04066,Níjar,Almería,432,686,-254
2004,04079,Roquetas de Mar,Almería,1880,1962,-82
2004,04102,Vícar,Almería,456,489,-33
2004,04902,El Ejido,Almería,1016,2109,-1093
2004,05019,Ávila,Ávila,788,923,-135
2004,06011,Almendralejo,Badajoz,391,436,-45
2004,06015,Badajoz,Badajoz,2204,2032,172
2004,06044,Don Benito,Badajoz,557,381,176
2004,06083,Mérida,Badajoz,803,733,70
2004,06088,Montijo,Badajoz,168,140,28
2004,06095,Olivenza,Badajoz,235,100,135
2004,06149,Villafranca de los Barros,Badajoz,166,108,58
2004,06153,Villanueva de la Serena,Badajoz,315,270,45
2004,06158,Zafra,Badajoz,212,209,3
2004,07003,Alcúdia,Baleares,591,615,-24
2004,07011,Calvià,Baleares,653,1016,-363
2004,07015,Ciutadella de Menorca,Baleares,995,768,227
2004,07022,Felanitx,Baleares,226,270,-44
2004,07026,Eivissa,Baleares,1699,1543,156
2004,07027,Inca,Baleares,329,461,-132
2004,07031,Llucmajor,Baleares,496,538,-42
2004,07032,Maó-Mahón,Baleares,1041,811,230
2004,07033,Manacor,Baleares,553,822,-269
2004,07036,Marratxí,Baleares,169,232,-63
2004,07040,Palma,Baleares,7329,8578,-1249
2004,07042,Pollença,Baleares,236,276,-40
2004,07044,Sa Pobla,Baleares,75,117,-42
2004,07046,Sant Antoni de Portmany,Baleares,459,431,28
2004,07048,Sant Josep de sa Talaia,Baleares,734,492,242
2004,07054,Santa Eulària des Riu,Baleares,862,768,94
2004,07057,Santanyí,Baleares,223,307,-84
2004,07061,Sóller,Baleares,109,110,-1
2004,07062,Son Servera,Baleares,280,336,-56
2004,08006,Arenys de Mar,Barcelona,154,182,-28
2004,08009,Argentona,Barcelona,39,105,-66
2004,08015,Badalona,Barcelona,1862,3334,-1472
2004,08019,Barcelona,Barcelona,17603,23390,-5787
2004,08022,Berga,Barcelona,143,136,7
2004,08033,Caldes de Montbui,Barcelona,117,120,-3
2004,08035,Calella,Barcelona,243,338,-95
2004,08040,Canet de Mar,Barcelona,113,130,-17
2004,08041,Canovelles,Barcelona,141,256,-115
2004,08046,Cardedeu,Barcelona,103,96,7
2004,08051,Castellar del Vallès,Barcelona,146,159,-13
2004,08054,Castellbisbal,Barcelona,88,126,-38
2004,08056,Castelldefels,Barcelona,866,1247,-381
2004,08072,Corbera de Llobregat,Barcelona,79,98,-19
2004,08073,Cornellà de Llobregat,Barcelona,664,1168,-504
2004,08076,Esparreguera,Barcelona,163,256,-93
2004,08077,Esplugues de Llobregat,Barcelona,456,590,-134
2004,08086,Les Franqueses del Vallès,Barcelona,94,183,-89
2004,08088,La Garriga,Barcelona,85,87,-2
2004,08089,Gavà,Barcelona,387,714,-327
2004,08096,Granollers,Barcelona,620,775,-155
2004,08101,L'Hospitalet de Llobregat,Barcelona,2522,3963,-1441
2004,08102,Igualada,Barcelona,379,446,-67
2004,08105,La Llagosta,Barcelona,122,198,-76
2004,08107,Lliçà d'Amunt,Barcelona,49,97,-48
2004,08110,Malgrat de Mar,Barcelona,257,316,-59
2004,08112,Manlleu,Barcelona,198,185,13
2004,08113,Manresa,Barcelona,775,692,83
2004,08114,Martorell,Barcelona,307,377,-70
2004,08118,El Masnou,Barcelona,117,200,-83
2004,08121,Mataró,Barcelona,999,1589,-590
2004,08123,Molins de Rei,Barcelona,156,267,-111
2004,08124,Mollet del Vallès,Barcelona,523,828,-305
2004,08125,Montcada i Reixac,Barcelona,226,321,-95
2004,08136,Montornès del Vallès,Barcelona,117,209,-92
2004,08147,Olesa de Montserrat,Barcelona,166,246,-80
2004,08156,Palau-solità i Plegamans,Barcelona,61,118,-57
2004,08159,Parets del Vallès,Barcelona,105,168,-63
2004,08161,Piera,Barcelona,106,117,-11
2004,08163,Pineda de Mar,Barcelona,346,493,-147
2004,08169,El Prat de Llobregat,Barcelona,527,960,-433
2004,08172,Premià de Mar,Barcelona,224,402,-178
2004,08180,Ripollet,Barcelona,307,578,-271
2004,08184,Rubí,Barcelona,595,939,-344
2004,08187,Sabadell,Barcelona,1714,2275,-561
2004,08194,Sant Adrià de Besòs,Barcelona,255,447,-192
2004,08196,Sant Andreu de la Barca,Barcelona,222,394,-172
2004,08200,Sant Boi de Llobregat,Barcelona,632,1237,-605
2004,08202,Sant Celoni,Barcelona,233,244,-11
2004,08205,Sant Cugat del Vallès,Barcelona,590,709,-119
2004,08211,Sant Feliu de Llobregat,Barcelona,313,538,-225
2004,08217,Sant Joan Despí,Barcelona,262,361,-99
2004,08219,Vilassar de Mar,Barcelona,147,235,-88
2004,08221,Sant Just Desvern,Barcelona,184,145,39
2004,08231,Sant Pere de Ribes,Barcelona,273,448,-175
2004,08238,Sant Quirze del Vallès,Barcelona,134,126,8
2004,08240,Sant Sadurní d'Anoia,Barcelona,96,164,-68
2004,08245,Santa Coloma de Gramenet,Barcelona,1076,1955,-879
2004,08252,Barberà del Vallès,Barcelona,239,316,-77
2004,08260,Santa Perpètua de Mogoda,Barcelona,187,249,-62
2004,08263,Sant Vicenç dels Horts,Barcelona,155,335,-180
2004,08266,Cerdanyola del Vallès,Barcelona,431,648,-217
2004,08270,Sitges,Barcelona,376,335,41
2004,08279,Terrassa,Barcelona,1706,2296,-590
2004,08284,Tordera,Barcelona,338,287,51
2004,08285,Torelló,Barcelona,99,112,-13
2004,08295,Vallirana,Barcelona,74,121,-47
2004,08298,Vic,Barcelona,603,499,104
2004,08301,Viladecans,Barcelona,479,1062,-583
2004,08302,Vilanova del Camí,Barcelona,73,132,-59
2004,08305,Vilafranca del Penedès,Barcelona,509,522,-13
2004,08307,Vilanova i la Geltrú,Barcelona,829,990,-161
2004,08904,Badia del Vallès,Barcelona,129,244,-115
2004,09018,Aranda de Duero,Burgos,558,611,-53
2004,09059,Burgos,Burgos,2335,2545,-210
2004,09219,Miranda de Ebro,Burgos,852,897,-45
2004,10037,Cáceres,Cáceres,1324,1384,-60
2004,10067,Coria,Cáceres,180,196,-16
2004,10131,Navalmoral de la Mata,Cáceres,394,472,-78
2004,10148,Plasencia,Cáceres,703,566,137
2004,10180,Talayuela,Cáceres,212,527,-315
2004,11004,Algeciras,Cádiz,1931,1596,335
2004,11006,Arcos de la Frontera,Cádiz,394,231,163
2004,11007,Barbate,Cádiz,298,327,-29
2004,11008,Los Barrios,Cádiz,423,196,227
2004,11012,Cádiz,Cádiz,1423,1596,-173
2004,11014,Conil de la Frontera,Cádiz,271,151,120
2004,11015,Chiclana de la Frontera,Cádiz,1153,636,517
2004,11016,Chipiona,Cádiz,253,194,59
2004,11020,Jerez de la Frontera,Cádiz,3213,2128,1085
2004,11022,La Línea de la Concepción,Cádiz,730,678,52
2004,11023,Medina-Sidonia,Cádiz,77,51,26
2004,11027,El Puerto de Santa María,Cádiz,1523,1234,289
2004,11028,Puerto Real,Cádiz,397,359,38
2004,11030,Rota,Cádiz,397,341,56
2004,11031,San Fernando,Cádiz,1353,1105,248
2004,11032,Sanlúcar de Barrameda,Cádiz,571,365,206
2004,11033,San Roque,Cádiz,438,381,57
2004,11035,Tarifa,Cádiz,445,240,205
2004,11038,Ubrique,Cádiz,114,193,-79
2004,11039,Vejer de la Frontera,Cádiz,130,60,70
2004,11041,Villamartín,Cádiz,159,152,7
2004,12005,L'Alcora,Castellón,173,133,40
2004,12009,Almassora,Castellón,197,203,-6
2004,12027,Benicarló,Castellón,579,480,99
2004,12028,Benicasim/Benicàssim,Castellón,378,300,78
2004,12032,Borriana/Burriana,Castellón,553,402,151
2004,12040,Castellón de la Plana/Castelló de la Plana,Castellón,2500,2531,-31
2004,12082,Nules,Castellón,170,102,68
2004,12084,Onda,Castellón,328,209,119
2004,12126,La Vall d'Uixó,Castellón,317,312,5
2004,12135,Vila-real,Castellón,644,514,130
2004,12138,Vinaròs,Castellón,673,597,76
2004,13005,Alcázar de San Juan,Ciudad Real,623,492,131
2004,13023,Bolaños de Calatrava,Ciudad Real,137,238,-101
2004,13028,Campo de Criptana,Ciudad Real,130,152,-22
2004,13034,Ciudad Real,Ciudad Real,1264,966,298
2004,13039,Daimiel,Ciudad Real,184,163,21
2004,13053,Manzanares,Ciudad Real,271,289,-18
2004,13056,Miguelturra,Ciudad Real,139,100,39
2004,13071,Puertollano,Ciudad Real,787,891,-104
2004,13078,Socuéllamos,Ciudad Real,202,348,-146
2004,13079,La Solana,Ciudad Real,146,136,10
2004,13082,Tomelloso,Ciudad Real,273,412,-139
2004,13087,Valdepeñas,Ciudad Real,429,396,33
2004,14002,Aguilar de la Frontera,Córdoba,103,95,8
2004,14007,Baena,Córdoba,305,324,-19
2004,14013,Cabra,Córdoba,217,155,62
2004,14017,La Carlota,Córdoba,189,114,75
2004,14021,Córdoba,Córdoba,3502,4079,-577
2004,14030,Fuente Palmera,Córdoba,143,117,26
2004,14038,Lucena,Córdoba,474,454,20
2004,14042,Montilla,Córdoba,199,158,41
2004,14049,Palma del Río,Córdoba,345,331,14
2004,14052,Peñarroya-Pueblonuevo,Córdoba,161,252,-91
2004,14054,Pozoblanco,Córdoba,164,162,2
2004,14055,Priego de Córdoba,Córdoba,308,317,-9
2004,14056,Puente Genil,Córdoba,311,399,-88
2004,15002,Ames,A Coruña,477,322,155
2004,15005,Arteixo,A Coruña,289,260,29
2004,15009,Betanzos,A Coruña,86,97,-11
2004,15011,Boiro,A Coruña,169,144,25
2004,15017,Cambre,A Coruña,213,158,55
2004,15019,Carballo,A Coruña,181,260,-79
2004,15030,A Coruña,A Coruña,2852,3035,-183
2004,15031,Culleredo,A Coruña,417,219,198
2004,15035,Fene,A Coruña,94,117,-23
2004,15036,Ferrol,A Coruña,1029,1134,-105
2004,15041,A Laracha,A Coruña,45,50,-5
2004,15053,Muros,A Coruña,107,83,24
2004,15054,Narón,A Coruña,393,317,76
2004,15057,Noia,A Coruña,171,154,17
2004,15058,Oleiros,A Coruña,470,342,128
2004,15059,Ordes,A Coruña,63,95,-32
2004,15070,As Pontes de García Rodríguez,A Coruña,88,131,-43
2004,15071,Porto do Son,A Coruña,117,113,4
2004,15072,Rianxo,A Coruña,99,83,16
2004,15073,Ribeira,A Coruña,261,229,32
2004,15075,Sada (A Coruña),A Coruña,214,134,80
2004,15077,Santa Comba,A Coruña,38,64,-26
2004,15078,Santiago de Compostela,A Coruña,1287,1119,168
2004,15082,Teo,A Coruña,218,162,56
2004,16078,Cuenca,Cuenca,1052,815,237
2004,16203,Tarancón,Cuenca,395,299,96
2004,17015,Banyoles,Girona,242,186,56
2004,17023,Blanes,Girona,1539,1218,321
2004,17066,Figueres,Girona,871,561,310
2004,17079,Girona,Girona,2123,1377,746
2004,17095,Lloret de Mar,Girona,1615,968,647
2004,17114,Olot,Girona,662,402,260
2004,17117,Palafrugell,Girona,421,312,109
2004,17118,Palamós,Girona,390,235,155
2004,17147,Ripoll,Girona,166,185,-19
2004,17152,Roses,Girona,391,249,142
2004,17155,Salt,Girona,878,513,365
2004,17160,Sant Feliu de Guíxols,Girona,438,316,122
2004,17180,Santa Coloma de Farners,Girona,262,114,148
2004,18003,Albolote,Granada,266,129,137
2004,18017,Almuñécar,Granada,421,338,83
2004,18021,Armilla,Granada,507,226,281
2004,18022,Atarfe,Granada,196,131,65
2004,18023,Baza,Granada,438,381,57
2004,18087,Granada,Granada,3275,3916,-641
2004,18089,Guadix,Granada,294,274,20
2004,18101,Huétor Vega,Granada,140,86,54
2004,18102,Illora,Granada,123,92,31
2004,18122,Loja,Granada,200,244,-44
2004,18127,Maracena,Granada,275,170,105
2004,18140,Motril,Granada,680,672,8
2004,18145,Ogíjares,Granada,213,91,122
2004,18158,Pinos Puente,Granada,124,107,17
2004,18173,Salobreña,Granada,190,143,47
2004,18175,Santa Fe,Granada,232,146,86
2004,18193,La Zubia,Granada,242,146,96
2004,18905,Las Gabias,Granada,207,78,129
2004,19046,Azuqueca de Henares,Guadalajara,1490,795,695
2004,19130,Guadalajara,Guadalajara,1688,1375,313
2004,20009,Andoain,Guipúzcoa,93,135,-42
2004,20017,Azkoitia,Guipúzcoa,74,63,11
2004,20018,Azpeitia,Guipúzcoa,77,68,9
2004,20019,Beasain,Guipúzcoa,115,106,9
2004,20030,Eibar,Guipúzcoa,306,393,-87
2004,20032,Elgoibar,Guipúzcoa,82,100,-18
2004,20036,Hondarribia,Guipúzcoa,173,157,16
2004,20040,Hernani,Guipúzcoa,118,118,0
2004,20045,Irun,Guipúzcoa,788,782,6
2004,20055,Arrasate/Mondragón,Guipúzcoa,187,379,-192
2004,20059,Oñati,Guipúzcoa,54,86,-32
2004,20064,Pasaia,Guipúzcoa,122,149,-27
2004,20067,Errenteria,Guipúzcoa,217,346,-129
2004,20069,Donostia/San Sebastián,Guipúzcoa,1843,1939,-96
2004,20071,Tolosa,Guipúzcoa,119,132,-13
2004,20074,Bergara,Guipúzcoa,134,170,-36
2004,20079,Zarautz,Guipúzcoa,241,215,26
2004,20080,Zumarraga,Guipúzcoa,65,97,-32
2004,20902,Lasarte-Oria,Guipúzcoa,164,208,-44
2004,21002,Aljaraque,Huelva,191,151,40
2004,21005,Almonte,Huelva,265,314,-49
2004,21010,Ayamonte,Huelva,300,233,67
2004,21013,Bollullos Par del Condado,Huelva,113,106,7
2004,21021,Cartaya,Huelva,348,310,38
2004,21035,Gibraleón,Huelva,103,87,16
2004,21041,Huelva,Huelva,1552,1596,-44
2004,21042,Isla Cristina,Huelva,335,253,82
2004,21044,Lepe,Huelva,443,405,38
2004,21050,Moguer,Huelva,406,447,-41
2004,21060,Punta Umbría,Huelva,229,132,97
2004,21072,Valverde del Camino,Huelva,76,96,-20
2004,22048,Barbastro,Huesca,221,249,-28
2004,22112,Fraga,Huesca,286,350,-64
2004,22125,Huesca,Huesca,928,793,135
2004,22130,Jaca,Huesca,407,376,31
2004,22158,Monzón,Huesca,249,267,-18
2004,23002,Alcalá la Real,Jaén,395,372,23
2004,23003,Alcaudete,Jaén,150,145,5
2004,23005,Andújar,Jaén,534,527,7
2004,23009,Baeza,Jaén,197,178,19
2004,23010,Bailén,Jaén,168,201,-33
2004,23024,La Carolina,Jaén,247,224,23
2004,23050,Jaén,Jaén,1022,1450,-428
2004,23053,Jódar,Jaén,112,147,-35
2004,23055,Linares,Jaén,854,922,-68
2004,23060,Martos,Jaén,217,216,1
2004,23086,Torredelcampo,Jaén,116,110,6
2004,23087,Torredonjimeno,Jaén,126,136,-10
2004,23092,Úbeda,Jaén,509,403,106
2004,23095,Villacarrillo,Jaén,138,173,-35
2004,24008,Astorga,León,154,217,-63
2004,24010,La Bañeza,León,182,172,10
2004,24089,León,León,1957,2451,-494
2004,24115,Ponferrada,León,882,907,-25
2004,24142,San Andrés del Rabanedo,León,408,377,31
2004,24202,Villablino,León,110,254,-144
2004,24222,Villaquilambre,León,216,140,76
2004,25040,Balaguer,Lleida,361,289,72
2004,25120,Lleida,Lleida,3074,2894,180
2004,25137,Mollerussa,Lleida,269,251,18
2004,25203,La Seu d'Urgell,Lleida,433,358,75
2004,25217,Tàrrega,Lleida,475,406,69
2004,26018,Arnedo,La Rioja,168,208,-40
2004,26036,Calahorra,La Rioja,725,548,177
2004,26071,Haro,La Rioja,412,202,210
2004,26089,Logroño,La Rioja,2965,2690,275
2004,27028,Lugo,Lugo,1255,1269,-14
2004,27031,Monforte de Lemos,Lugo,313,350,-37
2004,27057,Sarria,Lugo,143,148,-5
2004,27065,Vilalba,Lugo,107,132,-25
2004,27066,Viveiro,Lugo,210,217,-7
2004,28005,Alcalá de Henares,Madrid,2743,4931,-2188
2004,28006,Alcobendas,Madrid,1174,1408,-234
2004,28007,Alcorcón,Madrid,1390,2164,-774
2004,28009,Algete,Madrid,100,326,-226
2004,28010,Alpedrete,Madrid,148,154,-6
2004,28013,Aranjuez,Madrid,786,907,-121
2004,28014,Arganda del Rey,Madrid,489,602,-113
2004,28022,Boadilla del Monte,Madrid,436,412,24
2004,28040,Ciempozuelos,Madrid,175,297,-122
2004,28045,Colmenar Viejo,Madrid,356,612,-256
2004,28047,Collado Villalba,Madrid,604,1074,-470
2004,28049,Coslada,Madrid,481,1085,-604
2004,28054,El Escorial,Madrid,145,171,-26
2004,28058,Fuenlabrada,Madrid,1787,4032,-2245
2004,28061,Galapagar,Madrid,403,570,-167
2004,28065,Getafe,Madrid,1308,2431,-1123
2004,28068,Guadarrama,Madrid,187,224,-37
2004,28073,Humanes de Madrid,Madrid,251,423,-172
2004,28074,Leganés,Madrid,1430,2479,-1049
2004,28079,Madrid,Madrid,36939,53420,-16481
2004,28080,Majadahonda,Madrid,820,933,-113
2004,28084,Mejorada del Campo,Madrid,170,255,-85
2004,28092,Móstoles,Madrid,1859,3721,-1862
2004,28096,Navalcarnero,Madrid,191,252,-61
2004,28106,Parla,Madrid,1073,2051,-978
2004,28113,Pinto,Madrid,532,520,12
2004,28115,Pozuelo de Alarcón,Madrid,758,809,-51
2004,28123,Rivas-Vaciamadrid,Madrid,456,463,-7
2004,28127,Las Rozas de Madrid,Madrid,1028,955,73
2004,28130,San Fernando de Henares,Madrid,241,531,-290
2004,28131,San Lorenzo de El Escorial,Madrid,166,234,-68
2004,28132,San Martín de la Vega,Madrid,212,382,-170
2004,28134,San Sebastián de los Reyes,Madrid,577,916,-339
2004,28148,Torrejón de Ardoz,Madrid,1207,2291,-1084
2004,28152,Torrelodones,Madrid,149,204,-55
2004,28161,Valdemoro,Madrid,771,982,-211
2004,28176,Villanueva de la Cañada,Madrid,211,221,-10
2004,28181,Villaviciosa de Odón,Madrid,177,294,-117
2004,28903,Tres Cantos,Madrid,469,570,-101
2004,29007,Alhaurín de la Torre,Málaga,343,217,126
2004,29008,Alhaurín el Grande,Málaga,136,96,40
2004,29012,Álora,Málaga,89,60,29
2004,29015,Antequera,Málaga,439,305,134
2004,29025,Benalmádena,Málaga,1142,590,552
2004,29038,Cártama,Málaga,157,58,99
2004,29042,Coín,Málaga,240,170,70
2004,29051,Estepona,Málaga,2098,1019,1079
2004,29054,Fuengirola,Málaga,1861,869,992
2004,29067,Málaga,Málaga,6042,4796,1246
2004,29069,Marbella,Málaga,3096,1819,1277
2004,29070,Mijas,Málaga,1010,529,481
2004,29075,Nerja,Málaga,230,204,26
2004,29082,Rincón de la Victoria,Málaga,662,373,289
2004,29084,Ronda,Málaga,549,397,152
2004,29091,Torrox,Málaga,223,106,117
2004,29094,Vélez-Málaga,Málaga,1038,485,553
2004,29901,Torremolinos,Málaga,1455,975,480
2004,30002,Abarán,Murcia,109,138,-29
2004,30003,Águilas,Murcia,643,516,127
2004,30005,Alcantarilla,Murcia,426,321,105
2004,30008,Alhama de Murcia,Murcia,266,199,67
2004,30009,Archena,Murcia,274,200,74
2004,30012,Bullas,Murcia,130,91,39
2004,30015,Caravaca de la Cruz,Murcia,372,334,38
2004,30016,Cartagena,Murcia,3084,2735,349
2004,30017,Cehegín,Murcia,184,106,78
2004,30019,Cieza (Murcia),Murcia,248,265,-17
2004,30021,Fuente Álamo de Murcia,Murcia,272,204,68
2004,30022,Jumilla,Murcia,406,417,-11
2004,30024,Lorca,Murcia,1769,1561,208
2004,30026,Mazarrón,Murcia,832,682,150
2004,30027,Molina de Segura,Murcia,804,530,274
2004,30029,Mula,Murcia,219,186,33
2004,30030,Murcia,Murcia,5092,4062,1030
2004,30033,Puerto Lumbreras,Murcia,177,132,45
2004,30035,San Javier,Murcia,946,709,237
2004,30036,San Pedro del Pinatar,Murcia,699,505,194
2004,30037,Torre-Pacheco,Murcia,393,567,-174
2004,30038,Las Torres de Cotillas,Murcia,243,154,89
2004,30039,Totana,Murcia,403,362,41
2004,30041,La Unión,Murcia,150,139,11
2004,30043,Yecla,Murcia,558,470,88
2004,30901,Santomera,Murcia,250,172,78
2004,30902,Los Alcázares,Murcia,475,374,101
2004,31060,Burlada/Burlata,Navarra,191,169,22
2004,31097,Estella-Lizarra,Navarra,172,167,5
2004,31201,Pamplona/Iruña,Navarra,2457,2465,-8
2004,31227,Tafalla,Navarra,96,110,-14
2004,31232,Tudela,Navarra,669,687,-18
2004,31258,Villava/Atarrabia,Navarra,80,86,-6
2004,31901,Barañain,Navarra,348,283,65
2004,31907,Zizur Mayor/Zizur Nagusia,Navarra,147,130,17
2004,32009,O Barco de Valdeorras,Ourense,204,260,-56
2004,32019,O Carballiño,Ourense,152,165,-13
2004,32054,Ourense,Ourense,1347,1895,-548
2004,32085,Verín,Ourense,278,347,-69
2004,33002,Aller,Asturias,53,89,-36
2004,33004,Avilés,Asturias,680,802,-122
2004,33011,Cangas del Narcea,Asturias,62,125,-63
2004,33014,Carreño,Asturias,69,54,15
2004,33016,Castrillón,Asturias,164,179,-15
2004,33020,Corvera de Asturias,Asturias,108,153,-45
2004,33024,Gijón,Asturias,2781,3030,-249
2004,33025,Gozón,Asturias,57,58,-1
2004,33026,Grado,Asturias,53,67,-14
2004,33031,Langreo,Asturias,247,342,-95
2004,33032,Laviana,Asturias,70,72,-2
2004,33033,Lena,Asturias,91,115,-24
2004,33034,Valdés,Asturias,86,84,2
2004,33035,Llanera,Asturias,88,96,-8
2004,33036,Llanes,Asturias,209,138,71
2004,33037,Mieres (Asturias),Asturias,264,363,-99
2004,33044,Oviedo,Asturias,2352,2484,-132
2004,33060,San Martín del Rey Aurelio,Asturias,98,121,-23
2004,33066,Siero,Asturias,356,369,-13
2004,33073,Tineo,Asturias,38,66,-28
2004,33076,Villaviciosa,Asturias,146,57,89
2004,34120,Palencia,Palencia,1023,1318,-295
2004,35002,Agüimes,Las Palmas,295,294,1
2004,35004,Arrecife,Las Palmas,1661,1617,44
2004,35006,Arucas,Las Palmas,108,161,-53
2004,35009,Gáldar,Las Palmas,73,71,2
2004,35011,Ingenio,Las Palmas,153,170,-17
2004,35012,Mogán,Las Palmas,175,294,-119
2004,35014,La Oliva,Las Palmas,825,660,165
2004,35015,Pájara,Las Palmas,1496,1386,110
2004,35016,Las Palmas de Gran Canaria,Las Palmas,4531,5190,-659
2004,35017,Puerto del Rosario,Las Palmas,1579,1273,306
2004,35018,San Bartolomé,Las Palmas,592,617,-25
2004,35019,San Bartolomé de Tirajana,Las Palmas,507,619,-112
2004,35021,Santa Brígida,Las Palmas,135,129,6
2004,35022,Santa Lucía de Tirajana,Las Palmas,808,816,-8
2004,35023,Santa María de Guía de Gran Canaria,Las Palmas,32,56,-24
2004,35024,Teguise,Las Palmas,414,318,96
2004,35026,Telde,Las Palmas,776,825,-49
2004,35027,Teror,Las Palmas,33,47,-14
2004,35028,Tías,Las Palmas,558,595,-37
2004,35030,Tuineje,Las Palmas,515,421,94
2004,36003,Baiona,Pontevedra,133,108,25
2004,36004,Bueu,Pontevedra,59,75,-16
2004,36006,Cambados,Pontevedra,90,127,-37
2004,36008,Cangas,Pontevedra,201,202,-1
2004,36017,A Estrada,Pontevedra,231,274,-43
2004,36021,Gondomar,Pontevedra,95,100,-5
2004,36022,O Grove,Pontevedra,112,119,-7
2004,36023,A Guarda,Pontevedra,82,91,-9
2004,36024,Lalín,Pontevedra,225,304,-79
2004,36026,Marín,Pontevedra,339,406,-67
2004,36029,Moaña,Pontevedra,73,152,-79
2004,36033,Mos,Pontevedra,60,87,-27
2004,36035,Nigrán,Pontevedra,162,132,30
2004,36038,Pontevedra,Pontevedra,919,1108,-189
2004,36039,O Porriño,Pontevedra,144,130,14
2004,36041,Poio,Pontevedra,177,149,28
2004,36042,Ponteareas,Pontevedra,302,279,23
2004,36045,Redondela,Pontevedra,178,215,-37
2004,36051,Sanxenxo,Pontevedra,159,156,3
2004,36054,Tomiño,Pontevedra,72,115,-43
2004,36055,Tui,Pontevedra,198,171,27
2004,36057,Vigo,Pontevedra,3038,3534,-496
2004,36060,Vilagarcía de Arousa,Pontevedra,517,406,111
2004,36061,Vilanova de Arousa,Pontevedra,122,96,26
2004,37046,Béjar,Salamanca,255,254,1
2004,37107,Ciudad Rodrigo,Salamanca,216,248,-32
2004,37274,Salamanca,Salamanca,2247,3033,-786
2004,37294,Santa Marta de Tormes,Salamanca,251,245,6
2004,38001,Adeje,Santa Cruz de Tenerife,1237,1114,123
2004,38006,Arona,Santa Cruz de Tenerife,2802,2284,518
2004,38011,Candelaria,Santa Cruz de Tenerife,439,346,93
2004,38017,Granadilla de Abona,Santa Cruz de Tenerife,991,936,55
2004,38019,Guía de Isora,Santa Cruz de Tenerife,220,221,-1
2004,38020,Güímar,Santa Cruz de Tenerife,69,83,-14
2004,38022,Icod de los Vinos,Santa Cruz de Tenerife,102,111,-9
2004,38023,San Cristóbal de La Laguna,Santa Cruz de Tenerife,1287,1081,206
2004,38024,Los Llanos de Aridane,Santa Cruz de Tenerife,185,220,-35
2004,38026,La Orotava,Santa Cruz de Tenerife,205,216,-11
2004,38028,Puerto de la Cruz,Santa Cruz de Tenerife,721,554,167
2004,38031,Los Realejos,Santa Cruz de Tenerife,190,188,2
2004,38032,El Rosario,Santa Cruz de Tenerife,174,202,-28
2004,38035,San Miguel de Abona,Santa Cruz de Tenerife,178,157,21
2004,38037,Santa Cruz de la Palma,Santa Cruz de Tenerife,341,347,-6
2004,38038,Santa Cruz de Tenerife,Santa Cruz de Tenerife,2967,2855,112
2004,38039,Santa Úrsula,Santa Cruz de Tenerife,127,102,25
2004,38040,Santiago del Teide,Santa Cruz de Tenerife,131,142,-11
2004,38043,Tacoronte,Santa Cruz de Tenerife,110,110,0
2004,38046,Tegueste,Santa Cruz de Tenerife,43,40,3
2004,39008,El Astillero,Cantabria,144,144,0
2004,39016,Camargo,Cantabria,289,214,75
2004,39020,Castro-Urdiales,Cantabria,2465,1134,1331
2004,39025,Los Corrales de Buelna,Cantabria,88,91,-3
2004,39035,Laredo,Cantabria,322,286,36
2004,39052,Piélagos,Cantabria,221,149,72
2004,39059,Reinosa,Cantabria,123,138,-15
2004,39075,Santander,Cantabria,2333,2522,-189
2004,39079,Santoña,Cantabria,223,145,78
2004,39087,Torrelavega,Cantabria,458,643,-185
2004,40194,Segovia,Segovia,910,1110,-200
2004,41004,Alcalá de Guadaíra,Sevilla,677,472,205
2004,41007,La Algaba,Sevilla,95,72,23
2004,41011,Arahal,Sevilla,87,53,34
2004,41017,Bormujos,Sevilla,269,145,124
2004,41018,Brenes,Sevilla,135,87,48
2004,41020,Las Cabezas de San Juan,Sevilla,164,136,28
2004,41021,Camas,Sevilla,266,208,58
2004,41024,Carmona,Sevilla,260,142,118
2004,41029,Castilleja de la Cuesta,Sevilla,158,191,-33
2004,41034,Coria del Río,Sevilla,228,159,69
2004,41038,Dos Hermanas,Sevilla,1270,1066,204
2004,41039,Écija,Sevilla,449,343,106
2004,41041,Estepa,Sevilla,99,113,-14
2004,41047,Gines,Sevilla,175,73,102
2004,41053,Lebrija,Sevilla,210,165,45
2004,41055,Lora del Río,Sevilla,209,177,32
2004,41058,Mairena del Alcor,Sevilla,89,97,-8
2004,41059,Mairena del Aljarafe,Sevilla,492,409,83
2004,41060,Marchena,Sevilla,169,117,52
2004,41065,Morón de la Frontera,Sevilla,329,262,67
2004,41068,Osuna,Sevilla,184,161,23
2004,41069,Los Palacios y Villafranca,Sevilla,190,164,26
2004,41075,Pilas,Sevilla,78,58,20
2004,41077,La Puebla de Cazalla,Sevilla,166,130,36
2004,41079,La Puebla del Río,Sevilla,86,60,26
2004,41081,La Rinconada,Sevilla,307,266,41
2004,41086,San Juan de Aznalfarache,Sevilla,301,198,103
2004,41087,Sanlúcar la Mayor,Sevilla,134,111,23
2004,41091,Sevilla,Sevilla,7498,7434,64
2004,41093,Tomares,Sevilla,386,227,159
2004,41095,Utrera,Sevilla,513,348,165
2004,41102,El Viso del Alcor,Sevilla,129,61,68
2004,42173,Soria,Soria,872,906,-34
2004,43014,Amposta,Tarragona,384,268,116
2004,43037,Calafell,Tarragona,2102,870,1232
2004,43038,Cambrils,Tarragona,950,560,390
2004,43123,Reus,Tarragona,1811,1325,486
2004,43136,Sant Carles de la Ràpita,Tarragona,414,238,176
2004,43148,Tarragona,Tarragona,2487,1593,894
2004,43153,Torredembarra,Tarragona,795,352,443
2004,43155,Tortosa,Tarragona,997,612,385
2004,43161,Valls,Tarragona,486,280,206
2004,43163,El Vendrell,Tarragona,2222,879,1343
2004,43171,Vila-seca,Tarragona,527,311,216
2004,43901,Deltebre,Tarragona,114,79,35
2004,43905,Salou,Tarragona,1085,685,400
2004,44013,Alcañiz,Teruel,275,316,-41
2004,44216,Teruel,Teruel,563,620,-57
2004,45053,Consuegra,Toledo,90,102,-12
2004,45081,Illescas,Toledo,946,330,616
2004,45087,Madridejos,Toledo,106,89,17
2004,45142,Quintanar de la Orden,Toledo,140,192,-52
2004,45163,Sonseca,Toledo,107,150,-43
2004,45165,Talavera de la Reina,Toledo,1709,1352,357
2004,45168,Toledo,Toledo,1775,1304,471
2004,45173,Torrijos,Toledo,313,178,135
2004,46005,Alaquàs,Valencia,305,198,107
2004,46007,Albal,Valencia,145,59,86
2004,46013,Alboraya,Valencia,259,178,81
2004,46017,Alzira,Valencia,473,306,167
2004,46019,L'Alcúdia,Valencia,63,77,-14
2004,46021,Aldaia,Valencia,244,196,48
2004,46022,Alfafar,Valencia,275,170,105
2004,46029,Algemesí,Valencia,229,190,39
2004,46031,Alginet,Valencia,60,56,4
2004,46054,Benetússer,Valencia,79,86,-7
2004,46060,Benifaió,Valencia,80,85,-5
2004,46070,Bétera,Valencia,224,142,82
2004,46078,Burjassot,Valencia,414,304,110
2004,46081,Canals,Valencia,51,91,-40
2004,46083,Carcaixent,Valencia,199,162,37
2004,46085,Carlet,Valencia,94,90,4
2004,46094,Catarroja,Valencia,268,158,110
2004,46102,Quart de Poblet,Valencia,183,185,-2
2004,46105,Cullera,Valencia,360,280,80
2004,46110,Xirivella,Valencia,411,310,101
2004,46111,Chiva,Valencia,152,98,54
2004,46116,L'Eliana,Valencia,213,120,93
2004,46131,Gandia,Valencia,1400,929,471
2004,46135,Godella,Valencia,140,106,34
2004,46145,Xátiva,Valencia,300,215,85
2004,46147,Llíria,Valencia,273,251,22
2004,46159,Manises,Valencia,286,213,73
2004,46164,Massamagrell,Valencia,128,107,21
2004,46169,Mislata,Valencia,523,423,100
2004,46171,Moncada,Valencia,159,130,29
2004,46181,Oliva,Valencia,431,314,117
2004,46184,Ontinyent,Valencia,342,444,-102
2004,46186,Paiporta,Valencia,225,162,63
2004,46190,Paterna,Valencia,829,436,393
2004,46194,Picassent,Valencia,156,87,69
2004,46202,La Pobla de Vallbona,Valencia,226,110,116
2004,46205,Puçol,Valencia,267,189,78
2004,46213,Requena,Valencia,132,176,-44
2004,46214,Riba-roja de Túria,Valencia,232,116,116
2004,46220,Sagunto/Sagunt,Valencia,1136,646,490
2004,46230,Silla,Valencia,188,143,45
2004,46235,Sueca,Valencia,244,148,96
2004,46238,Tavernes de la Valldigna,Valencia,210,121,89
2004,46244,Torrent (Valencia),Valencia,925,566,359
2004,46249,Utiel,Valencia,88,110,-22
2004,46250,València,Valencia,13136,9986,3150
2004,47076,Laguna de Duero,Valladolid,234,269,-35
2004,47085,Medina del Campo,Valladolid,268,277,-9
2004,47186,Valladolid,Valladolid,4225,4839,-614
2004,48003,Amorebieta-Etxano,Vizcaya,74,118,-44
2004,48011,Arrigorriaga,Vizcaya,114,159,-45
2004,48013,Barakaldo,Vizcaya,819,1096,-277
2004,48015,Basauri,Vizcaya,302,549,-247
2004,48017,Bermeo,Vizcaya,90,105,-15
2004,48020,Bilbao,Vizcaya,4303,5089,-786
2004,48027,Durango,Vizcaya,251,266,-15
2004,48034,Ermua,Vizcaya,160,307,-147
2004,48036,Galdakao,Vizcaya,187,306,-119
2004,48044,Getxo,Vizcaya,686,1045,-359
2004,48046,Gernika-Lumo,Vizcaya,106,96,10
2004,48054,Leioa,Vizcaya,208,342,-134
2004,48069,Mungia,Vizcaya,130,152,-22
2004,48078,Portugalete,Vizcaya,340,570,-230
2004,48080,Valle de Trápaga-Trapagaran,Vizcaya,85,142,-57
2004,48082,Santurtzi,Vizcaya,389,641,-252
2004,48084,Sestao,Vizcaya,244,438,-194
2004,48085,Sopela,Vizcaya,87,112,-25
2004,48902,Erandio,Vizcaya,182,231,-49
2004,49021,Benavente,Zamora,534,382,152
2004,49275,Zamora,Zamora,979,1055,-76
2004,50067,Calatayud,Zaragoza,329,432,-103
2004,50095,Ejea de los Caballeros,Zaragoza,230,198,32
2004,50251,Tarazona,Zaragoza,160,138,22
2004,50272,Utebo,Zaragoza,244,187,57
2004,50297,Zaragoza,Zaragoza,8461,7751,710
2004,51001,Ceuta,Ceuta,1632,2656,-1024
2004,52001,Melilla,Melilla,1973,2688,-715
2005,01036,Laudio/Llodio,Álava,248,338,-90
2005,01059,Vitoria-Gasteiz,Álava,3391,3686,-295
2005,02003,Albacete,Albacete,2290,2438,-148
2005,02009,Almansa,Albacete,420,397,23
2005,02037,Hellín,Albacete,472,719,-247
2005,02069,La Roda,Albacete,216,222,-6
2005,02081,Villarrobledo,Albacete,335,453,-118
2005,03005,Albatera,Alicante,106,110,-4
2005,03009,Alcoy/Alcoi,Alicante,492,596,-104
2005,03011,L'Alfàs del Pi,Alicante,293,239,54
2005,03014,Alicante/Alacant,Alicante,6271,4962,1309
2005,03015,Almoradí,Alicante,280,166,114
2005,03018,Altea,Alicante,429,308,121
2005,03019,Aspe,Alicante,140,124,16
2005,03031,Benidorm,Alicante,2340,1908,432
2005,03041,Benissa,Alicante,87,72,15
2005,03047,Calp,Alicante,532,376,156
2005,03049,Callosa de Segura,Alicante,161,160,1
2005,03050,El Campello,Alicante,515,310,205
2005,03056,Cocentaina,Alicante,86,112,-26
2005,03059,Crevillent,Alicante,274,239,35
2005,03063,Dénia,Alicante,928,804,124
2005,03065,Elche/Elx,Alicante,2814,2089,725
2005,03066,Elda,Alicante,480,500,-20
2005,03076,Guardamar del Segura,Alicante,357,262,95
2005,03079,Ibi,Alicante,204,182,22
2005,03082,Jávea/Xàbia,Alicante,468,506,-38
2005,03089,Monóvar/Monòver,Alicante,121,109,12
2005,03090,Mutxamel,Alicante,226,147,79
2005,03093,Novelda,Alicante,191,216,-25
2005,03094,La Nucia,Alicante,293,164,129
2005,03099,Orihuela,Alicante,1099,1122,-23
2005,03102,Pego,Alicante,115,114,1
2005,03104,Petrer,Alicante,205,212,-7
2005,03113,Rojales,Alicante,112,129,-17
2005,03119,Sant Joan d'Alacant,Alicante,350,216,134
2005,03121,Santa Pola,Alicante,704,412,292
2005,03122,San Vicente del Raspeig/Sant Vicent del Raspeig,Alicante,467,370,97
2005,03128,Teulada,Alicante,175,146,29
2005,03133,Torrevieja,Alicante,4077,3054,1023
2005,03139,Villajoyosa/La Vila Joiosa,Alicante,695,354,341
2005,03140,Villena,Alicante,373,395,-22
2005,03902,Pilar de la Horadada,Alicante,790,611,179
2005,04003,Adra,Almería,253,241,12
2005,04006,Albox,Almería,150,268,-118
2005,04013,Almería,Almería,2553,2485,68
2005,04029,Berja,Almería,129,136,-7
2005,04035,Cuevas del Almanzora,Almería,210,155,55
2005,04052,Huércal de Almería,Almería,145,90,55
2005,04053,Huércal-Overa,Almería,254,307,-53
2005,04066,Níjar,Almería,375,523,-148
2005,04079,Roquetas de Mar,Almería,1750,1756,-6
2005,04100,Vera,Almería,386,171,215
2005,04102,Vícar,Almería,355,513,-158
2005,04902,El Ejido,Almería,1348,1427,-79
2005,05019,Ávila,Ávila,1129,968,161
2005,06011,Almendralejo,Badajoz,441,382,59
2005,06015,Badajoz,Badajoz,1951,2165,-214
2005,06044,Don Benito,Badajoz,580,374,206
2005,06083,Mérida,Badajoz,844,738,106
2005,06088,Montijo,Badajoz,117,161,-44
2005,06095,Olivenza,Badajoz,218,193,25
2005,06149,Villafranca de los Barros,Badajoz,175,107,68
2005,06153,Villanueva de la Serena,Badajoz,342,239,103
2005,06158,Zafra,Badajoz,154,214,-60
2005,07003,Alcúdia,Baleares,408,513,-105
2005,07011,Calvià,Baleares,794,821,-27
2005,07014,Capdepera,Baleares,245,263,-18
2005,07015,Ciutadella de Menorca,Baleares,973,786,187
2005,07022,Felanitx,Baleares,216,228,-12
2005,07026,Eivissa,Baleares,1440,1448,-8
2005,07027,Inca,Baleares,359,383,-24
2005,07031,Llucmajor,Baleares,529,484,45
2005,07032,Maó-Mahón,Baleares,957,777,180
2005,07033,Manacor,Baleares,688,589,99
2005,07036,Marratxí,Baleares,179,189,-10
2005,07040,Palma,Baleares,7425,7326,99
2005,07042,Pollença,Baleares,227,283,-56
2005,07044,Sa Pobla,Baleares,132,117,15
2005,07046,Sant Antoni de Portmany,Baleares,546,506,40
2005,07048,Sant Josep de sa Talaia,Baleares,814,499,315
2005,07054,Santa Eulària des Riu,Baleares,940,759,181
2005,07057,Santanyí,Baleares,235,218,17
2005,07061,Sóller,Baleares,187,122,65
2005,07062,Son Servera,Baleares,243,281,-38
2005,08006,Arenys de Mar,Barcelona,115,159,-44
2005,08009,Argentona,Barcelona,43,106,-63
2005,08015,Badalona,Barcelona,2075,4029,-1954
2005,08019,Barcelona,Barcelona,20247,24599,-4352
2005,08022,Berga,Barcelona,137,155,-18
2005,08033,Caldes de Montbui,Barcelona,121,128,-7
2005,08035,Calella,Barcelona,230,291,-61
2005,08040,Canet de Mar,Barcelona,71,124,-53
2005,08041,Canovelles,Barcelona,159,223,-64
2005,08046,Cardedeu,Barcelona,113,120,-7
2005,08051,Castellar del Vallès,Barcelona,139,193,-54
2005,08054,Castellbisbal,Barcelona,106,146,-40
2005,08056,Castelldefels,Barcelona,882,1288,-406
2005,08072,Corbera de Llobregat,Barcelona,92,132,-40
2005,08073,Cornellà de Llobregat,Barcelona,763,1206,-443
2005,08074,Cubelles,Barcelona,222,264,-42
2005,08076,Esparreguera,Barcelona,166,275,-109
2005,08077,Esplugues de Llobregat,Barcelona,389,648,-259
2005,08086,Les Franqueses del Vallès,Barcelona,132,164,-32
2005,08088,La Garriga,Barcelona,120,108,12
2005,08089,Gavà,Barcelona,420,738,-318
2005,08096,Granollers,Barcelona,700,781,-81
2005,08101,L'Hospitalet de Llobregat,Barcelona,2634,3976,-1342
2005,08102,Igualada,Barcelona,410,430,-20
2005,08105,La Llagosta,Barcelona,136,204,-68
2005,08107,Lliçà d'Amunt,Barcelona,50,117,-67
2005,08110,Malgrat de Mar,Barcelona,276,313,-37
2005,08112,Manlleu,Barcelona,192,294,-102
2005,08113,Manresa,Barcelona,825,784,41
2005,08114,Martorell,Barcelona,265,464,-199
2005,08118,El Masnou,Barcelona,186,188,-2
2005,08121,Mataró,Barcelona,1121,1865,-744
2005,08123,Molins de Rei,Barcelona,152,212,-60
2005,08124,Mollet del Vallès,Barcelona,593,901,-308
2005,08125,Montcada i Reixac,Barcelona,270,394,-124
2005,08136,Montornès del Vallès,Barcelona,139,190,-51
2005,08147,Olesa de Montserrat,Barcelona,182,289,-107
2005,08156,Palau-solità i Plegamans,Barcelona,83,105,-22
2005,08157,Pallejà,Barcelona,77,141,-64
2005,08159,Parets del Vallès,Barcelona,112,175,-63
2005,08161,Piera,Barcelona,86,135,-49
2005,08163,Pineda de Mar,Barcelona,356,516,-160
2005,08169,El Prat de Llobregat,Barcelona,490,998,-508
2005,08172,Premià de Mar,Barcelona,222,411,-189
2005,08180,Ripollet,Barcelona,278,528,-250
2005,08184,Rubí,Barcelona,568,958,-390
2005,08187,Sabadell,Barcelona,1804,2340,-536
2005,08194,Sant Adrià de Besòs,Barcelona,222,443,-221
2005,08196,Sant Andreu de la Barca,Barcelona,208,439,-231
2005,08200,Sant Boi de Llobregat,Barcelona,623,1263,-640
2005,08202,Sant Celoni,Barcelona,219,284,-65
2005,08205,Sant Cugat del Vallès,Barcelona,716,720,-4
2005,08211,Sant Feliu de Llobregat,Barcelona,339,544,-205
2005,08217,Sant Joan Despí,Barcelona,219,396,-177
2005,08218,Sant Joan de Vilatorrada,Barcelona,46,48,-2
2005,08219,Vilassar de Mar,Barcelona,128,161,-33
2005,08221,Sant Just Desvern,Barcelona,109,122,-13
2005,08231,Sant Pere de Ribes,Barcelona,291,362,-71
2005,08238,Sant Quirze del Vallès,Barcelona,112,134,-22
2005,08240,Sant Sadurní d'Anoia,Barcelona,99,100,-1
2005,08245,Santa Coloma de Gramenet,Barcelona,1160,2341,-1181
2005,08252,Barberà del Vallès,Barcelona,203,346,-143
2005,08260,Santa Perpètua de Mogoda,Barcelona,152,383,-231
2005,08263,Sant Vicenç dels Horts,Barcelona,210,350,-140
2005,08266,Cerdanyola del Vallès,Barcelona,446,722,-276
2005,08270,Sitges,Barcelona,311,350,-39
2005,08279,Terrassa,Barcelona,1684,2163,-479
2005,08284,Tordera,Barcelona,355,313,42
2005,08285,Torelló,Barcelona,117,99,18
2005,08295,Vallirana,Barcelona,76,166,-90
2005,08298,Vic,Barcelona,509,582,-73
2005,08301,Viladecans,Barcelona,612,1128,-516
2005,08302,Vilanova del Camí,Barcelona,62,112,-50
2005,08305,Vilafranca del Penedès,Barcelona,443,587,-144
2005,08307,Vilanova i la Geltrú,Barcelona,716,1033,-317
2005,08904,Badia del Vallès,Barcelona,134,230,-96
2005,09018,Aranda de Duero,Burgos,494,566,-72
2005,09059,Burgos,Burgos,2235,2382,-147
2005,09219,Miranda de Ebro,Burgos,863,931,-68
2005,10037,Cáceres,Cáceres,1343,1334,9
2005,10067,Coria,Cáceres,183,195,-12
2005,10121,Miajadas,Cáceres,125,169,-44
2005,10131,Navalmoral de la Mata,Cáceres,334,505,-171
2005,10148,Plasencia,Cáceres,492,601,-109
2005,10180,Talayuela,Cáceres,205,545,-340
2005,11004,Algeciras,Cádiz,1950,1679,271
2005,11006,Arcos de la Frontera,Cádiz,390,226,164
2005,11007,Barbate,Cádiz,275,256,19
2005,11008,Los Barrios,Cádiz,410,288,122
2005,11012,Cádiz,Cádiz,1262,1598,-336
2005,11014,Conil de la Frontera,Cádiz,290,161,129
2005,11015,Chiclana de la Frontera,Cádiz,963,717,246
2005,11016,Chipiona,Cádiz,201,185,16
2005,11020,Jerez de la Frontera,Cádiz,2646,2005,641
2005,11022,La Línea de la Concepción,Cádiz,657,623,34
2005,11023,Medina-Sidonia,Cádiz,98,57,41
2005,11027,El Puerto de Santa María,Cádiz,1319,1087,232
2005,11028,Puerto Real,Cádiz,382,401,-19
2005,11030,Rota,Cádiz,475,357,118
2005,11031,San Fernando,Cádiz,1021,1074,-53
2005,11032,Sanlúcar de Barrameda,Cádiz,526,416,110
2005,11033,San Roque,Cádiz,431,386,45
2005,11035,Tarifa,Cádiz,337,273,64
2005,11038,Ubrique,Cádiz,85,201,-116
2005,11039,Vejer de la Frontera,Cádiz,83,98,-15
2005,11041,Villamartín,Cádiz,108,126,-18
2005,12005,L'Alcora,Castellón,139,118,21
2005,12009,Almassora,Castellón,231,195,36
2005,12027,Benicarló,Castellón,671,475,196
2005,12028,Benicasim/Benicàssim,Castellón,280,286,-6
2005,12032,Borriana/Burriana,Castellón,602,406,196
2005,12040,Castellón de la Plana/Castelló de la Plana,Castellón,2583,2378,205
2005,12082,Nules,Castellón,221,139,82
2005,12084,Onda,Castellón,395,214,181
2005,12126,La Vall d'Uixó,Castellón,381,272,109
2005,12135,Vila-real,Castellón,773,499,274
2005,12138,Vinaròs,Castellón,862,507,355
2005,13005,Alcázar de San Juan,Ciudad Real,763,543,220
2005,13023,Bolaños de Calatrava,Ciudad Real,186,205,-19
2005,13028,Campo de Criptana,Ciudad Real,105,126,-21
2005,13034,Ciudad Real,Ciudad Real,1299,1154,145
2005,13039,Daimiel,Ciudad Real,162,151,11
2005,13053,Manzanares,Ciudad Real,356,324,32
2005,13056,Miguelturra,Ciudad Real,168,78,90
2005,13071,Puertollano,Ciudad Real,975,776,199
2005,13078,Socuéllamos,Ciudad Real,162,261,-99
2005,13079,La Solana,Ciudad Real,134,172,-38
2005,13082,Tomelloso,Ciudad Real,530,478,52
2005,13087,Valdepeñas,Ciudad Real,483,417,66
2005,13096,Villarrubia de los Ojos,Ciudad Real,82,99,-17
2005,14002,Aguilar de la Frontera,Córdoba,101,115,-14
2005,14007,Baena,Córdoba,251,368,-117
2005,14013,Cabra,Córdoba,166,194,-28
2005,14017,La Carlota,Córdoba,235,113,122
2005,14021,Córdoba,Córdoba,2885,3775,-890
2005,14030,Fuente Palmera,Córdoba,143,112,31
2005,14038,Lucena,Córdoba,455,485,-30
2005,14042,Montilla,Córdoba,190,155,35
2005,14049,Palma del Río,Córdoba,351,349,2
2005,14052,Peñarroya-Pueblonuevo,Córdoba,173,189,-16
2005,14054,Pozoblanco,Córdoba,214,196,18
2005,14055,Priego de Córdoba,Córdoba,264,278,-14
2005,14056,Puente Genil,Córdoba,277,326,-49
2005,14058,Rute,Córdoba,155,145,10
2005,15002,Ames,A Coruña,493,301,192
2005,15005,Arteixo,A Coruña,288,276,12
2005,15009,Betanzos,A Coruña,134,88,46
2005,15011,Boiro,A Coruña,194,163,31
2005,15017,Cambre,A Coruña,230,182,48
2005,15019,Carballo,A Coruña,227,192,35
2005,15030,A Coruña,A Coruña,3097,2933,164
2005,15031,Culleredo,A Coruña,383,254,129
2005,15035,Fene,A Coruña,119,137,-18
2005,15036,Ferrol,A Coruña,899,1030,-131
2005,15041,A Laracha,A Coruña,46,42,4
2005,15054,Narón,A Coruña,358,321,37
2005,15057,Noia,A Coruña,192,118,74
2005,15058,Oleiros,A Coruña,473,348,125
2005,15059,Ordes,A Coruña,98,89,9
2005,15070,As Pontes de García Rodríguez,A Coruña,118,132,-14
2005,15072,Rianxo,A Coruña,14,94,-80
2005,15073,Ribeira,A Coruña,243,243,0
2005,15075,Sada (A Coruña),A Coruña,150,118,32
2005,15077,Santa Comba,A Coruña,40,52,-12
2005,15078,Santiago de Compostela,A Coruña,1292,1199,93
2005,15082,Teo,A Coruña,238,161,77
2005,16078,Cuenca,Cuenca,867,801,66
2005,16203,Tarancón,Cuenca,342,331,11
2005,17015,Banyoles,Girona,190,198,-8
2005,17023,Blanes,Girona,1532,1383,149
2005,17066,Figueres,Girona,736,654,82
2005,17079,Girona,Girona,1958,1695,263
2005,17095,Lloret de Mar,Girona,1735,1063,672
2005,17114,Olot,Girona,649,540,109
2005,17117,Palafrugell,Girona,372,366,6
2005,17118,Palamós,Girona,372,297,75
2005,17147,Ripoll,Girona,241,218,23
2005,17152,Roses,Girona,494,303,191
2005,17155,Salt,Girona,670,539,131
2005,17160,Sant Feliu de Guíxols,Girona,453,314,139
2005,17180,Santa Coloma de Farners,Girona,205,174,31
2005,17199,Torroella de Montgrí,Girona,231,219,12
2005,18003,Albolote,Granada,265,163,102
2005,18017,Almuñécar,Granada,489,384,105
2005,18021,Armilla,Granada,506,236,270
2005,18022,Atarfe,Granada,235,130,105
2005,18023,Baza,Granada,463,398,65
2005,18087,Granada,Granada,4202,3841,361
2005,18089,Guadix,Granada,346,259,87
2005,18101,Huétor Vega,Granada,145,88,57
2005,18102,Illora,Granada,108,81,27
2005,18122,Loja,Granada,278,193,85
2005,18127,Maracena,Granada,266,165,101
2005,18140,Motril,Granada,716,682,34
2005,18145,Ogíjares,Granada,156,125,31
2005,18153,Peligros,Granada,136,96,40
2005,18158,Pinos Puente,Granada,143,96,47
2005,18173,Salobreña,Granada,195,158,37
2005,18175,Santa Fe,Granada,185,144,41
2005,18193,La Zubia,Granada,298,155,143
2005,18905,Las Gabias,Granada,246,110,136
2005,19046,Azuqueca de Henares,Guadalajara,2189,852,1337
2005,19130,Guadalajara,Guadalajara,1723,1283,440
2005,20009,Andoain,Guipúzcoa,82,118,-36
2005,20017,Azkoitia,Guipúzcoa,78,77,1
2005,20018,Azpeitia,Guipúzcoa,90,74,16
2005,20019,Beasain,Guipúzcoa,127,93,34
2005,20030,Eibar,Guipúzcoa,290,466,-176
2005,20032,Elgoibar,Guipúzcoa,94,78,16
2005,20036,Hondarribia,Guipúzcoa,172,146,26
2005,20040,Hernani,Guipúzcoa,128,134,-6
2005,20045,Irun,Guipúzcoa,749,768,-19
2005,20055,Arrasate/Mondragón,Guipúzcoa,160,313,-153
2005,20059,Oñati,Guipúzcoa,57,75,-18
2005,20064,Pasaia,Guipúzcoa,104,139,-35
2005,20067,Errenteria,Guipúzcoa,258,338,-80
2005,20069,Donostia/San Sebastián,Guipúzcoa,1871,1996,-125
2005,20071,Tolosa,Guipúzcoa,109,106,3
2005,20074,Bergara,Guipúzcoa,150,171,-21
2005,20079,Zarautz,Guipúzcoa,263,226,37
2005,20080,Zumarraga,Guipúzcoa,58,103,-45
2005,20902,Lasarte-Oria,Guipúzcoa,141,193,-52
2005,21002,Aljaraque,Huelva,235,168,67
2005,21005,Almonte,Huelva,352,242,110
2005,21010,Ayamonte,Huelva,284,194,90
2005,21013,Bollullos Par del Condado,Huelva,102,88,14
2005,21021,Cartaya,Huelva,429,238,191
2005,21035,Gibraleón,Huelva,86,98,-12
2005,21041,Huelva,Huelva,1632,1588,44
2005,21042,Isla Cristina,Huelva,327,263,64
2005,21044,Lepe,Huelva,618,370,248
2005,21050,Moguer,Huelva,1060,346,714
2005,21060,Punta Umbría,Huelva,211,137,74
2005,21072,Valverde del Camino,Huelva,69,83,-14
2005,22048,Barbastro,Huesca,266,228,38
2005,22112,Fraga,Huesca,237,332,-95
2005,22125,Huesca,Huesca,914,829,85
2005,22130,Jaca,Huesca,480,414,66
2005,22158,Monzón,Huesca,295,266,29
2005,23002,Alcalá la Real,Jaén,306,322,-16
2005,23003,Alcaudete,Jaén,141,150,-9
2005,23005,Andújar,Jaén,490,574,-84
2005,23009,Baeza,Jaén,222,183,39
2005,23010,Bailén,Jaén,168,152,16
2005,23024,La Carolina,Jaén,236,273,-37
2005,23050,Jaén,Jaén,1043,1469,-426
2005,23053,Jódar,Jaén,98,124,-26
2005,23055,Linares,Jaén,949,904,45
2005,23058,Mancha Real,Jaén,119,104,15
2005,23060,Martos,Jaén,225,201,24
2005,23086,Torredelcampo,Jaén,83,124,-41
2005,23087,Torredonjimeno,Jaén,93,127,-34
2005,23092,Úbeda,Jaén,349,520,-171
2005,23095,Villacarrillo,Jaén,111,173,-62
2005,24008,Astorga,León,155,188,-33
2005,24010,La Bañeza,León,172,186,-14
2005,24014,Bembibre,León,166,180,-14
2005,24089,León,León,1990,2806,-816
2005,24115,Ponferrada,León,915,1137,-222
2005,24142,San Andrés del Rabanedo,León,411,420,-9
2005,24202,Villablino,León,116,253,-137
2005,24222,Villaquilambre,León,262,218,44
2005,25040,Balaguer,Lleida,317,402,-85
2005,25120,Lleida,Lleida,2483,3492,-1009
2005,25137,Mollerussa,Lleida,321,294,27
2005,25203,La Seu d'Urgell,Lleida,296,394,-98
2005,25217,Tàrrega,Lleida,446,452,-6
2005,26018,Arnedo,La Rioja,143,206,-63
2005,26036,Calahorra,La Rioja,578,584,-6
2005,26071,Haro,La Rioja,356,235,121
2005,26089,Logroño,La Rioja,2711,3026,-315
2005,27028,Lugo,Lugo,1360,1140,220
2005,27031,Monforte de Lemos,Lugo,260,341,-81
2005,27057,Sarria,Lugo,170,113,57
2005,27065,Vilalba,Lugo,122,130,-8
2005,27066,Viveiro,Lugo,234,228,6
2005,28005,Alcalá de Henares,Madrid,2895,5492,-2597
2005,28006,Alcobendas,Madrid,1191,1384,-193
2005,28007,Alcorcón,Madrid,1432,2347,-915
2005,28009,Algete,Madrid,148,319,-171
2005,28010,Alpedrete,Madrid,130,166,-36
2005,28013,Aranjuez,Madrid,872,736,136
2005,28014,Arganda del Rey,Madrid,598,609,-11
2005,28022,Boadilla del Monte,Madrid,415,395,20
2005,28040,Ciempozuelos,Madrid,229,335,-106
2005,28045,Colmenar Viejo,Madrid,388,531,-143
2005,28047,Collado Villalba,Madrid,661,1052,-391
2005,28049,Coslada,Madrid,443,1134,-691
2005,28054,El Escorial,Madrid,122,215,-93
2005,28058,Fuenlabrada,Madrid,2034,4092,-2058
2005,28061,Galapagar,Madrid,397,490,-93
2005,28065,Getafe,Madrid,1408,2426,-1018
2005,28068,Guadarrama,Madrid,164,233,-69
2005,28073,Humanes de Madrid,Madrid,224,405,-181
2005,28074,Leganés,Madrid,1530,2470,-940
2005,28079,Madrid,Madrid,36988,51093,-14105
2005,28080,Majadahonda,Madrid,749,877,-128
2005,28083,Meco,Madrid,135,327,-192
2005,28084,Mejorada del Campo,Madrid,196,315,-119
2005,28092,Móstoles,Madrid,1814,3759,-1945
2005,28096,Navalcarnero,Madrid,252,366,-114
2005,28106,Parla,Madrid,1329,2192,-863
2005,28113,Pinto,Madrid,563,576,-13
2005,28115,Pozuelo de Alarcón,Madrid,745,859,-114
2005,28123,Rivas-Vaciamadrid,Madrid,539,447,92
2005,28127,Las Rozas de Madrid,Madrid,1085,972,113
2005,28130,San Fernando de Henares,Madrid,256,625,-369
2005,28131,San Lorenzo de El Escorial,Madrid,227,204,23
2005,28132,San Martín de la Vega,Madrid,206,401,-195
2005,28134,San Sebastián de los Reyes,Madrid,600,897,-297
2005,28148,Torrejón de Ardoz,Madrid,1321,2257,-936
2005,28152,Torrelodones,Madrid,170,207,-37
2005,28161,Valdemoro,Madrid,935,928,7
2005,28176,Villanueva de la Cañada,Madrid,272,213,59
2005,28177,Villanueva del Pardillo,Madrid,233,133,100
2005,28181,Villaviciosa de Odón,Madrid,240,264,-24
2005,28903,Tres Cantos,Madrid,436,489,-53
2005,29007,Alhaurín de la Torre,Málaga,364,195,169
2005,29008,Alhaurín el Grande,Málaga,144,84,60
2005,29012,Álora,Málaga,80,65,15
2005,29015,Antequera,Málaga,433,282,151
2005,29025,Benalmádena,Málaga,1058,640,418
2005,29038,Cártama,Málaga,127,75,52
2005,29042,Coín,Málaga,274,139,135
2005,29051,Estepona,Málaga,1941,1069,872
2005,29054,Fuengirola,Málaga,1513,1012,501
2005,29067,Málaga,Málaga,4898,4801,97
2005,29069,Marbella,Málaga,2532,2255,277
2005,29070,Mijas,Málaga,998,581,417
2005,29075,Nerja,Málaga,282,199,83
2005,29082,Rincón de la Victoria,Málaga,616,345,271
2005,29084,Ronda,Málaga,539,469,70
2005,29091,Torrox,Málaga,307,152,155
2005,29094,Vélez-Málaga,Málaga,1014,590,424
2005,29901,Torremolinos,Málaga,1470,924,546
2005,30002,Abarán,Murcia,111,103,8
2005,30003,Águilas,Murcia,758,440,318
2005,30005,Alcantarilla,Murcia,517,342,175
2005,30008,Alhama de Murcia,Murcia,292,169,123
2005,30009,Archena,Murcia,247,176,71
2005,30012,Bullas,Murcia,122,92,30
2005,30015,Caravaca de la Cruz,Murcia,398,306,92
2005,30016,Cartagena,Murcia,2919,2561,358
2005,30017,Cehegín,Murcia,160,130,30
2005,30019,Cieza (Murcia),Murcia,277,262,15
2005,30021,Fuente Álamo de Murcia,Murcia,330,202,128
2005,30022,Jumilla,Murcia,414,389,25
2005,30024,Lorca,Murcia,1786,1302,484
2005,30026,Mazarrón,Murcia,720,653,67
2005,30027,Molina de Segura,Murcia,1016,586,430
2005,30029,Mula,Murcia,231,161,70
2005,30030,Murcia,Murcia,5698,4205,1493
2005,30033,Puerto Lumbreras,Murcia,207,165,42
2005,30035,San Javier,Murcia,945,616,329
2005,30036,San Pedro del Pinatar,Murcia,785,523,262
2005,30037,Torre-Pacheco,Murcia,563,523,40
2005,30038,Las Torres de Cotillas,Murcia,279,152,127
2005,30039,Totana,Murcia,414,304,110
2005,30041,La Unión,Murcia,163,118,45
2005,30043,Yecla,Murcia,411,531,-120
2005,30901,Santomera,Murcia,232,185,47
2005,30902,Los Alcázares,Murcia,629,346,283
2005,31060,Burlada/Burlata,Navarra,212,183,29
2005,31097,Estella-Lizarra,Navarra,161,154,7
2005,31201,Pamplona/Iruña,Navarra,2614,2404,210
2005,31227,Tafalla,Navarra,79,90,-11
2005,31232,Tudela,Navarra,689,750,-61
2005,31258,Villava/Atarrabia,Navarra,65,68,-3
2005,31901,Barañain,Navarra,322,309,13
2005,31907,Zizur Mayor/Zizur Nagusia,Navarra,117,142,-25
2005,32009,O Barco de Valdeorras,Ourense,216,298,-82
2005,32019,O Carballiño,Ourense,206,182,24
2005,32054,Ourense,Ourense,1288,1666,-378
2005,32085,Verín,Ourense,291,312,-21
2005,33002,Aller,Asturias,47,103,-56
2005,33004,Avilés,Asturias,718,812,-94
2005,33011,Cangas del Narcea,Asturias,83,107,-24
2005,33014,Carreño,Asturias,90,69,21
2005,33016,Castrillón,Asturias,146,178,-32
2005,33020,Corvera de Asturias,Asturias,91,115,-24
2005,33024,Gijón,Asturias,2757,2984,-227
2005,33025,Gozón,Asturias,69,54,15
2005,33026,Grado,Asturias,34,84,-50
2005,33031,Langreo,Asturias,249,352,-103
2005,33032,Laviana,Asturias,67,80,-13
2005,33033,Lena,Asturias,79,134,-55
2005,33034,Valdés,Asturias,88,76,12
2005,33035,Llanera,Asturias,107,85,22
2005,33036,Llanes,Asturias,203,116,87
2005,33037,Mieres (Asturias),Asturias,300,380,-80
2005,33044,Oviedo,Asturias,2448,2585,-137
2005,33060,San Martín del Rey Aurelio,Asturias,103,128,-25
2005,33066,Siero,Asturias,369,353,16
2005,33073,Tineo,Asturias,38,60,-22
2005,33076,Villaviciosa,Asturias,109,57,52
2005,34120,Palencia,Palencia,1024,1151,-127
2005,35002,Agüimes,Las Palmas,271,291,-20
2005,35004,Arrecife,Las Palmas,1512,1408,104
2005,35006,Arucas,Las Palmas,140,142,-2
2005,35009,Gáldar,Las Palmas,83,78,5
2005,35011,Ingenio,Las Palmas,146,163,-17
2005,35012,Mogán,Las Palmas,251,287,-36
2005,35014,La Oliva,Las Palmas,1011,717,294
2005,35015,Pájara,Las Palmas,1338,1393,-55
2005,35016,Las Palmas de Gran Canaria,Las Palmas,4448,4938,-490
2005,35017,Puerto del Rosario,Las Palmas,1221,1344,-123
2005,35018,San Bartolomé,Las Palmas,562,633,-71
2005,35019,San Bartolomé de Tirajana,Las Palmas,571,605,-34
2005,35021,Santa Brígida,Las Palmas,66,129,-63
2005,35022,Santa Lucía de Tirajana,Las Palmas,744,762,-18
2005,35023,Santa María de Guía de Gran Canaria,Las Palmas,42,49,-7
2005,35024,Teguise,Las Palmas,343,385,-42
2005,35026,Telde,Las Palmas,735,738,-3
2005,35027,Teror,Las Palmas,28,45,-17
2005,35028,Tías,Las Palmas,514,529,-15
2005,35030,Tuineje,Las Palmas,417,477,-60
2005,36003,Baiona,Pontevedra,115,128,-13
2005,36004,Bueu,Pontevedra,84,117,-33
2005,36006,Cambados,Pontevedra,121,111,10
2005,36008,Cangas,Pontevedra,212,193,19
2005,36017,A Estrada,Pontevedra,245,276,-31
2005,36021,Gondomar,Pontevedra,84,75,9
2005,36022,O Grove,Pontevedra,79,111,-32
2005,36023,A Guarda,Pontevedra,120,102,18
2005,36024,Lalín,Pontevedra,237,219,18
2005,36026,Marín,Pontevedra,300,404,-104
2005,36029,Moaña,Pontevedra,150,158,-8
2005,36033,Mos,Pontevedra,49,91,-42
2005,36035,Nigrán,Pontevedra,151,136,15
2005,36038,Pontevedra,Pontevedra,1011,1147,-136
2005,36039,O Porriño,Pontevedra,127,144,-17
2005,36041,Poio,Pontevedra,205,124,81
2005,36042,Ponteareas,Pontevedra,308,256,52
2005,36045,Redondela,Pontevedra,220,203,17
2005,36051,Sanxenxo,Pontevedra,229,153,76
2005,36054,Tomiño,Pontevedra,150,83,67
2005,36055,Tui,Pontevedra,200,159,41
2005,36057,Vigo,Pontevedra,3376,3372,4
2005,36060,Vilagarcía de Arousa,Pontevedra,589,429,160
2005,36061,Vilanova de Arousa,Pontevedra,93,102,-9
2005,37046,Béjar,Salamanca,248,270,-22
2005,37107,Ciudad Rodrigo,Salamanca,196,263,-67
2005,37274,Salamanca,Salamanca,2021,2850,-829
2005,37294,Santa Marta de Tormes,Salamanca,265,202,63
2005,38001,Adeje,Santa Cruz de Tenerife,1251,1094,157
2005,38006,Arona,Santa Cruz de Tenerife,2597,2243,354
2005,38011,Candelaria,Santa Cruz de Tenerife,410,413,-3
2005,38017,Granadilla de Abona,Santa Cruz de Tenerife,909,945,-36
2005,38019,Guía de Isora,Santa Cruz de Tenerife,234,206,28
2005,38020,Güímar,Santa Cruz de Tenerife,96,130,-34
2005,38022,Icod de los Vinos,Santa Cruz de Tenerife,104,108,-4
2005,38023,San Cristóbal de La Laguna,Santa Cruz de Tenerife,1361,1144,217
2005,38024,Los Llanos de Aridane,Santa Cruz de Tenerife,174,224,-50
2005,38026,La Orotava,Santa Cruz de Tenerife,168,195,-27
2005,38028,Puerto de la Cruz,Santa Cruz de Tenerife,607,521,86
2005,38031,Los Realejos,Santa Cruz de Tenerife,174,160,14
2005,38032,El Rosario,Santa Cruz de Tenerife,73,196,-123
2005,38035,San Miguel de Abona,Santa Cruz de Tenerife,144,177,-33
2005,38037,Santa Cruz de la Palma,Santa Cruz de Tenerife,346,331,15
2005,38038,Santa Cruz de Tenerife,Santa Cruz de Tenerife,2716,3021,-305
2005,38039,Santa Úrsula,Santa Cruz de Tenerife,90,121,-31
2005,38040,Santiago del Teide,Santa Cruz de Tenerife,98,112,-14
2005,38043,Tacoronte,Santa Cruz de Tenerife,111,117,-6
2005,38046,Tegueste,Santa Cruz de Tenerife,52,45,7
2005,39008,El Astillero,Cantabria,211,160,51
2005,39016,Camargo,Cantabria,324,209,115
2005,39020,Castro-Urdiales,Cantabria,2178,1308,870
2005,39025,Los Corrales de Buelna,Cantabria,84,96,-12
2005,39035,Laredo,Cantabria,259,274,-15
2005,39052,Piélagos,Cantabria,254,176,78
2005,39059,Reinosa,Cantabria,118,150,-32
2005,39073,Santa Cruz de Bezana,Cantabria,99,96,3
2005,39075,Santander,Cantabria,2154,2573,-419
2005,39079,Santoña,Cantabria,221,207,14
2005,39087,Torrelavega,Cantabria,507,591,-84
2005,40194,Segovia,Segovia,813,1214,-401
2005,41004,Alcalá de Guadaíra,Sevilla,677,487,190
2005,41007,La Algaba,Sevilla,63,53,10
2005,41011,Arahal,Sevilla,104,56,48
2005,41017,Bormujos,Sevilla,307,132,175
2005,41018,Brenes,Sevilla,156,79,77
2005,41020,Las Cabezas de San Juan,Sevilla,157,132,25
2005,41021,Camas,Sevilla,256,198,58
2005,41024,Carmona,Sevilla,197,240,-43
2005,41029,Castilleja de la Cuesta,Sevilla,144,137,7
2005,41034,Coria del Río,Sevilla,218,180,38
2005,41038,Dos Hermanas,Sevilla,1352,960,392
2005,41039,Écija,Sevilla,473,304,169
2005,41041,Estepa,Sevilla,134,92,42
2005,41047,Gines,Sevilla,107,103,4
2005,41053,Lebrija,Sevilla,247,146,101
2005,41055,Lora del Río,Sevilla,218,128,90
2005,41058,Mairena del Alcor,Sevilla,127,68,59
2005,41059,Mairena del Aljarafe,Sevilla,440,339,101
2005,41060,Marchena,Sevilla,142,103,39
2005,41065,Morón de la Frontera,Sevilla,320,224,96
2005,41068,Osuna,Sevilla,135,133,2
2005,41069,Los Palacios y Villafranca,Sevilla,218,137,81
2005,41075,Pilas,Sevilla,89,58,31
2005,41077,La Puebla de Cazalla,Sevilla,220,92,128
2005,41079,La Puebla del Río,Sevilla,98,84,14
2005,41081,La Rinconada,Sevilla,317,226,91
2005,41086,San Juan de Aznalfarache,Sevilla,247,206,41
2005,41087,Sanlúcar la Mayor,Sevilla,117,88,29
2005,41091,Sevilla,Sevilla,7239,6967,272
2005,41093,Tomares,Sevilla,373,260,113
2005,41095,Utrera,Sevilla,564,296,268
2005,41102,El Viso del Alcor,Sevilla,112,55,57
2005,42173,Soria,Soria,818,851,-33
2005,43014,Amposta,Tarragona,388,325,63
2005,43037,Calafell,Tarragona,2182,1004,1178
2005,43038,Cambrils,Tarragona,998,591,407
2005,43123,Reus,Tarragona,2140,1379,761
2005,43136,Sant Carles de la Ràpita,Tarragona,365,268,97
2005,43148,Tarragona,Tarragona,2260,1932,328
2005,43153,Torredembarra,Tarragona,693,386,307
2005,43155,Tortosa,Tarragona,1079,960,119
2005,43161,Valls,Tarragona,548,292,256
2005,43163,El Vendrell,Tarragona,2043,1082,961
2005,43171,Vila-seca,Tarragona,759,345,414
2005,43901,Deltebre,Tarragona,112,65,47
2005,43905,Salou,Tarragona,1136,770,366
2005,44013,Alcañiz,Teruel,237,342,-105
2005,44216,Teruel,Teruel,510,658,-148
2005,45053,Consuegra,Toledo,108,116,-8
2005,45081,Illescas,Toledo,1107,410,697
2005,45087,Madridejos,Toledo,87,111,-24
2005,45142,Quintanar de la Orden,Toledo,219,251,-32
2005,45163,Sonseca,Toledo,130,182,-52
2005,45165,Talavera de la Reina,Toledo,1710,1396,314
2005,45168,Toledo,Toledo,1864,1344,520
2005,45173,Torrijos,Toledo,229,182,47
2005,45185,Villacañas,Toledo,176,138,38
2005,46005,Alaquàs,Valencia,257,191,66
2005,46007,Albal,Valencia,156,134,22
2005,46011,Alberic,Valencia,138,95,43
2005,46013,Alboraya,Valencia,264,167,97
2005,46017,Alzira,Valencia,495,344,151
2005,46019,L'Alcúdia,Valencia,93,75,18
2005,46021,Aldaia,Valencia,217,178,39
2005,46022,Alfafar,Valencia,267,201,66
2005,46029,Algemesí,Valencia,283,209,74
2005,46031,Alginet,Valencia,56,76,-20
2005,46054,Benetússer,Valencia,80,110,-30
2005,46060,Benifaió,Valencia,74,74,0
2005,46070,Bétera,Valencia,212,154,58
2005,46078,Burjassot,Valencia,301,303,-2
2005,46081,Canals,Valencia,44,77,-33
2005,46083,Carcaixent,Valencia,205,145,60
2005,46085,Carlet,Valencia,110,93,17
2005,46094,Catarroja,Valencia,291,193,98
2005,46102,Quart de Poblet,Valencia,266,182,84
2005,46105,Cullera,Valencia,316,280,36
2005,46110,Xirivella,Valencia,454,278,176
2005,46111,Chiva,Valencia,168,93,75
2005,46116,L'Eliana,Valencia,209,142,67
2005,46131,Gandia,Valencia,1992,1238,754
2005,46135,Godella,Valencia,82,115,-33
2005,46145,Xátiva,Valencia,253,256,-3
2005,46147,Llíria,Valencia,281,252,29
2005,46159,Manises,Valencia,290,231,59
2005,46164,Massamagrell,Valencia,103,106,-3
2005,46169,Mislata,Valencia,598,437,161
2005,46171,Moncada,Valencia,157,138,19
2005,46181,Oliva,Valencia,527,365,162
2005,46184,Ontinyent,Valencia,357,337,20
2005,46186,Paiporta,Valencia,204,161,43
2005,46190,Paterna,Valencia,793,557,236
2005,46193,Picanya,Valencia,85,66,19
2005,46194,Picassent,Valencia,163,120,43
2005,46202,La Pobla de Vallbona,Valencia,185,136,49
2005,46205,Puçol,Valencia,287,146,141
2005,46213,Requena,Valencia,153,156,-3
2005,46214,Riba-roja de Túria,Valencia,253,174,79
2005,46220,Sagunto/Sagunt,Valencia,1069,684,385
2005,46230,Silla,Valencia,164,145,19
2005,46235,Sueca,Valencia,222,165,57
2005,46238,Tavernes de la Valldigna,Valencia,172,147,25
2005,46244,Torrent (Valencia),Valencia,925,718,207
2005,46249,Utiel,Valencia,102,58,44
2005,46250,València,Valencia,13528,10611,2917
2005,47076,Laguna de Duero,Valladolid,290,289,1
2005,47085,Medina del Campo,Valladolid,262,273,-11
2005,47186,Valladolid,Valladolid,4383,4807,-424
2005,48003,Amorebieta-Etxano,Vizcaya,85,131,-46
2005,48011,Arrigorriaga,Vizcaya,110,156,-46
2005,48013,Barakaldo,Vizcaya,830,1146,-316
2005,48015,Basauri,Vizcaya,336,475,-139
2005,48017,Bermeo,Vizcaya,82,130,-48
2005,48020,Bilbao,Vizcaya,4050,4941,-891
2005,48027,Durango,Vizcaya,282,258,24
2005,48034,Ermua,Vizcaya,215,269,-54
2005,48036,Galdakao,Vizcaya,162,261,-99
2005,48044,Getxo,Vizcaya,698,941,-243
2005,48046,Gernika-Lumo,Vizcaya,87,91,-4
2005,48054,Leioa,Vizcaya,233,292,-59
2005,48069,Mungia,Vizcaya,138,114,24
2005,48078,Portugalete,Vizcaya,360,626,-266
2005,48080,Valle de Trápaga-Trapagaran,Vizcaya,103,121,-18
2005,48082,Santurtzi,Vizcaya,407,554,-147
2005,48084,Sestao,Vizcaya,275,401,-126
2005,48085,Sopela,Vizcaya,101,143,-42
2005,48902,Erandio,Vizcaya,199,295,-96
2005,49021,Benavente,Zamora,654,534,120
2005,49275,Zamora,Zamora,817,1115,-298
2005,50067,Calatayud,Zaragoza,324,385,-61
2005,50095,Ejea de los Caballeros,Zaragoza,236,227,9
2005,50251,Tarazona,Zaragoza,221,161,60
2005,50272,Utebo,Zaragoza,216,216,0
2005,50297,Zaragoza,Zaragoza,8646,8150,496
2005,51001,Ceuta,Ceuta,1913,2490,-577
2005,52001,Melilla,Melilla,2037,2408,-371
2006,01036,Laudio/Llodio,Álava,234,323,-89
2006,01059,Vitoria-Gasteiz,Álava,3534,3671,-137
2006,02003,Albacete,Albacete,2923,2816,107
2006,02009,Almansa,Albacete,437,487,-50
2006,02037,Hellín,Albacete,622,748,-126
2006,02069,La Roda,Albacete,229,241,-12
2006,02081,Villarrobledo,Albacete,410,611,-201
2006,03005,Albatera,Alicante,153,103,50
2006,03009,Alcoy/Alcoi,Alicante,507,637,-130
2006,03011,L'Alfàs del Pi,Alicante,286,274,12
2006,03014,Alicante/Alacant,Alicante,6300,5320,980
2006,03015,Almoradí,Alicante,208,231,-23
2006,03018,Altea,Alicante,473,380,93
2006,03019,Aspe,Alicante,189,152,37
2006,03031,Benidorm,Alicante,2296,2058,238
2006,03041,Benissa,Alicante,131,119,12
2006,03047,Calp,Alicante,566,479,87
2006,03049,Callosa de Segura,Alicante,198,173,25
2006,03050,El Campello,Alicante,500,421,79
2006,03056,Cocentaina,Alicante,101,81,20
2006,03059,Crevillent,Alicante,428,298,130
2006,03063,Dénia,Alicante,1067,871,196
2006,03065,Elche/Elx,Alicante,2749,2345,404
2006,03066,Elda,Alicante,611,533,78
2006,03076,Guardamar del Segura,Alicante,429,310,119
2006,03079,Ibi,Alicante,255,201,54
2006,03082,Jávea/Xàbia,Alicante,535,532,3
2006,03089,Monóvar/Monòver,Alicante,92,117,-25
2006,03090,Mutxamel,Alicante,207,190,17
2006,03093,Novelda,Alicante,171,221,-50
2006,03094,La Nucia,Alicante,298,200,98
2006,03099,Orihuela,Alicante,1247,1171,76
2006,03102,Pego,Alicante,136,122,14
2006,03104,Petrer,Alicante,232,261,-29
2006,03113,Rojales,Alicante,114,129,-15
2006,03119,Sant Joan d'Alacant,Alicante,368,328,40
2006,03121,Santa Pola,Alicante,787,436,351
2006,03122,San Vicente del Raspeig/Sant Vicent del Raspeig,Alicante,616,449,167
2006,03128,Teulada,Alicante,178,162,16
2006,03133,Torrevieja,Alicante,3998,3367,631
2006,03139,Villajoyosa/La Vila Joiosa,Alicante,735,449,286
2006,03140,Villena,Alicante,447,445,2
2006,03902,Pilar de la Horadada,Alicante,896,671,225
2006,04003,Adra,Almería,252,268,-16
2006,04006,Albox,Almería,160,314,-154
2006,04013,Almería,Almería,2499,2880,-381
2006,04029,Berja,Almería,108,158,-50
2006,04035,Cuevas del Almanzora,Almería,326,201,125
2006,04052,Huércal de Almería,Almería,175,86,89
2006,04053,Huércal-Overa,Almería,329,321,8
2006,04066,Níjar,Almería,398,741,-343
2006,04079,Roquetas de Mar,Almería,1737,2056,-319
2006,04100,Vera,Almería,459,254,205
2006,04102,Vícar,Almería,366,675,-309
2006,04902,El Ejido,Almería,1136,2241,-1105
2006,05019,Ávila,Ávila,1283,1224,59
2006,06011,Almendralejo,Badajoz,469,448,21
2006,06015,Badajoz,Badajoz,2089,2427,-338
2006,06044,Don Benito,Badajoz,543,416,127
2006,06083,Mérida,Badajoz,1036,831,205
2006,06088,Montijo,Badajoz,180,161,19
2006,06095,Olivenza,Badajoz,250,247,3
2006,06149,Villafranca de los Barros,Badajoz,184,119,65
2006,06153,Villanueva de la Serena,Badajoz,451,269,182
2006,06158,Zafra,Badajoz,282,217,65
2006,07003,Alcúdia,Baleares,533,480,53
2006,07005,Andratx,Baleares,192,146,46
2006,07011,Calvià,Baleares,1024,818,206
2006,07014,Capdepera,Baleares,291,300,-9
2006,07015,Ciutadella de Menorca,Baleares,995,842,153
2006,07022,Felanitx,Baleares,238,156,82
2006,07026,Eivissa,Baleares,1891,1626,265
2006,07027,Inca,Baleares,393,363,30
2006,07031,Llucmajor,Baleares,602,508,94
2006,07032,Maó-Mahón,Baleares,980,888,92
2006,07033,Manacor,Baleares,730,571,159
2006,07036,Marratxí,Baleares,213,175,38
2006,07040,Palma,Baleares,8057,7497,560
2006,07042,Pollença,Baleares,278,219,59
2006,07044,Sa Pobla,Baleares,135,127,8
2006,07046,Sant Antoni de Portmany,Baleares,698,535,163
2006,07048,Sant Josep de sa Talaia,Baleares,938,569,369
2006,07054,Santa Eulària des Riu,Baleares,1139,819,320
2006,07055,Santa Margalida,Baleares,315,235,80
2006,07057,Santanyí,Baleares,304,212,92
2006,07061,Sóller,Baleares,146,135,11
2006,07062,Son Servera,Baleares,337,265,72
2006,08001,Abrera,Barcelona,92,140,-48
2006,08006,Arenys de Mar,Barcelona,126,180,-54
2006,08009,Argentona,Barcelona,56,96,-40
2006,08015,Badalona,Barcelona,2144,3828,-1684
2006,08019,Barcelona,Barcelona,20589,25664,-5075
2006,08022,Berga,Barcelona,174,167,7
2006,08033,Caldes de Montbui,Barcelona,101,162,-61
2006,08035,Calella,Barcelona,238,335,-97
2006,08040,Canet de Mar,Barcelona,118,142,-24
2006,08041,Canovelles,Barcelona,189,220,-31
2006,08046,Cardedeu,Barcelona,85,134,-49
2006,08051,Castellar del Vallès,Barcelona,141,302,-161
2006,08054,Castellbisbal,Barcelona,81,159,-78
2006,08056,Castelldefels,Barcelona,893,1311,-418
2006,08072,Corbera de Llobregat,Barcelona,82,159,-77
2006,08073,Cornellà de Llobregat,Barcelona,765,1372,-607
2006,08074,Cubelles,Barcelona,259,328,-69
2006,08076,Esparreguera,Barcelona,153,280,-127
2006,08077,Esplugues de Llobregat,Barcelona,401,653,-252
2006,08086,Les Franqueses del Vallès,Barcelona,155,186,-31
2006,08088,La Garriga,Barcelona,91,127,-36
2006,08089,Gavà,Barcelona,395,912,-517
2006,08096,Granollers,Barcelona,595,871,-276
2006,08101,L'Hospitalet de Llobregat,Barcelona,2763,4421,-1658
2006,08102,Igualada,Barcelona,432,575,-143
2006,08105,La Llagosta,Barcelona,110,232,-122
2006,08107,Lliçà d'Amunt,Barcelona,65,107,-42
2006,08110,Malgrat de Mar,Barcelona,260,394,-134
2006,08112,Manlleu,Barcelona,157,272,-115
2006,08113,Manresa,Barcelona,866,884,-18
2006,08114,Martorell,Barcelona,315,441,-126
2006,08118,El Masnou,Barcelona,178,251,-73
2006,08121,Mataró,Barcelona,1080,2015,-935
2006,08123,Molins de Rei,Barcelona,142,298,-156
2006,08124,Mollet del Vallès,Barcelona,493,881,-388
2006,08125,Montcada i Reixac,Barcelona,264,464,-200
2006,08136,Montornès del Vallès,Barcelona,136,254,-118
2006,08147,Olesa de Montserrat,Barcelona,122,254,-132
2006,08156,Palau-solità i Plegamans,Barcelona,82,206,-124
2006,08157,Pallejà,Barcelona,78,119,-41
2006,08159,Parets del Vallès,Barcelona,97,177,-80
2006,08161,Piera,Barcelona,98,163,-65
2006,08163,Pineda de Mar,Barcelona,267,525,-258
2006,08169,El Prat de Llobregat,Barcelona,568,1026,-458
2006,08172,Premià de Mar,Barcelona,205,481,-276
2006,08180,Ripollet,Barcelona,289,561,-272
2006,08184,Rubí,Barcelona,587,1217,-630
2006,08187,Sabadell,Barcelona,1743,2578,-835
2006,08194,Sant Adrià de Besòs,Barcelona,246,486,-240
2006,08196,Sant Andreu de la Barca,Barcelona,279,418,-139
2006,08200,Sant Boi de Llobregat,Barcelona,616,1309,-693
2006,08202,Sant Celoni,Barcelona,236,321,-85
2006,08205,Sant Cugat del Vallès,Barcelona,688,855,-167
2006,08211,Sant Feliu de Llobregat,Barcelona,322,603,-281
2006,08217,Sant Joan Despí,Barcelona,249,385,-136
2006,08218,Sant Joan de Vilatorrada,Barcelona,56,79,-23
2006,08219,Vilassar de Mar,Barcelona,130,214,-84
2006,08221,Sant Just Desvern,Barcelona,120,159,-39
2006,08231,Sant Pere de Ribes,Barcelona,271,451,-180
2006,08238,Sant Quirze del Vallès,Barcelona,106,166,-60
2006,08240,Sant Sadurní d'Anoia,Barcelona,120,113,7
2006,08245,Santa Coloma de Gramenet,Barcelona,1263,2353,-1090
2006,08252,Barberà del Vallès,Barcelona,179,376,-197
2006,08260,Santa Perpètua de Mogoda,Barcelona,209,315,-106
2006,08263,Sant Vicenç dels Horts,Barcelona,182,407,-225
2006,08266,Cerdanyola del Vallès,Barcelona,493,735,-242
2006,08270,Sitges,Barcelona,344,356,-12
2006,08279,Terrassa,Barcelona,2011,2766,-755
2006,08284,Tordera,Barcelona,349,389,-40
2006,08285,Torelló,Barcelona,93,109,-16
2006,08295,Vallirana,Barcelona,80,168,-88
2006,08298,Vic,Barcelona,520,572,-52
2006,08301,Viladecans,Barcelona,569,1282,-713
2006,08302,Vilanova del Camí,Barcelona,81,154,-73
2006,08305,Vilafranca del Penedès,Barcelona,448,588,-140
2006,08307,Vilanova i la Geltrú,Barcelona,807,1112,-305
2006,08904,Badia del Vallès,Barcelona,115,217,-102
2006,09018,Aranda de Duero,Burgos,605,645,-40
2006,09059,Burgos,Burgos,2427,2652,-225
2006,09219,Miranda de Ebro,Burgos,780,971,-191
2006,10037,Cáceres,Cáceres,1435,1480,-45
2006,10067,Coria,Cáceres,148,224,-76
2006,10121,Miajadas,Cáceres,166,149,17
2006,10131,Navalmoral de la Mata,Cáceres,396,539,-143
2006,10148,Plasencia,Cáceres,660,658,2
2006,10180,Talayuela,Cáceres,177,594,-417
2006,11004,Algeciras,Cádiz,1891,1862,29
2006,11006,Arcos de la Frontera,Cádiz,379,214,165
2006,11007,Barbate,Cádiz,287,252,35
2006,11008,Los Barrios,Cádiz,346,283,63
2006,11012,Cádiz,Cádiz,1130,1622,-492
2006,11014,Conil de la Frontera,Cádiz,263,154,109
2006,11015,Chiclana de la Frontera,Cádiz,944,718,226
2006,11016,Chipiona,Cádiz,303,218,85
2006,11020,Jerez de la Frontera,Cádiz,2870,2116,754
2006,11022,La Línea de la Concepción,Cádiz,642,687,-45
2006,11023,Medina-Sidonia,Cádiz,70,43,27
2006,11027,El Puerto de Santa María,Cádiz,1518,1248,270
2006,11028,Puerto Real,Cádiz,445,348,97
2006,11030,Rota,Cádiz,495,426,69
2006,11031,San Fernando,Cádiz,1089,1106,-17
2006,11032,Sanlúcar de Barrameda,Cádiz,430,465,-35
2006,11033,San Roque,Cádiz,556,452,104
2006,11035,Tarifa,Cádiz,282,246,36
2006,11038,Ubrique,Cádiz,132,219,-87
2006,11039,Vejer de la Frontera,Cádiz,105,79,26
2006,11041,Villamartín,Cádiz,138,124,14
2006,12005,L'Alcora,Castellón,228,99,129
2006,12009,Almassora,Castellón,351,216,135
2006,12027,Benicarló,Castellón,705,421,284
2006,12028,Benicasim/Benicàssim,Castellón,410,334,76
2006,12032,Borriana/Burriana,Castellón,637,457,180
2006,12040,Castellón de la Plana/Castelló de la Plana,Castellón,2899,2428,471
2006,12082,Nules,Castellón,229,147,82
2006,12084,Onda,Castellón,573,310,263
2006,12126,La Vall d'Uixó,Castellón,485,271,214
2006,12135,Vila-real,Castellón,890,562,328
2006,12138,Vinaròs,Castellón,856,558,298
2006,13005,Alcázar de San Juan,Ciudad Real,621,600,21
2006,13023,Bolaños de Calatrava,Ciudad Real,134,250,-116
2006,13028,Campo de Criptana,Ciudad Real,206,155,51
2006,13034,Ciudad Real,Ciudad Real,1326,1183,143
2006,13039,Daimiel,Ciudad Real,230,160,70
2006,13053,Manzanares,Ciudad Real,345,310,35
2006,13056,Miguelturra,Ciudad Real,196,100,96
2006,13071,Puertollano,Ciudad Real,1024,832,192
2006,13078,Socuéllamos,Ciudad Real,123,365,-242
2006,13079,La Solana,Ciudad Real,138,136,2
2006,13082,Tomelloso,Ciudad Real,685,529,156
2006,13087,Valdepeñas,Ciudad Real,560,489,71
2006,13096,Villarrubia de los Ojos,Ciudad Real,92,107,-15
2006,14002,Aguilar de la Frontera,Córdoba,106,134,-28
2006,14007,Baena,Córdoba,220,345,-125
2006,14013,Cabra,Córdoba,235,214,21
2006,14017,La Carlota,Córdoba,205,133,72
2006,14021,Córdoba,Córdoba,3254,3922,-668
2006,14030,Fuente Palmera,Córdoba,162,146,16
2006,14038,Lucena,Córdoba,512,506,6
2006,14042,Montilla,Córdoba,191,169,22
2006,14049,Palma del Río,Córdoba,414,317,97
2006,14052,Peñarroya-Pueblonuevo,Córdoba,166,209,-43
2006,14054,Pozoblanco,Córdoba,186,213,-27
2006,14055,Priego de Córdoba,Córdoba,303,314,-11
2006,14056,Puente Genil,Córdoba,373,372,1
2006,14058,Rute,Córdoba,118,137,-19
2006,15002,Ames,A Coruña,647,357,290
2006,15005,Arteixo,A Coruña,360,237,123
2006,15009,Betanzos,A Coruña,143,96,47
2006,15011,Boiro,A Coruña,159,149,10
2006,15017,Cambre,A Coruña,247,196,51
2006,15019,Carballo,A Coruña,180,238,-58
2006,15030,A Coruña,A Coruña,3065,3210,-145
2006,15031,Culleredo,A Coruña,308,326,-18
2006,15035,Fene,A Coruña,81,153,-72
2006,15036,Ferrol,A Coruña,925,1084,-159
2006,15041,A Laracha,A Coruña,44,51,-7
2006,15054,Narón,A Coruña,341,319,22
2006,15057,Noia,A Coruña,196,174,22
2006,15058,Oleiros,A Coruña,453,391,62
2006,15059,Ordes,A Coruña,100,91,9
2006,15067,A Pobra do Caramiñal,A Coruña,62,77,-15
2006,15070,As Pontes de García Rodríguez,A Coruña,102,138,-36
2006,15071,Porto do Son,A Coruña,68,78,-10
2006,15072,Rianxo,A Coruña,98,93,5
2006,15073,Ribeira,A Coruña,243,262,-19
2006,15075,Sada (A Coruña),A Coruña,160,125,35
2006,15077,Santa Comba,A Coruña,74,53,21
2006,15078,Santiago de Compostela,A Coruña,1463,1310,153
2006,15082,Teo,A Coruña,229,212,17
2006,16078,Cuenca,Cuenca,1094,965,129
2006,16203,Tarancón,Cuenca,414,422,-8
2006,17015,Banyoles,Girona,207,240,-33
2006,17023,Blanes,Girona,1642,1284,358
2006,17047,Castelló d'Empúries,Girona,327,243,84
2006,17066,Figueres,Girona,901,733,168
2006,17079,Girona,Girona,2041,1829,212
2006,17095,Lloret de Mar,Girona,1785,1333,452
2006,17114,Olot,Girona,533,589,-56
2006,17117,Palafrugell,Girona,389,362,27
2006,17118,Palamós,Girona,408,302,106
2006,17147,Ripoll,Girona,227,231,-4
2006,17152,Roses,Girona,504,359,145
2006,17155,Salt,Girona,677,657,20
2006,17160,Sant Feliu de Guíxols,Girona,445,346,99
2006,17180,Santa Coloma de Farners,Girona,171,183,-12
2006,17199,Torroella de Montgrí,Girona,255,237,18
2006,18003,Albolote,Granada,246,165,81
2006,18017,Almuñécar,Granada,482,440,42
2006,18021,Armilla,Granada,502,333,169
2006,18022,Atarfe,Granada,312,125,187
2006,18023,Baza,Granada,427,430,-3
2006,18087,Granada,Granada,4037,4191,-154
2006,18089,Guadix,Granada,293,284,9
2006,18101,Huétor Vega,Granada,142,109,33
2006,18102,Illora,Granada,92,82,10
2006,18122,Loja,Granada,253,225,28
2006,18127,Maracena,Granada,266,212,54
2006,18140,Motril,Granada,680,826,-146
2006,18145,Ogíjares,Granada,183,142,41
2006,18153,Peligros,Granada,165,88,77
2006,18158,Pinos Puente,Granada,129,99,30
2006,18173,Salobreña,Granada,225,148,77
2006,18175,Santa Fe,Granada,244,160,84
2006,18193,La Zubia,Granada,219,165,54
2006,18905,Las Gabias,Granada,253,166,87
2006,19046,Azuqueca de Henares,Guadalajara,2492,1001,1491
2006,19130,Guadalajara,Guadalajara,1969,1396,573
2006,20009,Andoain,Guipúzcoa,106,129,-23
2006,20017,Azkoitia,Guipúzcoa,85,80,5
2006,20018,Azpeitia,Guipúzcoa,99,75,24
2006,20019,Beasain,Guipúzcoa,160,121,39
2006,20030,Eibar,Guipúzcoa,343,404,-61
2006,20032,Elgoibar,Guipúzcoa,115,80,35
2006,20036,Hondarribia,Guipúzcoa,177,182,-5
2006,20040,Hernani,Guipúzcoa,122,144,-22
2006,20045,Irun,Guipúzcoa,700,795,-95
2006,20055,Arrasate/Mondragón,Guipúzcoa,180,345,-165
2006,20059,Oñati,Guipúzcoa,40,59,-19
2006,20064,Pasaia,Guipúzcoa,123,129,-6
2006,20067,Errenteria,Guipúzcoa,266,302,-36
2006,20069,Donostia/San Sebastián,Guipúzcoa,1794,2120,-326
2006,20071,Tolosa,Guipúzcoa,129,155,-26
2006,20074,Bergara,Guipúzcoa,95,151,-56
2006,20079,Zarautz,Guipúzcoa,194,223,-29
2006,20080,Zumarraga,Guipúzcoa,56,92,-36
2006,20902,Lasarte-Oria,Guipúzcoa,132,195,-63
2006,21002,Aljaraque,Huelva,209,172,37
2006,21005,Almonte,Huelva,316,364,-48
2006,21010,Ayamonte,Huelva,372,253,119
2006,21013,Bollullos Par del Condado,Huelva,114,96,18
2006,21021,Cartaya,Huelva,330,288,42
2006,21035,Gibraleón,Huelva,87,73,14
2006,21041,Huelva,Huelva,1399,1803,-404
2006,21042,Isla Cristina,Huelva,320,323,-3
2006,21044,Lepe,Huelva,349,452,-103
2006,21050,Moguer,Huelva,325,589,-264
2006,21054,La Palma del Condado,Huelva,162,106,56
2006,21060,Punta Umbría,Huelva,198,224,-26
2006,21072,Valverde del Camino,Huelva,81,102,-21
2006,22048,Barbastro,Huesca,251,260,-9
2006,22112,Fraga,Huesca,336,378,-42
2006,22125,Huesca,Huesca,1010,818,192
2006,22130,Jaca,Huesca,404,440,-36
2006,22158,Monzón,Huesca,257,296,-39
2006,23002,Alcalá la Real,Jaén,327,360,-33
2006,23003,Alcaudete,Jaén,139,148,-9
2006,23005,Andújar,Jaén,520,672,-152
2006,23009,Baeza,Jaén,247,270,-23
2006,23010,Bailén,Jaén,244,210,34
2006,23024,La Carolina,Jaén,266,226,40
2006,23050,Jaén,Jaén,1145,1621,-476
2006,23053,Jódar,Jaén,67,107,-40
2006,23055,Linares,Jaén,934,1092,-158
2006,23058,Mancha Real,Jaén,131,103,28
2006,23060,Martos,Jaén,234,254,-20
2006,23086,Torredelcampo,Jaén,112,121,-9
2006,23087,Torredonjimeno,Jaén,129,126,3
2006,23092,Úbeda,Jaén,364,468,-104
2006,23095,Villacarrillo,Jaén,156,134,22
2006,24008,Astorga,León,172,231,-59
2006,24010,La Bañeza,León,194,151,43
2006,24014,Bembibre,León,195,217,-22
2006,24089,León,León,2149,2833,-684
2006,24115,Ponferrada,León,1064,1131,-67
2006,24142,San Andrés del Rabanedo,León,471,406,65
2006,24202,Villablino,León,111,280,-169
2006,24222,Villaquilambre,León,357,218,139
2006,25040,Balaguer,Lleida,312,381,-69
2006,25120,Lleida,Lleida,2999,3045,-46
2006,25137,Mollerussa,Lleida,396,343,53
2006,25203,La Seu d'Urgell,Lleida,311,442,-131
2006,25217,Tàrrega,Lleida,481,437,44
2006,26018,Arnedo,La Rioja,139,194,-55
2006,26036,Calahorra,La Rioja,618,606,12
2006,26071,Haro,La Rioja,401,284,117
2006,26089,Logroño,La Rioja,2820,2811,9
2006,27028,Lugo,Lugo,1386,1489,-103
2006,27031,Monforte de Lemos,Lugo,362,402,-40
2006,27057,Sarria,Lugo,179,138,41
2006,27065,Vilalba,Lugo,148,177,-29
2006,27066,Viveiro,Lugo,223,255,-32
2006,28005,Alcalá de Henares,Madrid,3041,5824,-2783
2006,28006,Alcobendas,Madrid,1276,1449,-173
2006,28007,Alcorcón,Madrid,1691,2566,-875
2006,28009,Algete,Madrid,206,392,-186
2006,28010,Alpedrete,Madrid,121,195,-74
2006,28013,Aranjuez,Madrid,1071,1068,3
2006,28014,Arganda del Rey,Madrid,780,715,65
2006,28022,Boadilla del Monte,Madrid,445,443,2
2006,28040,Ciempozuelos,Madrid,343,305,38
2006,28045,Colmenar Viejo,Madrid,452,580,-128
2006,28047,Collado Villalba,Madrid,780,1080,-300
2006,28049,Coslada,Madrid,642,1393,-751
2006,28054,El Escorial,Madrid,115,223,-108
2006,28058,Fuenlabrada,Madrid,2200,4615,-2415
2006,28061,Galapagar,Madrid,395,613,-218
2006,28065,Getafe,Madrid,1768,2602,-834
2006,28068,Guadarrama,Madrid,161,193,-32
2006,28073,Humanes de Madrid,Madrid,256,497,-241
2006,28074,Leganés,Madrid,1717,2899,-1182
2006,28079,Madrid,Madrid,46535,53977,-7442
2006,28080,Majadahonda,Madrid,872,946,-74
2006,28083,Meco,Madrid,172,427,-255
2006,28084,Mejorada del Campo,Madrid,198,415,-217
2006,28090,Moralzarzal,Madrid,82,112,-30
2006,28092,Móstoles,Madrid,2198,4314,-2116
2006,28096,Navalcarnero,Madrid,309,375,-66
2006,28106,Parla,Madrid,1772,2413,-641
2006,28113,Pinto,Madrid,636,657,-21
2006,28115,Pozuelo de Alarcón,Madrid,876,864,12
2006,28123,Rivas-Vaciamadrid,Madrid,500,621,-121
2006,28127,Las Rozas de Madrid,Madrid,1127,971,156
2006,28130,San Fernando de Henares,Madrid,286,526,-240
2006,28131,San Lorenzo de El Escorial,Madrid,258,257,1
2006,28132,San Martín de la Vega,Madrid,247,403,-156
2006,28134,San Sebastián de los Reyes,Madrid,871,984,-113
2006,28148,Torrejón de Ardoz,Madrid,1585,2412,-827
2006,28152,Torrelodones,Madrid,199,225,-26
2006,28161,Valdemoro,Madrid,1126,1132,-6
2006,28176,Villanueva de la Cañada,Madrid,255,253,2
2006,28177,Villanueva del Pardillo,Madrid,227,219,8
2006,28181,Villaviciosa de Odón,Madrid,271,346,-75
2006,28903,Tres Cantos,Madrid,573,539,34
2006,29007,Alhaurín de la Torre,Málaga,413,240,173
2006,29008,Alhaurín el Grande,Málaga,164,103,61
2006,29012,Álora,Málaga,73,58,15
2006,29015,Antequera,Málaga,484,399,85
2006,29025,Benalmádena,Málaga,1401,803,598
2006,29038,Cártama,Málaga,176,92,84
2006,29042,Coín,Málaga,245,188,57
2006,29051,Estepona,Málaga,1835,1405,430
2006,29054,Fuengirola,Málaga,1511,1214,297
2006,29067,Málaga,Málaga,5740,5394,346
2006,29068,Manilva,Málaga,571,325,246
2006,29069,Marbella,Málaga,2627,2337,290
2006,29070,Mijas,Málaga,1190,642,548
2006,29075,Nerja,Málaga,244,210,34
2006,29082,Rincón de la Victoria,Málaga,737,414,323
2006,29084,Ronda,Málaga,591,413,178
2006,29091,Torrox,Málaga,281,160,121
2006,29094,Vélez-Málaga,Málaga,1035,676,359
2006,29901,Torremolinos,Málaga,1347,963,384
2006,30002,Abarán,Murcia,117,94,23
2006,30003,Águilas,Murcia,703,616,87
2006,30005,Alcantarilla,Murcia,558,412,146
2006,30008,Alhama de Murcia,Murcia,247,195,52
2006,30009,Archena,Murcia,328,187,141
2006,30010,Beniel,Murcia,305,211,94
2006,30012,Bullas,Murcia,123,89,34
2006,30015,Caravaca de la Cruz,Murcia,357,335,22
2006,30016,Cartagena,Murcia,2561,2908,-347
2006,30017,Cehegín,Murcia,167,141,26
2006,30019,Cieza (Murcia),Murcia,302,256,46
2006,30021,Fuente Álamo de Murcia,Murcia,271,240,31
2006,30022,Jumilla,Murcia,419,385,34
2006,30024,Lorca,Murcia,1496,1497,-1
2006,30026,Mazarrón,Murcia,699,701,-2
2006,30027,Molina de Segura,Murcia,1141,711,430
2006,30029,Mula,Murcia,215,146,69
2006,30030,Murcia,Murcia,5228,4908,320
2006,30033,Puerto Lumbreras,Murcia,213,155,58
2006,30035,San Javier,Murcia,957,749,208
2006,30036,San Pedro del Pinatar,Murcia,871,632,239
2006,30037,Torre-Pacheco,Murcia,500,493,7
2006,30038,Las Torres de Cotillas,Murcia,320,139,181
2006,30039,Totana,Murcia,367,322,45
2006,30041,La Unión,Murcia,197,140,57
2006,30043,Yecla,Murcia,489,502,-13
2006,30901,Santomera,Murcia,235,216,19
2006,30902,Los Alcázares,Murcia,541,472,69
2006,31060,Burlada/Burlata,Navarra,190,146,44
2006,31097,Estella-Lizarra,Navarra,194,160,34
2006,31201,Pamplona/Iruña,Navarra,2570,2507,63
2006,31227,Tafalla,Navarra,98,110,-12
2006,31232,Tudela,Navarra,726,719,7
2006,31258,Villava/Atarrabia,Navarra,72,78,-6
2006,31901,Barañain,Navarra,291,263,28
2006,31907,Zizur Mayor/Zizur Nagusia,Navarra,123,109,14
2006,32009,O Barco de Valdeorras,Ourense,228,293,-65
2006,32019,O Carballiño,Ourense,244,220,24
2006,32054,Ourense,Ourense,1483,1957,-474
2006,32085,Verín,Ourense,357,312,45
2006,33002,Aller,Asturias,76,80,-4
2006,33004,Avilés,Asturias,707,877,-170
2006,33011,Cangas del Narcea,Asturias,70,105,-35
2006,33014,Carreño,Asturias,82,84,-2
2006,33016,Castrillón,Asturias,178,199,-21
2006,33020,Corvera de Asturias,Asturias,135,147,-12
2006,33024,Gijón,Asturias,2827,3091,-264
2006,33025,Gozón,Asturias,107,82,25
2006,33026,Grado,Asturias,63,71,-8
2006,33031,Langreo,Asturias,315,357,-42
2006,33032,Laviana,Asturias,87,92,-5
2006,33033,Lena,Asturias,153,127,26
2006,33034,Valdés,Asturias,96,110,-14
2006,33035,Llanera,Asturias,84,118,-34
2006,33036,Llanes,Asturias,205,138,67
2006,33037,Mieres (Asturias),Asturias,299,387,-88
2006,33044,Oviedo,Asturias,2664,2855,-191
2006,33060,San Martín del Rey Aurelio,Asturias,88,137,-49
2006,33066,Siero,Asturias,416,403,13
2006,33073,Tineo,Asturias,39,81,-42
2006,33076,Villaviciosa,Asturias,138,94,44
2006,34120,Palencia,Palencia,1122,1433,-311
2006,35002,Agüimes,Las Palmas,311,262,49
2006,35004,Arrecife,Las Palmas,1656,1527,129
2006,35006,Arucas,Las Palmas,167,140,27
2006,35009,Gáldar,Las Palmas,87,86,1
2006,35011,Ingenio,Las Palmas,158,152,6
2006,35012,Mogán,Las Palmas,296,288,8
2006,35014,La Oliva,Las Palmas,1008,865,143
2006,35015,Pájara,Las Palmas,1127,1375,-248
2006,35016,Las Palmas de Gran Canaria,Las Palmas,4720,5287,-567
2006,35017,Puerto del Rosario,Las Palmas,1162,1326,-164
2006,35018,San Bartolomé,Las Palmas,461,549,-88
2006,35019,San Bartolomé de Tirajana,Las Palmas,728,735,-7
2006,35021,Santa Brígida,Las Palmas,134,91,43
2006,35022,Santa Lucía de Tirajana,Las Palmas,824,740,84
2006,35023,Santa María de Guía de Gran Canaria,Las Palmas,46,47,-1
2006,35024,Teguise,Las Palmas,478,401,77
2006,35026,Telde,Las Palmas,738,779,-41
2006,35027,Teror,Las Palmas,24,44,-20
2006,35028,Tías,Las Palmas,542,548,-6
2006,35030,Tuineje,Las Palmas,401,480,-79
2006,36003,Baiona,Pontevedra,115,98,17
2006,36004,Bueu,Pontevedra,67,103,-36
2006,36006,Cambados,Pontevedra,97,129,-32
2006,36008,Cangas,Pontevedra,257,249,8
2006,36017,A Estrada,Pontevedra,212,252,-40
2006,36021,Gondomar,Pontevedra,105,94,11
2006,36022,O Grove,Pontevedra,108,115,-7
2006,36023,A Guarda,Pontevedra,107,73,34
2006,36024,Lalín,Pontevedra,305,307,-2
2006,36026,Marín,Pontevedra,270,431,-161
2006,36029,Moaña,Pontevedra,116,128,-12
2006,36033,Mos,Pontevedra,57,64,-7
2006,36035,Nigrán,Pontevedra,159,162,-3
2006,36038,Pontevedra,Pontevedra,1019,1261,-242
2006,36039,O Porriño,Pontevedra,158,134,24
2006,36041,Poio,Pontevedra,233,189,44
2006,36042,Ponteareas,Pontevedra,325,301,24
2006,36045,Redondela,Pontevedra,166,230,-64
2006,36051,Sanxenxo,Pontevedra,180,187,-7
2006,36054,Tomiño,Pontevedra,132,94,38
2006,36055,Tui,Pontevedra,151,184,-33
2006,36057,Vigo,Pontevedra,3291,3950,-659
2006,36060,Vilagarcía de Arousa,Pontevedra,629,557,72
2006,36061,Vilanova de Arousa,Pontevedra,99,88,11
2006,37046,Béjar,Salamanca,304,311,-7
2006,37107,Ciudad Rodrigo,Salamanca,153,237,-84
2006,37274,Salamanca,Salamanca,2402,3255,-853
2006,37294,Santa Marta de Tormes,Salamanca,280,218,62
2006,38001,Adeje,Santa Cruz de Tenerife,1246,1078,168
2006,38006,Arona,Santa Cruz de Tenerife,2416,2241,175
2006,38011,Candelaria,Santa Cruz de Tenerife,412,401,11
2006,38017,Granadilla de Abona,Santa Cruz de Tenerife,961,945,16
2006,38019,Guía de Isora,Santa Cruz de Tenerife,186,295,-109
2006,38020,Güímar,Santa Cruz de Tenerife,93,123,-30
2006,38022,Icod de los Vinos,Santa Cruz de Tenerife,81,126,-45
2006,38023,San Cristóbal de La Laguna,Santa Cruz de Tenerife,1467,1286,181
2006,38024,Los Llanos de Aridane,Santa Cruz de Tenerife,259,212,47
2006,38026,La Orotava,Santa Cruz de Tenerife,222,218,4
2006,38028,Puerto de la Cruz,Santa Cruz de Tenerife,668,534,134
2006,38031,Los Realejos,Santa Cruz de Tenerife,189,161,28
2006,38032,El Rosario,Santa Cruz de Tenerife,181,205,-24
2006,38035,San Miguel de Abona,Santa Cruz de Tenerife,208,176,32
2006,38037,Santa Cruz de la Palma,Santa Cruz de Tenerife,342,417,-75
2006,38038,Santa Cruz de Tenerife,Santa Cruz de Tenerife,2647,3165,-518
2006,38039,Santa Úrsula,Santa Cruz de Tenerife,143,116,27
2006,38040,Santiago del Teide,Santa Cruz de Tenerife,126,163,-37
2006,38043,Tacoronte,Santa Cruz de Tenerife,124,130,-6
2006,38046,Tegueste,Santa Cruz de Tenerife,43,65,-22
2006,39008,El Astillero,Cantabria,163,168,-5
2006,39016,Camargo,Cantabria,286,250,36
2006,39020,Castro-Urdiales,Cantabria,2068,1407,661
2006,39025,Los Corrales de Buelna,Cantabria,86,96,-10
2006,39035,Laredo,Cantabria,230,274,-44
2006,39052,Piélagos,Cantabria,264,186,78
2006,39059,Reinosa,Cantabria,100,173,-73
2006,39073,Santa Cruz de Bezana,Cantabria,108,118,-10
2006,39075,Santander,Cantabria,2190,2433,-243
2006,39079,Santoña,Cantabria,210,206,4
2006,39087,Torrelavega,Cantabria,546,589,-43
2006,40194,Segovia,Segovia,831,1298,-467
2006,41004,Alcalá de Guadaíra,Sevilla,554,508,46
2006,41007,La Algaba,Sevilla,65,57,8
2006,41011,Arahal,Sevilla,74,74,0
2006,41017,Bormujos,Sevilla,328,203,125
2006,41018,Brenes,Sevilla,124,73,51
2006,41020,Las Cabezas de San Juan,Sevilla,160,132,28
2006,41021,Camas,Sevilla,258,214,44
2006,41024,Carmona,Sevilla,181,181,0
2006,41029,Castilleja de la Cuesta,Sevilla,214,155,59
2006,41034,Coria del Río,Sevilla,253,207,46
2006,41038,Dos Hermanas,Sevilla,1338,1018,320
2006,41039,Écija,Sevilla,462,342,120
2006,41041,Estepa,Sevilla,116,99,17
2006,41047,Gines,Sevilla,109,120,-11
2006,41053,Lebrija,Sevilla,305,192,113
2006,41055,Lora del Río,Sevilla,219,182,37
2006,41058,Mairena del Alcor,Sevilla,169,142,27
2006,41059,Mairena del Aljarafe,Sevilla,437,383,54
2006,41060,Marchena,Sevilla,174,108,66
2006,41065,Morón de la Frontera,Sevilla,301,286,15
2006,41068,Osuna,Sevilla,168,111,57
2006,41069,Los Palacios y Villafranca,Sevilla,248,173,75
2006,41075,Pilas,Sevilla,95,86,9
2006,41077,La Puebla de Cazalla,Sevilla,158,105,53
2006,41079,La Puebla del Río,Sevilla,158,78,80
2006,41081,La Rinconada,Sevilla,361,234,127
2006,41086,San Juan de Aznalfarache,Sevilla,279,230,49
2006,41087,Sanlúcar la Mayor,Sevilla,151,98,53
2006,41091,Sevilla,Sevilla,7649,7344,305
2006,41093,Tomares,Sevilla,388,261,127
2006,41095,Utrera,Sevilla,605,320,285
2006,41102,El Viso del Alcor,Sevilla,72,85,-13
2006,42173,Soria,Soria,785,954,-169
2006,43014,Amposta,Tarragona,518,373,145
2006,43037,Calafell,Tarragona,2315,1128,1187
2006,43038,Cambrils,Tarragona,965,641,324
2006,43051,Cunit,Tarragona,1529,668,861
2006,43123,Reus,Tarragona,2274,1609,665
2006,43136,Sant Carles de la Ràpita,Tarragona,520,245,275
2006,43148,Tarragona,Tarragona,2451,2254,197
2006,43153,Torredembarra,Tarragona,734,408,326
2006,43155,Tortosa,Tarragona,1172,1014,158
2006,43161,Valls,Tarragona,606,364,242
2006,43163,El Vendrell,Tarragona,2189,1239,950
2006,43171,Vila-seca,Tarragona,736,393,343
2006,43901,Deltebre,Tarragona,169,74,95
2006,43905,Salou,Tarragona,1263,866,397
2006,44013,Alcañiz,Teruel,292,347,-55
2006,44216,Teruel,Teruel,608,820,-212
2006,45053,Consuegra,Toledo,102,120,-18
2006,45081,Illescas,Toledo,1593,435,1158
2006,45087,Madridejos,Toledo,164,121,43
2006,45106,Mora,Toledo,146,152,-6
2006,45142,Quintanar de la Orden,Toledo,239,261,-22
2006,45161,Seseña,Toledo,1679,703,976
2006,45163,Sonseca,Toledo,176,155,21
2006,45165,Talavera de la Reina,Toledo,1719,1532,187
2006,45168,Toledo,Toledo,1922,1621,301
2006,45173,Torrijos,Toledo,363,233,130
2006,45185,Villacañas,Toledo,216,142,74
2006,46005,Alaquàs,Valencia,286,228,58
2006,46007,Albal,Valencia,116,108,8
2006,46011,Alberic,Valencia,140,116,24
2006,46013,Alboraya,Valencia,281,201,80
2006,46017,Alzira,Valencia,424,410,14
2006,46019,L'Alcúdia,Valencia,87,73,14
2006,46021,Aldaia,Valencia,266,198,68
2006,46022,Alfafar,Valencia,279,209,70
2006,46029,Algemesí,Valencia,330,249,81
2006,46031,Alginet,Valencia,81,78,3
2006,46051,Benaguasil,Valencia,76,61,15
2006,46054,Benetússer,Valencia,125,124,1
2006,46060,Benifaió,Valencia,80,81,-1
2006,46070,Bétera,Valencia,243,141,102
2006,46078,Burjassot,Valencia,355,337,18
2006,46081,Canals,Valencia,80,67,13
2006,46083,Carcaixent,Valencia,197,212,-15
2006,46085,Carlet,Valencia,130,113,17
2006,46094,Catarroja,Valencia,248,214,34
2006,46102,Quart de Poblet,Valencia,243,225,18
2006,46105,Cullera,Valencia,279,319,-40
2006,46110,Xirivella,Valencia,465,371,94
2006,46111,Chiva,Valencia,136,96,40
2006,46116,L'Eliana,Valencia,190,144,46
2006,46131,Gandia,Valencia,2067,1493,574
2006,46135,Godella,Valencia,100,107,-7
2006,46145,Xátiva,Valencia,319,325,-6
2006,46147,Llíria,Valencia,257,251,6
2006,46159,Manises,Valencia,318,294,24
2006,46164,Massamagrell,Valencia,110,92,18
2006,46169,Mislata,Valencia,541,500,41
2006,46171,Moncada,Valencia,175,141,34
2006,46181,Oliva,Valencia,488,514,-26
2006,46184,Ontinyent,Valencia,405,378,27
2006,46186,Paiporta,Valencia,221,187,34
2006,46190,Paterna,Valencia,854,683,171
2006,46193,Picanya,Valencia,98,60,38
2006,46194,Picassent,Valencia,170,132,38
2006,46202,La Pobla de Vallbona,Valencia,205,194,11
2006,46205,Puçol,Valencia,236,146,90
2006,46213,Requena,Valencia,161,189,-28
2006,46214,Riba-roja de Túria,Valencia,155,146,9
2006,46220,Sagunto/Sagunt,Valencia,1241,801,440
2006,46230,Silla,Valencia,232,198,34
2006,46235,Sueca,Valencia,229,179,50
2006,46238,Tavernes de la Valldigna,Valencia,150,146,4
2006,46244,Torrent (Valencia),Valencia,1048,801,247
2006,46249,Utiel,Valencia,102,88,14
2006,46250,València,Valencia,12450,11452,998
2006,47076,Laguna de Duero,Valladolid,305,285,20
2006,47085,Medina del Campo,Valladolid,250,242,8
2006,47186,Valladolid,Valladolid,4789,5055,-266
2006,48003,Amorebieta-Etxano,Vizcaya,104,127,-23
2006,48011,Arrigorriaga,Vizcaya,94,142,-48
2006,48013,Barakaldo,Vizcaya,863,1185,-322
2006,48015,Basauri,Vizcaya,257,546,-289
2006,48017,Bermeo,Vizcaya,83,146,-63
2006,48020,Bilbao,Vizcaya,3910,5275,-1365
2006,48027,Durango,Vizcaya,294,315,-21
2006,48034,Ermua,Vizcaya,172,321,-149
2006,48036,Galdakao,Vizcaya,168,293,-125
2006,48044,Getxo,Vizcaya,695,1051,-356
2006,48046,Gernika-Lumo,Vizcaya,94,94,0
2006,48054,Leioa,Vizcaya,237,350,-113
2006,48069,Mungia,Vizcaya,96,142,-46
2006,48078,Portugalete,Vizcaya,315,586,-271
2006,48080,Valle de Trápaga-Trapagaran,Vizcaya,96,124,-28
2006,48082,Santurtzi,Vizcaya,372,572,-200
2006,48084,Sestao,Vizcaya,228,411,-183
2006,48085,Sopela,Vizcaya,100,102,-2
2006,48902,Erandio,Vizcaya,215,292,-77
2006,49021,Benavente,Zamora,665,729,-64
2006,49275,Zamora,Zamora,1022,1330,-308
2006,50067,Calatayud,Zaragoza,333,409,-76
2006,50095,Ejea de los Caballeros,Zaragoza,192,202,-10
2006,50251,Tarazona,Zaragoza,180,199,-19
2006,50272,Utebo,Zaragoza,281,205,76
2006,50297,Zaragoza,Zaragoza,8352,8580,-228
2006,51001,Ceuta,Ceuta,2204,2425,-221
2006,52001,Melilla,Melilla,2634,2827,-193
2007,01036,Laudio/Llodio,Álava,256,324,-68
2007,01059,Vitoria-Gasteiz,Álava,3868,3845,23
2007,02003,Albacete,Albacete,2772,3201,-429
2007,02009,Almansa,Albacete,558,534,24
2007,02025,Caudete,Albacete,317,350,-33
2007,02037,Hellín,Albacete,737,737,0
2007,02069,La Roda,Albacete,318,339,-21
2007,02081,Villarrobledo,Albacete,464,563,-99
2007,03005,Albatera,Alicante,216,156,60
2007,03009,Alcoy/Alcoi,Alicante,703,624,79
2007,03011,L'Alfàs del Pi,Alicante,328,270,58
2007,03014,Alicante/Alacant,Alicante,6861,6104,757
2007,03015,Almoradí,Alicante,277,277,0
2007,03018,Altea,Alicante,443,448,-5
2007,03019,Aspe,Alicante,175,152,23
2007,03031,Benidorm,Alicante,2440,2316,124
2007,03041,Benissa,Alicante,151,172,-21
2007,03047,Calp,Alicante,620,596,24
2007,03049,Callosa de Segura,Alicante,169,238,-69
2007,03050,El Campello,Alicante,510,390,120
2007,03056,Cocentaina,Alicante,130,104,26
2007,03059,Crevillent,Alicante,348,384,-36
2007,03063,Dénia,Alicante,1251,1089,162
2007,03065,Elche/Elx,Alicante,3241,3000,241
2007,03066,Elda,Alicante,693,614,79
2007,03076,Guardamar del Segura,Alicante,446,344,102
2007,03079,Ibi,Alicante,274,249,25
2007,03082,Jávea/Xàbia,Alicante,571,563,8
2007,03089,Monóvar/Monòver,Alicante,111,103,8
2007,03090,Mutxamel,Alicante,265,207,58
2007,03093,Novelda,Alicante,246,237,9
2007,03094,La Nucia,Alicante,329,236,93
2007,03099,Orihuela,Alicante,1433,1342,91
2007,03102,Pego,Alicante,143,123,20
2007,03104,Petrer,Alicante,271,257,14
2007,03113,Rojales,Alicante,173,134,39
2007,03118,San Fulgencio,Alicante,165,68,97
2007,03119,Sant Joan d'Alacant,Alicante,442,303,139
2007,03121,Santa Pola,Alicante,863,563,300
2007,03122,San Vicente del Raspeig/Sant Vicent del Raspeig,Alicante,710,535,175
2007,03128,Teulada,Alicante,209,185,24
2007,03133,Torrevieja,Alicante,4416,3736,680
2007,03139,Villajoyosa/La Vila Joiosa,Alicante,867,574,293
2007,03140,Villena,Alicante,513,445,68
2007,03902,Pilar de la Horadada,Alicante,909,776,133
2007,04003,Adra,Almería,280,381,-101
2007,04006,Albox,Almería,218,360,-142
2007,04013,Almería,Almería,2432,3277,-845
2007,04029,Berja,Almería,147,160,-13
2007,04035,Cuevas del Almanzora,Almería,317,274,43
2007,04052,Huércal de Almería,Almería,127,121,6
2007,04053,Huércal-Overa,Almería,328,387,-59
2007,04066,Níjar,Almería,511,987,-476
2007,04079,Roquetas de Mar,Almería,2178,2406,-228
2007,04100,Vera,Almería,604,325,279
2007,04102,Vícar,Almería,503,832,-329
2007,04902,El Ejido,Almería,1463,2459,-996
2007,05019,Ávila,Ávila,1384,1356,28
2007,06011,Almendralejo,Badajoz,626,558,68
2007,06015,Badajoz,Badajoz,1883,2322,-439
2007,06044,Don Benito,Badajoz,639,479,160
2007,06083,Mérida,Badajoz,996,1013,-17
2007,06088,Montijo,Badajoz,246,165,81
2007,06095,Olivenza,Badajoz,203,191,12
2007,06149,Villafranca de los Barros,Badajoz,128,155,-27
2007,06153,Villanueva de la Serena,Badajoz,450,323,127
2007,06158,Zafra,Badajoz,256,257,-1
2007,07003,Alcúdia,Baleares,547,538,9
2007,07005,Andratx,Baleares,153,139,14
2007,07011,Calvià,Baleares,1083,919,164
2007,07014,Capdepera,Baleares,368,357,11
2007,07015,Ciutadella de Menorca,Baleares,1132,991,141
2007,07022,Felanitx,Baleares,297,212,85
2007,07026,Eivissa,Baleares,2041,1844,197
2007,07027,Inca,Baleares,537,413,124
2007,07031,Llucmajor,Baleares,771,578,193
2007,07032,Maó-Mahón,Baleares,1042,1015,27
2007,07033,Manacor,Baleares,1032,593,439
2007,07036,Marratxí,Baleares,253,211,42
2007,07040,Palma,Baleares,9084,8251,833
2007,07042,Pollença,Baleares,310,226,84
2007,07044,Sa Pobla,Baleares,120,112,8
2007,07046,Sant Antoni de Portmany,Baleares,822,608,214
2007,07048,Sant Josep de sa Talaia,Baleares,1109,749,360
2007,07054,Santa Eulària des Riu,Baleares,1231,930,301
2007,07055,Santa Margalida,Baleares,339,194,145
2007,07057,Santanyí,Baleares,293,225,68
2007,07061,Sóller,Baleares,182,136,46
2007,07062,Son Servera,Baleares,296,323,-27
2007,08001,Abrera,Barcelona,85,140,-55
2007,08006,Arenys de Mar,Barcelona,136,177,-41
2007,08009,Argentona,Barcelona,75,113,-38
2007,08015,Badalona,Barcelona,2337,3840,-1503
2007,08019,Barcelona,Barcelona,22025,26668,-4643
2007,08022,Berga,Barcelona,203,220,-17
2007,08033,Caldes de Montbui,Barcelona,148,167,-19
2007,08035,Calella,Barcelona,241,342,-101
2007,08040,Canet de Mar,Barcelona,94,156,-62
2007,08041,Canovelles,Barcelona,176,216,-40
2007,08046,Cardedeu,Barcelona,87,121,-34
2007,08051,Castellar del Vallès,Barcelona,146,195,-49
2007,08054,Castellbisbal,Barcelona,101,144,-43
2007,08056,Castelldefels,Barcelona,948,1319,-371
2007,08072,Corbera de Llobregat,Barcelona,75,172,-97
2007,08073,Cornellà de Llobregat,Barcelona,813,1324,-511
2007,08074,Cubelles,Barcelona,187,301,-114
2007,08076,Esparreguera,Barcelona,194,297,-103
2007,08077,Esplugues de Llobregat,Barcelona,477,656,-179
2007,08086,Les Franqueses del Vallès,Barcelona,169,204,-35
2007,08088,La Garriga,Barcelona,145,127,18
2007,08089,Gavà,Barcelona,494,785,-291
2007,08096,Granollers,Barcelona,704,1018,-314
2007,08101,L'Hospitalet de Llobregat,Barcelona,3178,4283,-1105
2007,08102,Igualada,Barcelona,487,489,-2
2007,08105,La Llagosta,Barcelona,137,216,-79
2007,08107,Lliçà d'Amunt,Barcelona,71,123,-52
2007,08110,Malgrat de Mar,Barcelona,274,323,-49
2007,08112,Manlleu,Barcelona,185,252,-67
2007,08113,Manresa,Barcelona,969,914,55
2007,08114,Martorell,Barcelona,379,407,-28
2007,08118,El Masnou,Barcelona,160,244,-84
2007,08121,Mataró,Barcelona,1191,1866,-675
2007,08123,Molins de Rei,Barcelona,139,227,-88
2007,08124,Mollet del Vallès,Barcelona,567,761,-194
2007,08125,Montcada i Reixac,Barcelona,295,480,-185
2007,08136,Montornès del Vallès,Barcelona,181,277,-96
2007,08147,Olesa de Montserrat,Barcelona,185,283,-98
2007,08156,Palau-solità i Plegamans,Barcelona,96,112,-16
2007,08157,Pallejà,Barcelona,88,130,-42
2007,08159,Parets del Vallès,Barcelona,93,148,-55
2007,08161,Piera,Barcelona,80,177,-97
2007,08163,Pineda de Mar,Barcelona,289,498,-209
2007,08169,El Prat de Llobregat,Barcelona,636,992,-356
2007,08172,Premià de Mar,Barcelona,205,391,-186
2007,08180,Ripollet,Barcelona,315,577,-262
2007,08184,Rubí,Barcelona,775,1145,-370
2007,08187,Sabadell,Barcelona,2023,2741,-718
2007,08194,Sant Adrià de Besòs,Barcelona,312,499,-187
2007,08196,Sant Andreu de la Barca,Barcelona,296,514,-218
2007,08200,Sant Boi de Llobregat,Barcelona,717,1233,-516
2007,08202,Sant Celoni,Barcelona,274,295,-21
2007,08205,Sant Cugat del Vallès,Barcelona,727,927,-200
2007,08211,Sant Feliu de Llobregat,Barcelona,308,522,-214
2007,08217,Sant Joan Despí,Barcelona,210,390,-180
2007,08218,Sant Joan de Vilatorrada,Barcelona,66,65,1
2007,08219,Vilassar de Mar,Barcelona,142,217,-75
2007,08221,Sant Just Desvern,Barcelona,95,151,-56
2007,08231,Sant Pere de Ribes,Barcelona,330,399,-69
2007,08238,Sant Quirze del Vallès,Barcelona,110,190,-80
2007,08240,Sant Sadurní d'Anoia,Barcelona,108,145,-37
2007,08245,Santa Coloma de Gramenet,Barcelona,1575,2261,-686
2007,08252,Barberà del Vallès,Barcelona,296,349,-53
2007,08260,Santa Perpètua de Mogoda,Barcelona,239,317,-78
2007,08263,Sant Vicenç dels Horts,Barcelona,197,386,-189
2007,08266,Cerdanyola del Vallès,Barcelona,505,794,-289
2007,08270,Sitges,Barcelona,359,374,-15
2007,08279,Terrassa,Barcelona,2283,2922,-639
2007,08284,Tordera,Barcelona,465,318,147
2007,08285,Torelló,Barcelona,106,108,-2
2007,08295,Vallirana,Barcelona,87,124,-37
2007,08298,Vic,Barcelona,636,623,13
2007,08301,Viladecans,Barcelona,596,1189,-593
2007,08302,Vilanova del Camí,Barcelona,113,132,-19
2007,08305,Vilafranca del Penedès,Barcelona,515,610,-95
2007,08307,Vilanova i la Geltrú,Barcelona,851,1119,-268
2007,08904,Badia del Vallès,Barcelona,98,249,-151
2007,09018,Aranda de Duero,Burgos,637,749,-112
2007,09059,Burgos,Burgos,2793,2873,-80
2007,09219,Miranda de Ebro,Burgos,1029,981,48
2007,10037,Cáceres,Cáceres,1405,1541,-136
2007,10067,Coria,Cáceres,182,193,-11
2007,10121,Miajadas,Cáceres,211,176,35
2007,10131,Navalmoral de la Mata,Cáceres,380,526,-146
2007,10148,Plasencia,Cáceres,606,713,-107
2007,11004,Algeciras,Cádiz,2215,1989,226
2007,11006,Arcos de la Frontera,Cádiz,367,262,105
2007,11007,Barbate,Cádiz,282,258,24
2007,11008,Los Barrios,Cádiz,334,318,16
2007,11012,Cádiz,Cádiz,1153,1580,-427
2007,11014,Conil de la Frontera,Cádiz,304,199,105
2007,11015,Chiclana de la Frontera,Cádiz,1038,838,200
2007,11016,Chipiona,Cádiz,302,224,78
2007,11020,Jerez de la Frontera,Cádiz,2777,2311,466
2007,11021,Jimena de la Frontera,Cádiz,174,208,-34
2007,11022,La Línea de la Concepción,Cádiz,752,770,-18
2007,11023,Medina-Sidonia,Cádiz,97,59,38
2007,11027,El Puerto de Santa María,Cádiz,1359,1425,-66
2007,11028,Puerto Real,Cádiz,448,416,32
2007,11030,Rota,Cádiz,593,463,130
2007,11031,San Fernando,Cádiz,1095,1168,-73
2007,11032,Sanlúcar de Barrameda,Cádiz,454,487,-33
2007,11033,San Roque,Cádiz,577,516,61
2007,11035,Tarifa,Cádiz,269,302,-33
2007,11038,Ubrique,Cádiz,123,200,-77
2007,11039,Vejer de la Frontera,Cádiz,92,69,23
2007,11041,Villamartín,Cádiz,122,143,-21
2007,12005,L'Alcora,Castellón,237,146,91
2007,12009,Almassora,Castellón,500,285,215
2007,12027,Benicarló,Castellón,793,588,205
2007,12028,Benicasim/Benicàssim,Castellón,441,368,73
2007,12032,Borriana/Burriana,Castellón,747,537,210
2007,12040,Castellón de la Plana/Castelló de la Plana,Castellón,3439,2786,653
2007,12082,Nules,Castellón,217,129,88
2007,12084,Onda,Castellón,640,387,253
2007,12126,La Vall d'Uixó,Castellón,554,371,183
2007,12135,Vila-real,Castellón,993,724,269
2007,12138,Vinaròs,Castellón,1002,654,348
2007,13005,Alcázar de San Juan,Ciudad Real,892,707,185
2007,13023,Bolaños de Calatrava,Ciudad Real,152,209,-57
2007,13028,Campo de Criptana,Ciudad Real,221,160,61
2007,13034,Ciudad Real,Ciudad Real,1321,1352,-31
2007,13039,Daimiel,Ciudad Real,231,175,56
2007,13053,Manzanares,Ciudad Real,355,391,-36
2007,13056,Miguelturra,Ciudad Real,270,141,129
2007,13071,Puertollano,Ciudad Real,1114,878,236
2007,13078,Socuéllamos,Ciudad Real,170,352,-182
2007,13079,La Solana,Ciudad Real,216,198,18
2007,13082,Tomelloso,Ciudad Real,763,788,-25
2007,13087,Valdepeñas,Ciudad Real,406,526,-120
2007,13096,Villarrubia de los Ojos,Ciudad Real,137,124,13
2007,14002,Aguilar de la Frontera,Córdoba,116,131,-15
2007,14007,Baena,Córdoba,295,551,-256
2007,14013,Cabra,Córdoba,220,232,-12
2007,14017,La Carlota,Córdoba,254,116,138
2007,14021,Córdoba,Córdoba,3651,4218,-567
2007,14030,Fuente Palmera,Córdoba,142,106,36
2007,14038,Lucena,Córdoba,675,609,66
2007,14042,Montilla,Córdoba,180,222,-42
2007,14049,Palma del Río,Córdoba,398,408,-10
2007,14052,Peñarroya-Pueblonuevo,Córdoba,209,228,-19
2007,14054,Pozoblanco,Córdoba,206,220,-14
2007,14055,Priego de Córdoba,Córdoba,362,283,79
2007,14056,Puente Genil,Córdoba,383,512,-129
2007,14058,Rute,Córdoba,182,145,37
2007,15002,Ames,A Coruña,697,403,294
2007,15005,Arteixo,A Coruña,364,317,47
2007,15009,Betanzos,A Coruña,160,125,35
2007,15011,Boiro,A Coruña,207,150,57
2007,15017,Cambre,A Coruña,255,233,22
2007,15019,Carballo,A Coruña,248,236,12
2007,15030,A Coruña,A Coruña,3234,3297,-63
2007,15031,Culleredo,A Coruña,390,321,69
2007,15035,Fene,A Coruña,86,111,-25
2007,15036,Ferrol,A Coruña,1081,1153,-72
2007,15041,A Laracha,A Coruña,72,53,19
2007,15054,Narón,A Coruña,422,312,110
2007,15057,Noia,A Coruña,156,176,-20
2007,15058,Oleiros,A Coruña,437,422,15
2007,15059,Ordes,A Coruña,76,69,7
2007,15070,As Pontes de García Rodríguez,A Coruña,98,145,-47
2007,15072,Rianxo,A Coruña,126,81,45
2007,15073,Ribeira,A Coruña,299,308,-9
2007,15075,Sada (A Coruña),A Coruña,224,159,65
2007,15077,Santa Comba,A Coruña,59,40,19
2007,15078,Santiago de Compostela,A Coruña,1515,1374,141
2007,15082,Teo,A Coruña,184,169,15
2007,16078,Cuenca,Cuenca,1325,1197,128
2007,16203,Tarancón,Cuenca,497,513,-16
2007,17015,Banyoles,Girona,263,256,7
2007,17023,Blanes,Girona,1545,1408,137
2007,17034,Calonge i Sant Antoni,Girona,248,251,-3
2007,17047,Castelló d'Empúries,Girona,333,230,103
2007,17066,Figueres,Girona,840,809,31
2007,17079,Girona,Girona,2084,2072,12
2007,17095,Lloret de Mar,Girona,1691,1369,322
2007,17114,Olot,Girona,621,625,-4
2007,17117,Palafrugell,Girona,398,421,-23
2007,17118,Palamós,Girona,373,356,17
2007,17147,Ripoll,Girona,224,199,25
2007,17152,Roses,Girona,535,433,102
2007,17155,Salt,Girona,590,742,-152
2007,17160,Sant Feliu de Guíxols,Girona,471,373,98
2007,17180,Santa Coloma de Farners,Girona,162,168,-6
2007,17199,Torroella de Montgrí,Girona,227,265,-38
2007,18003,Albolote,Granada,235,180,55
2007,18017,Almuñécar,Granada,497,464,33
2007,18021,Armilla,Granada,611,380,231
2007,18022,Atarfe,Granada,267,158,109
2007,18023,Baza,Granada,471,499,-28
2007,18062,Churriana de la Vega,Granada,291,152,139
2007,18087,Granada,Granada,4258,4547,-289
2007,18089,Guadix,Granada,326,381,-55
2007,18101,Huétor Vega,Granada,132,68,64
2007,18102,Illora,Granada,102,121,-19
2007,18122,Loja,Granada,275,245,30
2007,18127,Maracena,Granada,306,218,88
2007,18140,Motril,Granada,600,854,-254
2007,18145,Ogíjares,Granada,175,151,24
2007,18153,Peligros,Granada,132,115,17
2007,18158,Pinos Puente,Granada,179,139,40
2007,18173,Salobreña,Granada,222,159,63
2007,18175,Santa Fe,Granada,186,147,39
2007,18193,La Zubia,Granada,301,194,107
2007,18905,Las Gabias,Granada,293,131,162
2007,19046,Azuqueca de Henares,Guadalajara,2475,1246,1229
2007,19130,Guadalajara,Guadalajara,2197,1675,522
2007,20009,Andoain,Guipúzcoa,116,127,-11
2007,20017,Azkoitia,Guipúzcoa,124,92,32
2007,20018,Azpeitia,Guipúzcoa,109,94,15
2007,20019,Beasain,Guipúzcoa,227,185,42
2007,20030,Eibar,Guipúzcoa,360,422,-62
2007,20032,Elgoibar,Guipúzcoa,163,128,35
2007,20036,Hondarribia,Guipúzcoa,131,176,-45
2007,20040,Hernani,Guipúzcoa,139,153,-14
2007,20045,Irun,Guipúzcoa,720,878,-158
2007,20055,Arrasate/Mondragón,Guipúzcoa,177,298,-121
2007,20059,Oñati,Guipúzcoa,64,87,-23
2007,20064,Pasaia,Guipúzcoa,115,146,-31
2007,20067,Errenteria,Guipúzcoa,270,369,-99
2007,20069,Donostia/San Sebastián,Guipúzcoa,1914,2190,-276
2007,20071,Tolosa,Guipúzcoa,114,94,20
2007,20074,Bergara,Guipúzcoa,123,215,-92
2007,20079,Zarautz,Guipúzcoa,225,220,5
2007,20080,Zumarraga,Guipúzcoa,93,103,-10
2007,20902,Lasarte-Oria,Guipúzcoa,157,178,-21
2007,21002,Aljaraque,Huelva,273,207,66
2007,21005,Almonte,Huelva,252,424,-172
2007,21010,Ayamonte,Huelva,327,296,31
2007,21013,Bollullos Par del Condado,Huelva,111,140,-29
2007,21021,Cartaya,Huelva,283,304,-21
2007,21035,Gibraleón,Huelva,124,95,29
2007,21041,Huelva,Huelva,1472,1927,-455
2007,21042,Isla Cristina,Huelva,281,350,-69
2007,21044,Lepe,Huelva,424,518,-94
2007,21050,Moguer,Huelva,324,571,-247
2007,21054,La Palma del Condado,Huelva,141,117,24
2007,21060,Punta Umbría,Huelva,206,200,6
2007,21072,Valverde del Camino,Huelva,99,87,12
2007,22048,Barbastro,Huesca,346,275,71
2007,22112,Fraga,Huesca,330,426,-96
2007,22125,Huesca,Huesca,1240,972,268
2007,22130,Jaca,Huesca,421,445,-24
2007,22158,Monzón,Huesca,374,281,93
2007,23002,Alcalá la Real,Jaén,381,372,9
2007,23003,Alcaudete,Jaén,91,170,-79
2007,23005,Andújar,Jaén,506,649,-143
2007,23009,Baeza,Jaén,188,290,-102
2007,23010,Bailén,Jaén,174,225,-51
2007,23024,La Carolina,Jaén,244,371,-127
2007,23050,Jaén,Jaén,1302,2169,-867
2007,23053,Jódar,Jaén,101,151,-50
2007,23055,Linares,Jaén,804,1203,-399
2007,23058,Mancha Real,Jaén,103,133,-30
2007,23060,Martos,Jaén,298,304,-6
2007,23086,Torredelcampo,Jaén,172,179,-7
2007,23087,Torredonjimeno,Jaén,146,194,-48
2007,23092,Úbeda,Jaén,489,622,-133
2007,23095,Villacarrillo,Jaén,150,160,-10
2007,24008,Astorga,León,141,211,-70
2007,24010,La Bañeza,León,239,212,27
2007,24014,Bembibre,León,178,210,-32
2007,24089,León,León,2522,2855,-333
2007,24115,Ponferrada,León,1154,1142,12
2007,24142,San Andrés del Rabanedo,León,498,396,102
2007,24202,Villablino,León,136,252,-116
2007,24222,Villaquilambre,León,350,228,122
2007,25040,Balaguer,Lleida,351,350,1
2007,25120,Lleida,Lleida,3013,3181,-168
2007,25137,Mollerussa,Lleida,425,356,69
2007,25203,La Seu d'Urgell,Lleida,282,410,-128
2007,25217,Tàrrega,Lleida,450,395,55
2007,26018,Arnedo,La Rioja,182,201,-19
2007,26036,Calahorra,La Rioja,685,668,17
2007,26071,Haro,La Rioja,458,301,157
2007,26089,Logroño,La Rioja,3328,2817,511
2007,27028,Lugo,Lugo,1487,1452,35
2007,27031,Monforte de Lemos,Lugo,410,400,10
2007,27057,Sarria,Lugo,167,147,20
2007,27065,Vilalba,Lugo,168,143,25
2007,27066,Viveiro,Lugo,240,289,-49
2007,28005,Alcalá de Henares,Madrid,3700,6010,-2310
2007,28006,Alcobendas,Madrid,1444,1669,-225
2007,28007,Alcorcón,Madrid,1816,2724,-908
2007,28009,Algete,Madrid,223,335,-112
2007,28010,Alpedrete,Madrid,178,219,-41
2007,28013,Aranjuez,Madrid,1394,1291,103
2007,28014,Arganda del Rey,Madrid,815,925,-110
2007,28022,Boadilla del Monte,Madrid,495,435,60
2007,28040,Ciempozuelos,Madrid,363,443,-80
2007,28045,Colmenar Viejo,Madrid,484,597,-113
2007,28047,Collado Villalba,Madrid,834,1023,-189
2007,28049,Coslada,Madrid,739,1292,-553
2007,28054,El Escorial,Madrid,169,235,-66
2007,28058,Fuenlabrada,Madrid,2526,4680,-2154
2007,28061,Galapagar,Madrid,494,639,-145
2007,28065,Getafe,Madrid,2216,3084,-868
2007,28068,Guadarrama,Madrid,196,200,-4
2007,28073,Humanes de Madrid,Madrid,279,533,-254
2007,28074,Leganés,Madrid,2135,3180,-1045
2007,28079,Madrid,Madrid,55496,58777,-3281
2007,28080,Majadahonda,Madrid,918,969,-51
2007,28083,Meco,Madrid,234,357,-123
2007,28084,Mejorada del Campo,Madrid,245,366,-121
2007,28090,Moralzarzal,Madrid,85,165,-80
2007,28092,Móstoles,Madrid,2558,4104,-1546
2007,28096,Navalcarnero,Madrid,403,380,23
2007,28106,Parla,Madrid,2449,2803,-354
2007,28113,Pinto,Madrid,632,817,-185
2007,28115,Pozuelo de Alarcón,Madrid,1049,835,214
2007,28123,Rivas-Vaciamadrid,Madrid,715,578,137
2007,28127,Las Rozas de Madrid,Madrid,1203,1214,-11
2007,28130,San Fernando de Henares,Madrid,362,615,-253
2007,28131,San Lorenzo de El Escorial,Madrid,246,262,-16
2007,28132,San Martín de la Vega,Madrid,333,341,-8
2007,28134,San Sebastián de los Reyes,Madrid,1057,987,70
2007,28148,Torrejón de Ardoz,Madrid,1694,2472,-778
2007,28152,Torrelodones,Madrid,234,235,-1
2007,28160,Valdemorillo,Madrid,126,156,-30
2007,28161,Valdemoro,Madrid,1275,1184,91
2007,28167,Velilla de San Antonio,Madrid,97,159,-62
2007,28176,Villanueva de la Cañada,Madrid,251,244,7
2007,28177,Villanueva del Pardillo,Madrid,197,316,-119
2007,28181,Villaviciosa de Odón,Madrid,305,332,-27
2007,28903,Tres Cantos,Madrid,556,489,67
2007,29007,Alhaurín de la Torre,Málaga,409,288,121
2007,29008,Alhaurín el Grande,Málaga,239,113,126
2007,29012,Álora,Málaga,91,77,14
2007,29015,Antequera,Málaga,517,449,68
2007,29025,Benalmádena,Málaga,1335,1008,327
2007,29038,Cártama,Málaga,175,124,51
2007,29042,Coín,Málaga,294,191,103
2007,29051,Estepona,Málaga,1981,1544,437
2007,29054,Fuengirola,Málaga,1941,1433,508
2007,29067,Málaga,Málaga,6708,6121,587
2007,29068,Manilva,Málaga,657,546,111
2007,29069,Marbella,Málaga,2598,2677,-79
2007,29070,Mijas,Málaga,1268,815,453
2007,29075,Nerja,Málaga,400,226,174
2007,29082,Rincón de la Victoria,Málaga,624,420,204
2007,29084,Ronda,Málaga,612,482,130
2007,29091,Torrox,Málaga,304,224,80
2007,29094,Vélez-Málaga,Málaga,1060,794,266
2007,29901,Torremolinos,Málaga,1570,1132,438
2007,30002,Abarán,Murcia,126,136,-10
2007,30003,Águilas,Murcia,749,692,57
2007,30005,Alcantarilla,Murcia,564,486,78
2007,30008,Alhama de Murcia,Murcia,259,337,-78
2007,30009,Archena,Murcia,329,330,-1
2007,30010,Beniel,Murcia,296,282,14
2007,30012,Bullas,Murcia,139,117,22
2007,30013,Calasparra,Murcia,144,176,-32
2007,30015,Caravaca de la Cruz,Murcia,394,492,-98
2007,30016,Cartagena,Murcia,2806,3195,-389
2007,30017,Cehegín,Murcia,159,165,-6
2007,30019,Cieza (Murcia),Murcia,296,328,-32
2007,30021,Fuente Álamo de Murcia,Murcia,346,369,-23
2007,30022,Jumilla,Murcia,407,479,-72
2007,30024,Lorca,Murcia,1565,2144,-579
2007,30026,Mazarrón,Murcia,718,721,-3
2007,30027,Molina de Segura,Murcia,1144,862,282
2007,30029,Mula,Murcia,290,265,25
2007,30030,Murcia,Murcia,5914,5879,35
2007,30033,Puerto Lumbreras,Murcia,237,221,16
2007,30035,San Javier,Murcia,887,908,-21
2007,30036,San Pedro del Pinatar,Murcia,846,807,39
2007,30037,Torre-Pacheco,Murcia,533,712,-179
2007,30038,Las Torres de Cotillas,Murcia,333,209,124
2007,30039,Totana,Murcia,355,466,-111
2007,30041,La Unión,Murcia,207,170,37
2007,30043,Yecla,Murcia,632,546,86
2007,30901,Santomera,Murcia,256,262,-6
2007,30902,Los Alcázares,Murcia,584,558,26
2007,31016,Ansoáin/Antsoain,Navarra,122,89,33
2007,31060,Burlada/Burlata,Navarra,229,177,52
2007,31097,Estella-Lizarra,Navarra,191,185,6
2007,31201,Pamplona/Iruña,Navarra,3151,2554,597
2007,31227,Tafalla,Navarra,90,89,1
2007,31232,Tudela,Navarra,937,734,203
2007,31258,Villava/Atarrabia,Navarra,105,66,39
2007,31901,Barañain,Navarra,363,299,64
2007,31907,Zizur Mayor/Zizur Nagusia,Navarra,129,145,-16
2007,32009,O Barco de Valdeorras,Ourense,236,340,-104
2007,32019,O Carballiño,Ourense,215,207,8
2007,32032,Xinzo de Limia,Ourense,117,160,-43
2007,32054,Ourense,Ourense,1549,2066,-517
2007,32085,Verín,Ourense,340,347,-7
2007,33002,Aller,Asturias,88,101,-13
2007,33004,Avilés,Asturias,894,849,45
2007,33011,Cangas del Narcea,Asturias,100,140,-40
2007,33014,Carreño,Asturias,120,97,23
2007,33016,Castrillón,Asturias,198,212,-14
2007,33020,Corvera de Asturias,Asturias,130,164,-34
2007,33024,Gijón,Asturias,3519,3170,349
2007,33025,Gozón,Asturias,86,75,11
2007,33026,Grado,Asturias,100,66,34
2007,33031,Langreo,Asturias,378,319,59
2007,33032,Laviana,Asturias,86,86,0
2007,33033,Lena,Asturias,169,130,39
2007,33034,Valdés,Asturias,95,100,-5
2007,33035,Llanera,Asturias,148,117,31
2007,33036,Llanes,Asturias,235,163,72
2007,33037,Mieres (Asturias),Asturias,373,403,-30
2007,33044,Oviedo,Asturias,3263,3169,94
2007,33060,San Martín del Rey Aurelio,Asturias,117,148,-31
2007,33066,Siero,Asturias,534,390,144
2007,33073,Tineo,Asturias,44,60,-16
2007,33076,Villaviciosa,Asturias,145,108,37
2007,34120,Palencia,Palencia,1193,1455,-262
2007,35002,Agüimes,Las Palmas,373,309,64
2007,35004,Arrecife,Las Palmas,1764,1871,-107
2007,35006,Arucas,Las Palmas,154,143,11
2007,35009,Gáldar,Las Palmas,87,116,-29
2007,35011,Ingenio,Las Palmas,209,182,27
2007,35012,Mogán,Las Palmas,289,353,-64
2007,35014,La Oliva,Las Palmas,1044,1007,37
2007,35015,Pájara,Las Palmas,1160,1299,-139
2007,35016,Las Palmas de Gran Canaria,Las Palmas,4814,5581,-767
2007,35017,Puerto del Rosario,Las Palmas,1247,1438,-191
2007,35018,San Bartolomé,Las Palmas,414,567,-153
2007,35019,San Bartolomé de Tirajana,Las Palmas,700,802,-102
2007,35021,Santa Brígida,Las Palmas,125,151,-26
2007,35022,Santa Lucía de Tirajana,Las Palmas,859,831,28
2007,35023,Santa María de Guía de Gran Canaria,Las Palmas,75,59,16
2007,35024,Teguise,Las Palmas,471,472,-1
2007,35026,Telde,Las Palmas,681,844,-163
2007,35027,Teror,Las Palmas,48,33,15
2007,35028,Tías,Las Palmas,577,592,-15
2007,35030,Tuineje,Las Palmas,434,430,4
2007,35034,Yaiza,Las Palmas,802,715,87
2007,36003,Baiona,Pontevedra,112,131,-19
2007,36004,Bueu,Pontevedra,78,125,-47
2007,36006,Cambados,Pontevedra,107,149,-42
2007,36008,Cangas,Pontevedra,241,261,-20
2007,36017,A Estrada,Pontevedra,207,284,-77
2007,36021,Gondomar,Pontevedra,102,94,8
2007,36022,O Grove,Pontevedra,107,131,-24
2007,36023,A Guarda,Pontevedra,93,102,-9
2007,36024,Lalín,Pontevedra,326,320,6
2007,36026,Marín,Pontevedra,329,350,-21
2007,36029,Moaña,Pontevedra,144,119,25
2007,36033,Mos,Pontevedra,62,87,-25
2007,36035,Nigrán,Pontevedra,153,141,12
2007,36038,Pontevedra,Pontevedra,1158,1377,-219
2007,36039,O Porriño,Pontevedra,179,145,34
2007,36041,Poio,Pontevedra,227,185,42
2007,36042,Ponteareas,Pontevedra,267,295,-28
2007,36045,Redondela,Pontevedra,226,199,27
2007,36051,Sanxenxo,Pontevedra,198,225,-27
2007,36054,Tomiño,Pontevedra,127,102,25
2007,36055,Tui,Pontevedra,157,181,-24
2007,36057,Vigo,Pontevedra,3531,4104,-573
2007,36060,Vilagarcía de Arousa,Pontevedra,614,546,68
2007,36061,Vilanova de Arousa,Pontevedra,107,90,17
2007,37046,Béjar,Salamanca,338,354,-16
2007,37107,Ciudad Rodrigo,Salamanca,252,244,8
2007,37274,Salamanca,Salamanca,2549,3285,-736
2007,37294,Santa Marta de Tormes,Salamanca,290,288,2
2007,38001,Adeje,Santa Cruz de Tenerife,1160,1243,-83
2007,38006,Arona,Santa Cruz de Tenerife,2445,2449,-4
2007,38011,Candelaria,Santa Cruz de Tenerife,431,441,-10
2007,38017,Granadilla de Abona,Santa Cruz de Tenerife,1187,1061,126
2007,38019,Guía de Isora,Santa Cruz de Tenerife,290,246,44
2007,38020,Güímar,Santa Cruz de Tenerife,162,108,54
2007,38022,Icod de los Vinos,Santa Cruz de Tenerife,85,114,-29
2007,38023,San Cristóbal de La Laguna,Santa Cruz de Tenerife,1553,1492,61
2007,38024,Los Llanos de Aridane,Santa Cruz de Tenerife,299,289,10
2007,38026,La Orotava,Santa Cruz de Tenerife,255,248,7
2007,38028,Puerto de la Cruz,Santa Cruz de Tenerife,622,657,-35
2007,38031,Los Realejos,Santa Cruz de Tenerife,166,177,-11
2007,38032,El Rosario,Santa Cruz de Tenerife,186,254,-68
2007,38035,San Miguel de Abona,Santa Cruz de Tenerife,267,226,41
2007,38037,Santa Cruz de la Palma,Santa Cruz de Tenerife,338,358,-20
2007,38038,Santa Cruz de Tenerife,Santa Cruz de Tenerife,2546,3227,-681
2007,38039,Santa Úrsula,Santa Cruz de Tenerife,146,151,-5
2007,38040,Santiago del Teide,Santa Cruz de Tenerife,117,131,-14
2007,38043,Tacoronte,Santa Cruz de Tenerife,140,111,29
2007,38046,Tegueste,Santa Cruz de Tenerife,46,51,-5
2007,39008,El Astillero,Cantabria,233,178,55
2007,39016,Camargo,Cantabria,351,292,59
2007,39020,Castro-Urdiales,Cantabria,1981,1461,520
2007,39025,Los Corrales de Buelna,Cantabria,122,69,53
2007,39035,Laredo,Cantabria,227,237,-10
2007,39052,Piélagos,Cantabria,373,197,176
2007,39059,Reinosa,Cantabria,127,127,0
2007,39073,Santa Cruz de Bezana,Cantabria,130,111,19
2007,39075,Santander,Cantabria,2548,2552,-4
2007,39079,Santoña,Cantabria,243,245,-2
2007,39087,Torrelavega,Cantabria,581,571,10
2007,40194,Segovia,Segovia,987,1525,-538
2007,41004,Alcalá de Guadaíra,Sevilla,672,530,142
2007,41007,La Algaba,Sevilla,123,76,47
2007,41011,Arahal,Sevilla,111,68,43
2007,41017,Bormujos,Sevilla,351,174,177
2007,41018,Brenes,Sevilla,121,97,24
2007,41020,Las Cabezas de San Juan,Sevilla,149,174,-25
2007,41021,Camas,Sevilla,248,242,6
2007,41024,Carmona,Sevilla,273,187,86
2007,41029,Castilleja de la Cuesta,Sevilla,195,157,38
2007,41034,Coria del Río,Sevilla,327,218,109
2007,41038,Dos Hermanas,Sevilla,1349,986,363
2007,41039,Écija,Sevilla,472,390,82
2007,41040,Espartinas,Sevilla,289,113,176
2007,41041,Estepa,Sevilla,166,133,33
2007,41047,Gines,Sevilla,108,111,-3
2007,41053,Lebrija,Sevilla,264,164,100
2007,41055,Lora del Río,Sevilla,183,191,-8
2007,41058,Mairena del Alcor,Sevilla,190,152,38
2007,41059,Mairena del Aljarafe,Sevilla,540,457,83
2007,41060,Marchena,Sevilla,161,123,38
2007,41065,Morón de la Frontera,Sevilla,256,214,42
2007,41068,Osuna,Sevilla,199,184,15
2007,41069,Los Palacios y Villafranca,Sevilla,234,169,65
2007,41075,Pilas,Sevilla,151,80,71
2007,41077,La Puebla de Cazalla,Sevilla,181,110,71
2007,41079,La Puebla del Río,Sevilla,102,110,-8
2007,41081,La Rinconada,Sevilla,278,257,21
2007,41086,San Juan de Aznalfarache,Sevilla,400,283,117
2007,41087,Sanlúcar la Mayor,Sevilla,132,96,36
2007,41091,Sevilla,Sevilla,8414,7757,657
2007,41093,Tomares,Sevilla,392,311,81
2007,41095,Utrera,Sevilla,513,322,191
2007,41102,El Viso del Alcor,Sevilla,105,88,17
2007,42173,Soria,Soria,883,985,-102
2007,43014,Amposta,Tarragona,514,375,139
2007,43037,Calafell,Tarragona,1670,1125,545
2007,43038,Cambrils,Tarragona,972,710,262
2007,43051,Cunit,Tarragona,1192,671,521
2007,43092,Mont-roig del Camp,Tarragona,540,274,266
2007,43123,Reus,Tarragona,2238,1793,445
2007,43136,Sant Carles de la Ràpita,Tarragona,544,327,217
2007,43148,Tarragona,Tarragona,3050,2682,368
2007,43153,Torredembarra,Tarragona,614,459,155
2007,43155,Tortosa,Tarragona,956,1137,-181
2007,43161,Valls,Tarragona,631,381,250
2007,43163,El Vendrell,Tarragona,1978,1218,760
2007,43171,Vila-seca,Tarragona,676,422,254
2007,43901,Deltebre,Tarragona,150,101,49
2007,43905,Salou,Tarragona,1289,951,338
2007,44013,Alcañiz,Teruel,295,466,-171
2007,44216,Teruel,Teruel,500,826,-326
2007,45053,Consuegra,Toledo,135,136,-1
2007,45081,Illescas,Toledo,1939,671,1268
2007,45087,Madridejos,Toledo,142,178,-36
2007,45106,Mora,Toledo,202,237,-35
2007,45161,Seseña,Toledo,2069,860,1209
2007,45163,Sonseca,Toledo,210,214,-4
2007,45165,Talavera de la Reina,Toledo,2017,1911,106
2007,45168,Toledo,Toledo,1984,1761,223
2007,45173,Torrijos,Toledo,438,216,222
2007,45185,Villacañas,Toledo,207,187,20
2007,46005,Alaquàs,Valencia,310,282,28
2007,46007,Albal,Valencia,146,133,13
2007,46011,Alberic,Valencia,215,105,110
2007,46013,Alboraya,Valencia,292,221,71
2007,46017,Alzira,Valencia,470,364,106
2007,46019,L'Alcúdia,Valencia,118,77,41
2007,46021,Aldaia,Valencia,323,231,92
2007,46022,Alfafar,Valencia,289,241,48
2007,46029,Algemesí,Valencia,341,256,85
2007,46031,Alginet,Valencia,153,76,77
2007,46051,Benaguasil,Valencia,101,97,4
2007,46054,Benetússer,Valencia,157,153,4
2007,46060,Benifaió,Valencia,61,122,-61
2007,46070,Bétera,Valencia,265,203,62
2007,46078,Burjassot,Valencia,394,413,-19
2007,46081,Canals,Valencia,94,89,5
2007,46083,Carcaixent,Valencia,213,176,37
2007,46085,Carlet,Valencia,102,117,-15
2007,46094,Catarroja,Valencia,343,253,90
2007,46102,Quart de Poblet,Valencia,330,252,78
2007,46105,Cullera,Valencia,304,289,15
2007,46110,Xirivella,Valencia,533,473,60
2007,46111,Chiva,Valencia,206,126,80
2007,46116,L'Eliana,Valencia,194,178,16
2007,46131,Gandia,Valencia,2172,1853,319
2007,46135,Godella,Valencia,110,95,15
2007,46145,Xátiva,Valencia,402,350,52
2007,46147,Llíria,Valencia,332,291,41
2007,46159,Manises,Valencia,480,326,154
2007,46164,Massamagrell,Valencia,135,119,16
2007,46169,Mislata,Valencia,620,554,66
2007,46171,Moncada,Valencia,195,157,38
2007,46181,Oliva,Valencia,591,547,44
2007,46184,Ontinyent,Valencia,408,496,-88
2007,46186,Paiporta,Valencia,239,203,36
2007,46190,Paterna,Valencia,986,756,230
2007,46193,Picanya,Valencia,111,88,23
2007,46194,Picassent,Valencia,208,137,71
2007,46202,La Pobla de Vallbona,Valencia,248,170,78
2007,46205,Puçol,Valencia,289,198,91
2007,46213,Requena,Valencia,221,156,65
2007,46214,Riba-roja de Túria,Valencia,233,200,33
2007,46220,Sagunto/Sagunt,Valencia,1588,933,655
2007,46230,Silla,Valencia,238,200,38
2007,46235,Sueca,Valencia,262,216,46
2007,46238,Tavernes de la Valldigna,Valencia,195,152,43
2007,46244,Torrent (Valencia),Valencia,930,825,105
2007,46249,Utiel,Valencia,126,77,49
2007,46250,València,Valencia,14903,13061,1842
2007,47076,Laguna de Duero,Valladolid,303,332,-29
2007,47085,Medina del Campo,Valladolid,338,327,11
2007,47186,Valladolid,Valladolid,4967,5364,-397
2007,48003,Amorebieta-Etxano,Vizcaya,100,180,-80
2007,48011,Arrigorriaga,Vizcaya,66,130,-64
2007,48013,Barakaldo,Vizcaya,976,1287,-311
2007,48015,Basauri,Vizcaya,282,452,-170
2007,48017,Bermeo,Vizcaya,107,160,-53
2007,48020,Bilbao,Vizcaya,4458,5355,-897
2007,48027,Durango,Vizcaya,332,254,78
2007,48034,Ermua,Vizcaya,264,323,-59
2007,48036,Galdakao,Vizcaya,172,278,-106
2007,48044,Getxo,Vizcaya,766,1101,-335
2007,48046,Gernika-Lumo,Vizcaya,97,137,-40
2007,48054,Leioa,Vizcaya,276,382,-106
2007,48069,Mungia,Vizcaya,136,132,4
2007,48078,Portugalete,Vizcaya,355,562,-207
2007,48080,Valle de Trápaga-Trapagaran,Vizcaya,86,121,-35
2007,48082,Santurtzi,Vizcaya,458,635,-177
2007,48084,Sestao,Vizcaya,226,411,-185
2007,48085,Sopela,Vizcaya,96,117,-21
2007,48902,Erandio,Vizcaya,166,270,-104
2007,49021,Benavente,Zamora,598,639,-41
2007,49275,Zamora,Zamora,1087,1218,-131
2007,50067,Calatayud,Zaragoza,394,471,-77
2007,50095,Ejea de los Caballeros,Zaragoza,213,250,-37
2007,50251,Tarazona,Zaragoza,246,183,63
2007,50272,Utebo,Zaragoza,300,220,80
2007,50297,Zaragoza,Zaragoza,10177,8871,1306
2007,51001,Ceuta,Ceuta,2177,2556,-379
2007,52001,Melilla,Melilla,2867,2652,215
2008,01002,Amurrio,Álava,161,163,-2
2008,01036,Laudio/Llodio,Álava,337,328,9
2008,01059,Vitoria-Gasteiz,Álava,4265,3482,783
2008,02003,Albacete,Albacete,2667,2555,112
2008,02009,Almansa,Albacete,443,479,-36
2008,02025,Caudete,Albacete,285,274,11
2008,02037,Hellín,Albacete,651,644,7
2008,02069,La Roda,Albacete,207,240,-33
2008,02081,Villarrobledo,Albacete,426,424,2
2008,03005,Albatera,Alicante,98,163,-65
2008,03009,Alcoy/Alcoi,Alicante,510,618,-108
2008,03011,L'Alfàs del Pi,Alicante,306,290,16
2008,03014,Alicante/Alacant,Alicante,5671,6095,-424
2008,03015,Almoradí,Alicante,313,303,10
2008,03018,Altea,Alicante,367,365,2
2008,03019,Aspe,Alicante,168,192,-24
2008,03031,Benidorm,Alicante,2034,2158,-124
2008,03041,Benissa,Alicante,106,153,-47
2008,03047,Calp,Alicante,456,560,-104
2008,03049,Callosa de Segura,Alicante,224,152,72
2008,03050,El Campello,Alicante,426,345,81
2008,03053,Castalla,Alicante,108,63,45
2008,03056,Cocentaina,Alicante,112,97,15
2008,03059,Crevillent,Alicante,305,347,-42
2008,03063,Dénia,Alicante,925,896,29
2008,03065,Elche/Elx,Alicante,2617,2997,-380
2008,03066,Elda,Alicante,484,675,-191
2008,03076,Guardamar del Segura,Alicante,334,356,-22
2008,03079,Ibi,Alicante,208,246,-38
2008,03082,Jávea/Xàbia,Alicante,473,557,-84
2008,03089,Monóvar/Monòver,Alicante,95,106,-11
2008,03090,Mutxamel,Alicante,215,196,19
2008,03093,Novelda,Alicante,174,224,-50
2008,03094,La Nucia,Alicante,268,236,32
2008,03099,Orihuela,Alicante,1179,1352,-173
2008,03102,Pego,Alicante,134,173,-39
2008,03104,Petrer,Alicante,238,271,-33
2008,03113,Rojales,Alicante,120,107,13
2008,03118,San Fulgencio,Alicante,92,95,-3
2008,03119,Sant Joan d'Alacant,Alicante,358,359,-1
2008,03121,Santa Pola,Alicante,656,629,27
2008,03122,San Vicente del Raspeig/Sant Vicent del Raspeig,Alicante,687,622,65
2008,03128,Teulada,Alicante,156,178,-22
2008,03133,Torrevieja,Alicante,3325,4135,-810
2008,03139,Villajoyosa/La Vila Joiosa,Alicante,671,603,68
2008,03140,Villena,Alicante,490,532,-42
2008,03902,Pilar de la Horadada,Alicante,747,745,2
2008,04003,Adra,Almería,245,297,-52
2008,04006,Albox,Almería,178,362,-184
2008,04013,Almería,Almería,2287,2807,-520
2008,04029,Berja,Almería,104,187,-83
2008,04035,Cuevas del Almanzora,Almería,229,313,-84
2008,04052,Huércal de Almería,Almería,116,100,16
2008,04053,Huércal-Overa,Almería,318,357,-39
2008,04066,Níjar,Almería,493,731,-238
2008,04079,Roquetas de Mar,Almería,2033,1987,46
2008,04100,Vera,Almería,390,486,-96
2008,04102,Vícar,Almería,505,574,-69
2008,04902,El Ejido,Almería,1645,1963,-318
2008,05019,Ávila,Ávila,1014,1250,-236
2008,06011,Almendralejo,Badajoz,483,569,-86
2008,06015,Badajoz,Badajoz,1762,1927,-165
2008,06044,Don Benito,Badajoz,530,496,34
2008,06070,Jerez de los Caballeros,Badajoz,104,77,27
2008,06083,Mérida,Badajoz,951,881,70
2008,06088,Montijo,Badajoz,241,162,79
2008,06095,Olivenza,Badajoz,139,167,-28
2008,06149,Villafranca de los Barros,Badajoz,103,111,-8
2008,06153,Villanueva de la Serena,Badajoz,403,325,78
2008,06158,Zafra,Badajoz,245,206,39
2008,07003,Alcúdia,Baleares,583,572,11
2008,07005,Andratx,Baleares,127,128,-1
2008,07011,Calvià,Baleares,1023,872,151
2008,07014,Capdepera,Baleares,302,243,59
2008,07015,Ciutadella de Menorca,Baleares,1064,983,81
2008,07022,Felanitx,Baleares,283,203,80
2008,07026,Eivissa,Baleares,2089,1838,251
2008,07027,Inca,Baleares,389,428,-39
2008,07031,Llucmajor,Baleares,692,508,184
2008,07032,Maó-Mahón,Baleares,995,949,46
2008,07033,Manacor,Baleares,831,762,69
2008,07036,Marratxí,Baleares,267,237,30
2008,07040,Palma,Baleares,8363,7887,476
2008,07042,Pollença,Baleares,233,247,-14
2008,07044,Sa Pobla,Baleares,135,127,8
2008,07046,Sant Antoni de Portmany,Baleares,817,602,215
2008,07048,Sant Josep de sa Talaia,Baleares,1060,778,282
2008,07054,Santa Eulària des Riu,Baleares,1268,962,306
2008,07055,Santa Margalida,Baleares,351,299,52
2008,07057,Santanyí,Baleares,323,214,109
2008,07061,Sóller,Baleares,176,112,64
2008,07062,Son Servera,Baleares,321,271,50
2008,08001,Abrera,Barcelona,88,86,2
2008,08006,Arenys de Mar,Barcelona,149,180,-31
2008,08009,Argentona,Barcelona,67,95,-28
2008,08015,Badalona,Barcelona,2635,2765,-130
2008,08019,Barcelona,Barcelona,22613,22698,-85
2008,08022,Berga,Barcelona,123,162,-39
2008,08033,Caldes de Montbui,Barcelona,163,157,6
2008,08035,Calella,Barcelona,227,289,-62
2008,08040,Canet de Mar,Barcelona,111,155,-44
2008,08041,Canovelles,Barcelona,195,195,0
2008,08046,Cardedeu,Barcelona,133,158,-25
2008,08051,Castellar del Vallès,Barcelona,163,243,-80
2008,08054,Castellbisbal,Barcelona,79,112,-33
2008,08056,Castelldefels,Barcelona,1079,1165,-86
2008,08072,Corbera de Llobregat,Barcelona,78,141,-63
2008,08073,Cornellà de Llobregat,Barcelona,976,1077,-101
2008,08074,Cubelles,Barcelona,247,323,-76
2008,08076,Esparreguera,Barcelona,181,274,-93
2008,08077,Esplugues de Llobregat,Barcelona,458,564,-106
2008,08086,Les Franqueses del Vallès,Barcelona,179,167,12
2008,08088,La Garriga,Barcelona,103,122,-19
2008,08089,Gavà,Barcelona,570,612,-42
2008,08096,Granollers,Barcelona,731,824,-93
2008,08101,L'Hospitalet de Llobregat,Barcelona,3578,3712,-134
2008,08102,Igualada,Barcelona,501,531,-30
2008,08105,La Llagosta,Barcelona,170,222,-52
2008,08107,Lliçà d'Amunt,Barcelona,93,96,-3
2008,08110,Malgrat de Mar,Barcelona,332,351,-19
2008,08112,Manlleu,Barcelona,202,251,-49
2008,08113,Manresa,Barcelona,964,836,128
2008,08114,Martorell,Barcelona,402,406,-4
2008,08118,El Masnou,Barcelona,157,197,-40
2008,08121,Mataró,Barcelona,1293,1507,-214
2008,08123,Molins de Rei,Barcelona,143,234,-91
2008,08124,Mollet del Vallès,Barcelona,612,672,-60
2008,08125,Montcada i Reixac,Barcelona,344,410,-66
2008,08126,Montgat,Barcelona,84,83,1
2008,08136,Montornès del Vallès,Barcelona,166,216,-50
2008,08147,Olesa de Montserrat,Barcelona,211,220,-9
2008,08156,Palau-solità i Plegamans,Barcelona,84,127,-43
2008,08157,Pallejà,Barcelona,85,123,-38
2008,08159,Parets del Vallès,Barcelona,132,169,-37
2008,08161,Piera,Barcelona,109,167,-58
2008,08163,Pineda de Mar,Barcelona,334,439,-105
2008,08169,El Prat de Llobregat,Barcelona,689,782,-93
2008,08172,Premià de Mar,Barcelona,249,277,-28
2008,08180,Ripollet,Barcelona,332,442,-110
2008,08181,La Roca del Vallès,Barcelona,62,86,-24
2008,08184,Rubí,Barcelona,832,1009,-177
2008,08187,Sabadell,Barcelona,2140,2198,-58
2008,08194,Sant Adrià de Besòs,Barcelona,321,380,-59
2008,08196,Sant Andreu de la Barca,Barcelona,267,412,-145
2008,08197,Sant Andreu de Llavaneres,Barcelona,76,75,1
2008,08200,Sant Boi de Llobregat,Barcelona,771,1043,-272
2008,08202,Sant Celoni,Barcelona,211,292,-81
2008,08205,Sant Cugat del Vallès,Barcelona,841,735,106
2008,08211,Sant Feliu de Llobregat,Barcelona,376,503,-127
2008,08217,Sant Joan Despí,Barcelona,268,333,-65
2008,08218,Sant Joan de Vilatorrada,Barcelona,66,79,-13
2008,08219,Vilassar de Mar,Barcelona,157,180,-23
2008,08221,Sant Just Desvern,Barcelona,106,140,-34
2008,08231,Sant Pere de Ribes,Barcelona,365,318,47
2008,08238,Sant Quirze del Vallès,Barcelona,91,179,-88
2008,08240,Sant Sadurní d'Anoia,Barcelona,119,122,-3
2008,08245,Santa Coloma de Gramenet,Barcelona,1681,1982,-301
2008,08252,Barberà del Vallès,Barcelona,272,300,-28
2008,08260,Santa Perpètua de Mogoda,Barcelona,252,265,-13
2008,08263,Sant Vicenç dels Horts,Barcelona,285,333,-48
2008,08266,Cerdanyola del Vallès,Barcelona,524,671,-147
2008,08270,Sitges,Barcelona,374,339,35
2008,08279,Terrassa,Barcelona,2598,2508,90
2008,08284,Tordera,Barcelona,416,378,38
2008,08285,Torelló,Barcelona,104,127,-23
2008,08295,Vallirana,Barcelona,113,138,-25
2008,08298,Vic,Barcelona,564,515,49
2008,08301,Viladecans,Barcelona,698,907,-209
2008,08302,Vilanova del Camí,Barcelona,84,136,-52
2008,08305,Vilafranca del Penedès,Barcelona,491,540,-49
2008,08307,Vilanova i la Geltrú,Barcelona,910,1022,-112
2008,08904,Badia del Vallès,Barcelona,106,183,-77
2008,09018,Aranda de Duero,Burgos,699,727,-28
2008,09059,Burgos,Burgos,2464,2687,-223
2008,09219,Miranda de Ebro,Burgos,840,1050,-210
2008,10037,Cáceres,Cáceres,1383,1371,12
2008,10067,Coria,Cáceres,129,152,-23
2008,10121,Miajadas,Cáceres,177,156,21
2008,10131,Navalmoral de la Mata,Cáceres,296,407,-111
2008,10148,Plasencia,Cáceres,608,623,-15
2008,11004,Algeciras,Cádiz,2094,1948,146
2008,11006,Arcos de la Frontera,Cádiz,263,296,-33
2008,11007,Barbate,Cádiz,303,261,42
2008,11008,Los Barrios,Cádiz,328,311,17
2008,11012,Cádiz,Cádiz,1358,1421,-63
2008,11014,Conil de la Frontera,Cádiz,234,192,42
2008,11015,Chiclana de la Frontera,Cádiz,806,904,-98
2008,11016,Chipiona,Cádiz,202,218,-16
2008,11020,Jerez de la Frontera,Cádiz,2611,2336,275
2008,11021,Jimena de la Frontera,Cádiz,142,168,-26
2008,11022,La Línea de la Concepción,Cádiz,748,771,-23
2008,11023,Medina-Sidonia,Cádiz,64,82,-18
2008,11027,El Puerto de Santa María,Cádiz,1334,1304,30
2008,11028,Puerto Real,Cádiz,397,444,-47
2008,11030,Rota,Cádiz,652,463,189
2008,11031,San Fernando,Cádiz,963,1036,-73
2008,11032,Sanlúcar de Barrameda,Cádiz,466,421,45
2008,11033,San Roque,Cádiz,522,436,86
2008,11035,Tarifa,Cádiz,256,283,-27
2008,11038,Ubrique,Cádiz,121,206,-85
2008,11039,Vejer de la Frontera,Cádiz,68,57,11
2008,11041,Villamartín,Cádiz,138,138,0
2008,12005,L'Alcora,Castellón,114,187,-73
2008,12009,Almassora,Castellón,325,262,63
2008,12027,Benicarló,Castellón,551,582,-31
2008,12028,Benicasim/Benicàssim,Castellón,344,317,27
2008,12032,Borriana/Burriana,Castellón,550,603,-53
2008,12040,Castellón de la Plana/Castelló de la Plana,Castellón,2791,2726,65
2008,12082,Nules,Castellón,196,145,51
2008,12084,Onda,Castellón,356,443,-87
2008,12085,Oropesa del Mar/Orpesa,Castellón,556,778,-222
2008,12126,La Vall d'Uixó,Castellón,372,366,6
2008,12135,Vila-real,Castellón,748,748,0
2008,12138,Vinaròs,Castellón,755,676,79
2008,13005,Alcázar de San Juan,Ciudad Real,590,618,-28
2008,13023,Bolaños de Calatrava,Ciudad Real,121,150,-29
2008,13028,Campo de Criptana,Ciudad Real,167,200,-33
2008,13034,Ciudad Real,Ciudad Real,1434,1158,276
2008,13039,Daimiel,Ciudad Real,217,157,60
2008,13053,Manzanares,Ciudad Real,346,333,13
2008,13056,Miguelturra,Ciudad Real,197,153,44
2008,13071,Puertollano,Ciudad Real,1030,831,199
2008,13078,Socuéllamos,Ciudad Real,205,263,-58
2008,13079,La Solana,Ciudad Real,192,180,12
2008,13082,Tomelloso,Ciudad Real,541,662,-121
2008,13087,Valdepeñas,Ciudad Real,593,470,123
2008,13096,Villarrubia de los Ojos,Ciudad Real,96,117,-21
2008,14002,Aguilar de la Frontera,Córdoba,102,116,-14
2008,14007,Baena,Córdoba,205,501,-296
2008,14013,Cabra,Córdoba,179,204,-25
2008,14017,La Carlota,Córdoba,199,152,47
2008,14021,Córdoba,Córdoba,4097,3740,357
2008,14030,Fuente Palmera,Córdoba,117,114,3
2008,14038,Lucena,Córdoba,548,620,-72
2008,14042,Montilla,Córdoba,170,191,-21
2008,14049,Palma del Río,Córdoba,285,338,-53
2008,14052,Peñarroya-Pueblonuevo,Córdoba,219,171,48
2008,14054,Pozoblanco,Córdoba,153,178,-25
2008,14055,Priego de Córdoba,Córdoba,336,319,17
2008,14056,Puente Genil,Córdoba,435,426,9
2008,14058,Rute,Córdoba,139,142,-3
2008,15002,Ames,A Coruña,632,421,211
2008,15005,Arteixo,A Coruña,465,308,157
2008,15009,Betanzos,A Coruña,123,112,11
2008,15011,Boiro,A Coruña,224,159,65
2008,15017,Cambre,A Coruña,237,210,27
2008,15019,Carballo,A Coruña,290,162,128
2008,15030,A Coruña,A Coruña,3362,3023,339
2008,15031,Culleredo,A Coruña,389,295,94
2008,15035,Fene,A Coruña,93,99,-6
2008,15036,Ferrol,A Coruña,994,983,11
2008,15041,A Laracha,A Coruña,82,49,33
2008,15054,Narón,A Coruña,379,318,61
2008,15057,Noia,A Coruña,193,127,66
2008,15058,Oleiros,A Coruña,424,353,71
2008,15059,Ordes,A Coruña,99,71,28
2008,15070,As Pontes de García Rodríguez,A Coruña,121,120,1
2008,15072,Rianxo,A Coruña,105,92,13
2008,15073,Ribeira,A Coruña,345,256,89
2008,15075,Sada (A Coruña),A Coruña,236,147,89
2008,15077,Santa Comba,A Coruña,51,55,-4
2008,15078,Santiago de Compostela,A Coruña,1495,1292,203
2008,15082,Teo,A Coruña,175,186,-11
2008,16078,Cuenca,Cuenca,1220,1187,33
2008,16203,Tarancón,Cuenca,605,444,161
2008,17015,Banyoles,Girona,265,283,-18
2008,17022,La Bisbal d'Empordà,Girona,143,171,-28
2008,17023,Blanes,Girona,1372,1371,1
2008,17034,Calonge i Sant Antoni,Girona,257,252,5
2008,17047,Castelló d'Empúries,Girona,246,227,19
2008,17048,Castell-Platja d'Aro,Girona,345,285,60
2008,17066,Figueres,Girona,783,932,-149
2008,17079,Girona,Girona,1897,2016,-119
2008,17095,Lloret de Mar,Girona,1404,1475,-71
2008,17114,Olot,Girona,544,586,-42
2008,17117,Palafrugell,Girona,317,438,-121
2008,17118,Palamós,Girona,355,332,23
2008,17147,Ripoll,Girona,211,222,-11
2008,17152,Roses,Girona,399,451,-52
2008,17155,Salt,Girona,585,723,-138
2008,17160,Sant Feliu de Guíxols,Girona,399,403,-4
2008,17180,Santa Coloma de Farners,Girona,198,182,16
2008,17199,Torroella de Montgrí,Girona,213,263,-50
2008,18003,Albolote,Granada,206,205,1
2008,18017,Almuñécar,Granada,387,482,-95
2008,18021,Armilla,Granada,494,422,72
2008,18022,Atarfe,Granada,213,188,25
2008,18023,Baza,Granada,451,455,-4
2008,18062,Churriana de la Vega,Granada,276,166,110
2008,18087,Granada,Granada,3806,4306,-500
2008,18089,Guadix,Granada,294,297,-3
2008,18101,Huétor Vega,Granada,120,135,-15
2008,18102,Illora,Granada,101,107,-6
2008,18122,Loja,Granada,222,272,-50
2008,18127,Maracena,Granada,293,245,48
2008,18140,Motril,Granada,649,873,-224
2008,18145,Ogíjares,Granada,127,158,-31
2008,18153,Peligros,Granada,95,116,-21
2008,18158,Pinos Puente,Granada,131,145,-14
2008,18173,Salobreña,Granada,127,198,-71
2008,18175,Santa Fe,Granada,225,183,42
2008,18193,La Zubia,Granada,238,203,35
2008,18905,Las Gabias,Granada,375,217,158
2008,19046,Azuqueca de Henares,Guadalajara,2259,1327,932
2008,19130,Guadalajara,Guadalajara,2251,1814,437
2008,20009,Andoain,Guipúzcoa,117,124,-7
2008,20017,Azkoitia,Guipúzcoa,104,83,21
2008,20018,Azpeitia,Guipúzcoa,97,77,20
2008,20019,Beasain,Guipúzcoa,140,131,9
2008,20030,Eibar,Guipúzcoa,343,429,-86
2008,20032,Elgoibar,Guipúzcoa,143,118,25
2008,20036,Hondarribia,Guipúzcoa,136,175,-39
2008,20040,Hernani,Guipúzcoa,154,124,30
2008,20045,Irun,Guipúzcoa,691,760,-69
2008,20055,Arrasate/Mondragón,Guipúzcoa,232,281,-49
2008,20059,Oñati,Guipúzcoa,57,70,-13
2008,20064,Pasaia,Guipúzcoa,112,114,-2
2008,20067,Errenteria,Guipúzcoa,287,309,-22
2008,20069,Donostia/San Sebastián,Guipúzcoa,1940,1964,-24
2008,20071,Tolosa,Guipúzcoa,99,114,-15
2008,20074,Bergara,Guipúzcoa,124,150,-26
2008,20079,Zarautz,Guipúzcoa,231,181,50
2008,20080,Zumarraga,Guipúzcoa,68,90,-22
2008,20902,Lasarte-Oria,Guipúzcoa,155,160,-5
2008,21002,Aljaraque,Huelva,204,164,40
2008,21005,Almonte,Huelva,255,282,-27
2008,21010,Ayamonte,Huelva,321,292,29
2008,21013,Bollullos Par del Condado,Huelva,81,125,-44
2008,21021,Cartaya,Huelva,284,247,37
2008,21035,Gibraleón,Huelva,74,81,-7
2008,21041,Huelva,Huelva,1473,1605,-132
2008,21042,Isla Cristina,Huelva,320,334,-14
2008,21044,Lepe,Huelva,416,443,-27
2008,21050,Moguer,Huelva,363,324,39
2008,21054,La Palma del Condado,Huelva,94,92,2
2008,21060,Punta Umbría,Huelva,227,175,52
2008,21072,Valverde del Camino,Huelva,104,85,19
2008,22048,Barbastro,Huesca,326,225,101
2008,22112,Fraga,Huesca,363,315,48
2008,22125,Huesca,Huesca,1119,953,166
2008,22130,Jaca,Huesca,447,477,-30
2008,22158,Monzón,Huesca,377,351,26
2008,22199,Sabiñánigo,Huesca,237,229,8
2008,23002,Alcalá la Real,Jaén,359,336,23
2008,23003,Alcaudete,Jaén,138,142,-4
2008,23005,Andújar,Jaén,512,679,-167
2008,23009,Baeza,Jaén,206,243,-37
2008,23010,Bailén,Jaén,182,287,-105
2008,23024,La Carolina,Jaén,213,229,-16
2008,23050,Jaén,Jaén,1060,1783,-723
2008,23053,Jódar,Jaén,132,121,11
2008,23055,Linares,Jaén,730,999,-269
2008,23058,Mancha Real,Jaén,114,107,7
2008,23060,Martos,Jaén,220,269,-49
2008,23086,Torredelcampo,Jaén,102,137,-35
2008,23087,Torredonjimeno,Jaén,133,169,-36
2008,23092,Úbeda,Jaén,412,562,-150
2008,23095,Villacarrillo,Jaén,148,149,-1
2008,24008,Astorga,León,251,200,51
2008,24010,La Bañeza,León,191,201,-10
2008,24014,Bembibre,León,157,195,-38
2008,24089,León,León,2219,2432,-213
2008,24115,Ponferrada,León,1182,1048,134
2008,24142,San Andrés del Rabanedo,León,492,392,100
2008,24202,Villablino,León,96,189,-93
2008,24222,Villaquilambre,León,312,263,49
2008,25040,Balaguer,Lleida,354,304,50
2008,25120,Lleida,Lleida,2994,3132,-138
2008,25137,Mollerussa,Lleida,375,308,67
2008,25203,La Seu d'Urgell,Lleida,319,394,-75
2008,25217,Tàrrega,Lleida,357,340,17
2008,26018,Arnedo,La Rioja,173,202,-29
2008,26036,Calahorra,La Rioja,589,599,-10
2008,26071,Haro,La Rioja,370,317,53
2008,26089,Logroño,La Rioja,3013,2636,377
2008,27028,Lugo,Lugo,1452,1393,59
2008,27031,Monforte de Lemos,Lugo,373,398,-25
2008,27057,Sarria,Lugo,190,173,17
2008,27065,Vilalba,Lugo,142,153,-11
2008,27066,Viveiro,Lugo,195,261,-66
2008,28005,Alcalá de Henares,Madrid,3297,4977,-1680
2008,28006,Alcobendas,Madrid,1391,1452,-61
2008,28007,Alcorcón,Madrid,1620,2320,-700
2008,28009,Algete,Madrid,247,331,-84
2008,28010,Alpedrete,Madrid,139,183,-44
2008,28013,Aranjuez,Madrid,1400,1195,205
2008,28014,Arganda del Rey,Madrid,685,784,-99
2008,28015,Arroyomolinos (Madrid),Madrid,232,141,91
2008,28022,Boadilla del Monte,Madrid,509,438,71
2008,28040,Ciempozuelos,Madrid,387,400,-13
2008,28045,Colmenar Viejo,Madrid,497,498,-1
2008,28047,Collado Villalba,Madrid,723,896,-173
2008,28049,Coslada,Madrid,748,1197,-449
2008,28054,El Escorial,Madrid,144,196,-52
2008,28058,Fuenlabrada,Madrid,2511,4089,-1578
2008,28061,Galapagar,Madrid,397,504,-107
2008,28065,Getafe,Madrid,2279,2732,-453
2008,28068,Guadarrama,Madrid,175,220,-45
2008,28073,Humanes de Madrid,Madrid,328,508,-180
2008,28074,Leganés,Madrid,2095,2835,-740
2008,28079,Madrid,Madrid,50307,51991,-1684
2008,28080,Majadahonda,Madrid,917,812,105
2008,28083,Meco,Madrid,249,333,-84
2008,28084,Mejorada del Campo,Madrid,220,331,-111
2008,28090,Moralzarzal,Madrid,98,116,-18
2008,28092,Móstoles,Madrid,2459,3736,-1277
2008,28096,Navalcarnero,Madrid,422,373,49
2008,28104,Paracuellos de Jarama,Madrid,399,169,230
2008,28106,Parla,Madrid,2179,2481,-302
2008,28113,Pinto,Madrid,605,724,-119
2008,28115,Pozuelo de Alarcón,Madrid,900,787,113
2008,28123,Rivas-Vaciamadrid,Madrid,712,559,153
2008,28127,Las Rozas de Madrid,Madrid,1106,1063,43
2008,28129,San Agustín del Guadalix,Madrid,147,131,16
2008,28130,San Fernando de Henares,Madrid,350,476,-126
2008,28131,San Lorenzo de El Escorial,Madrid,240,242,-2
2008,28132,San Martín de la Vega,Madrid,294,363,-69
2008,28134,San Sebastián de los Reyes,Madrid,1128,993,135
2008,28148,Torrejón de Ardoz,Madrid,1544,2089,-545
2008,28152,Torrelodones,Madrid,216,221,-5
2008,28160,Valdemorillo,Madrid,75,134,-59
2008,28161,Valdemoro,Madrid,1243,1052,191
2008,28167,Velilla de San Antonio,Madrid,112,120,-8
2008,28176,Villanueva de la Cañada,Madrid,234,203,31
2008,28177,Villanueva del Pardillo,Madrid,198,272,-74
2008,28181,Villaviciosa de Odón,Madrid,315,345,-30
2008,28903,Tres Cantos,Madrid,460,490,-30
2008,29007,Alhaurín de la Torre,Málaga,419,284,135
2008,29008,Alhaurín el Grande,Málaga,146,218,-72
2008,29012,Álora,Málaga,58,85,-27
2008,29015,Antequera,Málaga,405,430,-25
2008,29025,Benalmádena,Málaga,1166,897,269
2008,29038,Cártama,Málaga,203,145,58
2008,29042,Coín,Málaga,182,193,-11
2008,29051,Estepona,Málaga,1786,1574,212
2008,29054,Fuengirola,Málaga,1729,1486,243
2008,29067,Málaga,Málaga,5970,6003,-33
2008,29068,Manilva,Málaga,534,465,69
2008,29069,Marbella,Málaga,2229,2429,-200
2008,29070,Mijas,Málaga,1217,880,337
2008,29075,Nerja,Málaga,295,315,-20
2008,29082,Rincón de la Victoria,Málaga,639,418,221
2008,29084,Ronda,Málaga,604,516,88
2008,29091,Torrox,Málaga,295,264,31
2008,29094,Vélez-Málaga,Málaga,852,834,18
2008,29901,Torremolinos,Málaga,1435,1064,371
2008,30002,Abarán,Murcia,93,119,-26
2008,30003,Águilas,Murcia,723,665,58
2008,30005,Alcantarilla,Murcia,512,487,25
2008,30008,Alhama de Murcia,Murcia,319,249,70
2008,30009,Archena,Murcia,323,398,-75
2008,30010,Beniel,Murcia,276,229,47
2008,30012,Bullas,Murcia,86,99,-13
2008,30013,Calasparra,Murcia,182,136,46
2008,30015,Caravaca de la Cruz,Murcia,391,399,-8
2008,30016,Cartagena,Murcia,2815,2675,140
2008,30017,Cehegín,Murcia,121,155,-34
2008,30019,Cieza (Murcia),Murcia,302,318,-16
2008,30021,Fuente Álamo de Murcia,Murcia,277,334,-57
2008,30022,Jumilla,Murcia,475,377,98
2008,30024,Lorca,Murcia,1522,1708,-186
2008,30026,Mazarrón,Murcia,626,798,-172
2008,30027,Molina de Segura,Murcia,1038,853,185
2008,30029,Mula,Murcia,263,283,-20
2008,30030,Murcia,Murcia,5681,5299,382
2008,30033,Puerto Lumbreras,Murcia,238,242,-4
2008,30035,San Javier,Murcia,851,803,48
2008,30036,San Pedro del Pinatar,Murcia,679,803,-124
2008,30037,Torre-Pacheco,Murcia,465,547,-82
2008,30038,Las Torres de Cotillas,Murcia,238,243,-5
2008,30039,Totana,Murcia,426,436,-10
2008,30041,La Unión,Murcia,200,190,10
2008,30043,Yecla,Murcia,476,657,-181
2008,30901,Santomera,Murcia,240,219,21
2008,30902,Los Alcázares,Murcia,478,574,-96
2008,31016,Ansoáin/Antsoain,Navarra,94,82,12
2008,31060,Burlada/Burlata,Navarra,211,213,-2
2008,31097,Estella-Lizarra,Navarra,218,172,46
2008,31201,Pamplona/Iruña,Navarra,3061,2314,747
2008,31227,Tafalla,Navarra,121,102,19
2008,31232,Tudela,Navarra,912,731,181
2008,31258,Villava/Atarrabia,Navarra,116,53,63
2008,31901,Barañain,Navarra,291,271,20
2008,31907,Zizur Mayor/Zizur Nagusia,Navarra,152,113,39
2008,32009,O Barco de Valdeorras,Ourense,266,307,-41
2008,32019,O Carballiño,Ourense,203,228,-25
2008,32032,Xinzo de Limia,Ourense,131,92,39
2008,32054,Ourense,Ourense,1751,1785,-34
2008,32085,Verín,Ourense,340,303,37
2008,33002,Aller,Asturias,95,64,31
2008,33004,Avilés,Asturias,937,748,189
2008,33011,Cangas del Narcea,Asturias,77,101,-24
2008,33014,Carreño,Asturias,100,85,15
2008,33016,Castrillón,Asturias,204,155,49
2008,33020,Corvera de Asturias,Asturias,177,115,62
2008,33024,Gijón,Asturias,3556,2876,680
2008,33025,Gozón,Asturias,54,53,1
2008,33026,Grado,Asturias,72,45,27
2008,33031,Langreo,Asturias,347,289,58
2008,33032,Laviana,Asturias,102,87,15
2008,33033,Lena,Asturias,140,149,-9
2008,33034,Valdés,Asturias,99,95,4
2008,33035,Llanera,Asturias,138,88,50
2008,33036,Llanes,Asturias,163,143,20
2008,33037,Mieres (Asturias),Asturias,338,314,24
2008,33044,Oviedo,Asturias,3219,2747,472
2008,33060,San Martín del Rey Aurelio,Asturias,131,116,15
2008,33066,Siero,Asturias,527,348,179
2008,33073,Tineo,Asturias,57,46,11
2008,33076,Villaviciosa,Asturias,159,107,52
2008,34120,Palencia,Palencia,1115,1326,-211
2008,35002,Agüimes,Las Palmas,303,299,4
2008,35004,Arrecife,Las Palmas,1259,2287,-1028
2008,35006,Arucas,Las Palmas,153,156,-3
2008,35009,Gáldar,Las Palmas,117,81,36
2008,35011,Ingenio,Las Palmas,203,155,48
2008,35012,Mogán,Las Palmas,286,317,-31
2008,35014,La Oliva,Las Palmas,791,1138,-347
2008,35015,Pájara,Las Palmas,917,1190,-273
2008,35016,Las Palmas de Gran Canaria,Las Palmas,4823,5545,-722
2008,35017,Puerto del Rosario,Las Palmas,918,1938,-1020
2008,35018,San Bartolomé,Las Palmas,387,654,-267
2008,35019,San Bartolomé de Tirajana,Las Palmas,605,741,-136
2008,35021,Santa Brígida,Las Palmas,109,157,-48
2008,35022,Santa Lucía de Tirajana,Las Palmas,811,900,-89
2008,35023,Santa María de Guía de Gran Canaria,Las Palmas,33,70,-37
2008,35024,Teguise,Las Palmas,381,458,-77
2008,35026,Telde,Las Palmas,678,795,-117
2008,35027,Teror,Las Palmas,67,42,25
2008,35028,Tías,Las Palmas,465,671,-206
2008,35030,Tuineje,Las Palmas,290,483,-193
2008,35034,Yaiza,Las Palmas,639,842,-203
2008,36003,Baiona,Pontevedra,137,89,48
2008,36004,Bueu,Pontevedra,90,91,-1
2008,36006,Cambados,Pontevedra,144,102,42
2008,36008,Cangas,Pontevedra,281,224,57
2008,36017,A Estrada,Pontevedra,268,228,40
2008,36021,Gondomar,Pontevedra,97,82,15
2008,36022,O Grove,Pontevedra,109,128,-19
2008,36023,A Guarda,Pontevedra,102,102,0
2008,36024,Lalín,Pontevedra,293,321,-28
2008,36026,Marín,Pontevedra,260,303,-43
2008,36029,Moaña,Pontevedra,167,127,40
2008,36033,Mos,Pontevedra,82,72,10
2008,36035,Nigrán,Pontevedra,166,133,33
2008,36038,Pontevedra,Pontevedra,1124,1088,36
2008,36039,O Porriño,Pontevedra,206,130,76
2008,36041,Poio,Pontevedra,179,161,18
2008,36042,Ponteareas,Pontevedra,279,218,61
2008,36045,Redondela,Pontevedra,173,157,16
2008,36051,Sanxenxo,Pontevedra,181,183,-2
2008,36054,Tomiño,Pontevedra,143,69,74
2008,36055,Tui,Pontevedra,151,147,4
2008,36057,Vigo,Pontevedra,3619,3282,337
2008,36060,Vilagarcía de Arousa,Pontevedra,525,501,24
2008,36061,Vilanova de Arousa,Pontevedra,124,67,57
2008,37046,Béjar,Salamanca,266,330,-64
2008,37107,Ciudad Rodrigo,Salamanca,253,213,40
2008,37274,Salamanca,Salamanca,2517,3029,-512
2008,37294,Santa Marta de Tormes,Salamanca,275,257,18
2008,38001,Adeje,Santa Cruz de Tenerife,1122,1169,-47
2008,38006,Arona,Santa Cruz de Tenerife,1966,2499,-533
2008,38011,Candelaria,Santa Cruz de Tenerife,390,444,-54
2008,38017,Granadilla de Abona,Santa Cruz de Tenerife,952,1243,-291
2008,38019,Guía de Isora,Santa Cruz de Tenerife,257,305,-48
2008,38020,Güímar,Santa Cruz de Tenerife,122,103,19
2008,38022,Icod de los Vinos,Santa Cruz de Tenerife,79,124,-45
2008,38023,San Cristóbal de La Laguna,Santa Cruz de Tenerife,1528,1450,78
2008,38024,Los Llanos de Aridane,Santa Cruz de Tenerife,304,238,66
2008,38026,La Orotava,Santa Cruz de Tenerife,197,232,-35
2008,38028,Puerto de la Cruz,Santa Cruz de Tenerife,584,590,-6
2008,38031,Los Realejos,Santa Cruz de Tenerife,183,164,19
2008,38032,El Rosario,Santa Cruz de Tenerife,166,208,-42
2008,38035,San Miguel de Abona,Santa Cruz de Tenerife,210,258,-48
2008,38037,Santa Cruz de la Palma,Santa Cruz de Tenerife,329,386,-57
2008,38038,Santa Cruz de Tenerife,Santa Cruz de Tenerife,2719,2956,-237
2008,38039,Santa Úrsula,Santa Cruz de Tenerife,118,112,6
2008,38040,Santiago del Teide,Santa Cruz de Tenerife,127,124,3
2008,38043,Tacoronte,Santa Cruz de Tenerife,112,116,-4
2008,38046,Tegueste,Santa Cruz de Tenerife,40,59,-19
2008,39008,El Astillero,Cantabria,175,148,27
2008,39016,Camargo,Cantabria,257,285,-28
2008,39020,Castro-Urdiales,Cantabria,1775,1357,418
2008,39025,Los Corrales de Buelna,Cantabria,87,68,19
2008,39035,Laredo,Cantabria,206,211,-5
2008,39052,Piélagos,Cantabria,306,232,74
2008,39059,Reinosa,Cantabria,110,115,-5
2008,39073,Santa Cruz de Bezana,Cantabria,118,95,23
2008,39075,Santander,Cantabria,2237,2333,-96
2008,39079,Santoña,Cantabria,188,259,-71
2008,39087,Torrelavega,Cantabria,599,571,28
2008,40194,Segovia,Segovia,793,1325,-532
2008,41004,Alcalá de Guadaíra,Sevilla,620,423,197
2008,41005,Alcalá del Río,Sevilla,138,55,83
2008,41007,La Algaba,Sevilla,104,76,28
2008,41011,Arahal,Sevilla,84,71,13
2008,41017,Bormujos,Sevilla,338,187,151
2008,41018,Brenes,Sevilla,126,92,34
2008,41020,Las Cabezas de San Juan,Sevilla,140,119,21
2008,41021,Camas,Sevilla,290,225,65
2008,41023,Cantillana,Sevilla,92,50,42
2008,41024,Carmona,Sevilla,260,180,80
2008,41029,Castilleja de la Cuesta,Sevilla,204,148,56
2008,41034,Coria del Río,Sevilla,298,212,86
2008,41038,Dos Hermanas,Sevilla,1241,870,371
2008,41039,Écija,Sevilla,407,409,-2
2008,41040,Espartinas,Sevilla,212,102,110
2008,41041,Estepa,Sevilla,143,114,29
2008,41047,Gines,Sevilla,142,105,37
2008,41049,Guillena,Sevilla,123,68,55
2008,41053,Lebrija,Sevilla,265,218,47
2008,41055,Lora del Río,Sevilla,167,171,-4
2008,41058,Mairena del Alcor,Sevilla,222,145,77
2008,41059,Mairena del Aljarafe,Sevilla,594,402,192
2008,41060,Marchena,Sevilla,140,126,14
2008,41065,Morón de la Frontera,Sevilla,280,202,78
2008,41068,Osuna,Sevilla,169,165,4
2008,41069,Los Palacios y Villafranca,Sevilla,190,167,23
2008,41075,Pilas,Sevilla,186,78,108
2008,41077,La Puebla de Cazalla,Sevilla,114,103,11
2008,41079,La Puebla del Río,Sevilla,142,97,45
2008,41081,La Rinconada,Sevilla,296,192,104
2008,41086,San Juan de Aznalfarache,Sevilla,447,310,137
2008,41087,Sanlúcar la Mayor,Sevilla,171,103,68
2008,41091,Sevilla,Sevilla,7952,7086,866
2008,41093,Tomares,Sevilla,326,251,75
2008,41095,Utrera,Sevilla,468,354,114
2008,41102,El Viso del Alcor,Sevilla,114,79,35
2008,42173,Soria,Soria,770,902,-132
2008,43004,Alcanar,Tarragona,202,250,-48
2008,43014,Amposta,Tarragona,417,362,55
2008,43037,Calafell,Tarragona,1548,1180,368
2008,43038,Cambrils,Tarragona,809,748,61
2008,43051,Cunit,Tarragona,1069,768,301
2008,43092,Mont-roig del Camp,Tarragona,555,319,236
2008,43123,Reus,Tarragona,1281,1927,-646
2008,43136,Sant Carles de la Ràpita,Tarragona,408,428,-20
2008,43148,Tarragona,Tarragona,3015,2912,103
2008,43153,Torredembarra,Tarragona,439,470,-31
2008,43155,Tortosa,Tarragona,361,987,-626
2008,43161,Valls,Tarragona,472,433,39
2008,43163,El Vendrell,Tarragona,1557,1293,264
2008,43171,Vila-seca,Tarragona,554,566,-12
2008,43901,Deltebre,Tarragona,149,112,37
2008,43905,Salou,Tarragona,967,1056,-89
2008,44013,Alcañiz,Teruel,269,362,-93
2008,44216,Teruel,Teruel,591,801,-210
2008,45053,Consuegra,Toledo,101,148,-47
2008,45066,Fuensalida,Toledo,451,342,109
2008,45081,Illescas,Toledo,2096,750,1346
2008,45087,Madridejos,Toledo,122,168,-46
2008,45106,Mora,Toledo,155,181,-26
2008,45142,Quintanar de la Orden,Toledo,311,242,69
2008,45161,Seseña,Toledo,2752,954,1798
2008,45163,Sonseca,Toledo,151,181,-30
2008,45165,Talavera de la Reina,Toledo,1658,1730,-72
2008,45168,Toledo,Toledo,1816,1663,153
2008,45173,Torrijos,Toledo,291,272,19
2008,45185,Villacañas,Toledo,142,175,-33
2008,46005,Alaquàs,Valencia,279,261,18
2008,46007,Albal,Valencia,172,134,38
2008,46011,Alberic,Valencia,146,167,-21
2008,46013,Alboraya,Valencia,289,248,41
2008,46017,Alzira,Valencia,489,399,90
2008,46019,L'Alcúdia,Valencia,79,70,9
2008,46021,Aldaia,Valencia,286,239,47
2008,46022,Alfafar,Valencia,231,251,-20
2008,46029,Algemesí,Valencia,274,220,54
2008,46031,Alginet,Valencia,104,105,-1
2008,46051,Benaguasil,Valencia,141,82,59
2008,46054,Benetússer,Valencia,177,156,21
2008,46060,Benifaió,Valencia,73,75,-2
2008,46070,Bétera,Valencia,229,196,33
2008,46078,Burjassot,Valencia,393,362,31
2008,46081,Canals,Valencia,43,116,-73
2008,46083,Carcaixent,Valencia,154,167,-13
2008,46085,Carlet,Valencia,92,82,10
2008,46094,Catarroja,Valencia,313,316,-3
2008,46102,Quart de Poblet,Valencia,298,300,-2
2008,46105,Cullera,Valencia,273,304,-31
2008,46110,Xirivella,Valencia,447,432,15
2008,46111,Chiva,Valencia,178,157,21
2008,46116,L'Eliana,Valencia,136,143,-7
2008,46131,Gandia,Valencia,1690,1834,-144
2008,46135,Godella,Valencia,105,92,13
2008,46145,Xátiva,Valencia,243,288,-45
2008,46147,Llíria,Valencia,271,253,18
2008,46159,Manises,Valencia,346,437,-91
2008,46164,Massamagrell,Valencia,151,111,40
2008,46166,Meliana,Valencia,101,74,27
2008,46169,Mislata,Valencia,587,570,17
2008,46171,Moncada,Valencia,167,128,39
2008,46181,Oliva,Valencia,485,532,-47
2008,46184,Ontinyent,Valencia,353,422,-69
2008,46186,Paiporta,Valencia,228,229,-1
2008,46190,Paterna,Valencia,881,701,180
2008,46193,Picanya,Valencia,116,88,28
2008,46194,Picassent,Valencia,183,150,33
2008,46202,La Pobla de Vallbona,Valencia,273,202,71
2008,46205,Puçol,Valencia,233,235,-2
2008,46213,Requena,Valencia,225,200,25
2008,46214,Riba-roja de Túria,Valencia,227,208,19
2008,46220,Sagunto/Sagunt,Valencia,1143,1121,22
2008,46230,Silla,Valencia,203,202,1
2008,46235,Sueca,Valencia,224,221,3
2008,46238,Tavernes de la Valldigna,Valencia,149,163,-14
2008,46244,Torrent (Valencia),Valencia,987,855,132
2008,46249,Utiel,Valencia,91,107,-16
2008,46250,València,Valencia,13166,12477,689
2008,47010,Arroyo de la Encomienda,Valladolid,232,155,77
2008,47076,Laguna de Duero,Valladolid,250,252,-2
2008,47085,Medina del Campo,Valladolid,321,280,41
2008,47186,Valladolid,Valladolid,4366,4587,-221
2008,48003,Amorebieta-Etxano,Vizcaya,100,131,-31
2008,48011,Arrigorriaga,Vizcaya,97,113,-16
2008,48013,Barakaldo,Vizcaya,1067,1108,-41
2008,48015,Basauri,Vizcaya,325,433,-108
2008,48017,Bermeo,Vizcaya,142,109,33
2008,48020,Bilbao,Vizcaya,4693,4533,160
2008,48027,Durango,Vizcaya,331,276,55
2008,48034,Ermua,Vizcaya,267,302,-35
2008,48036,Galdakao,Vizcaya,151,244,-93
2008,48044,Getxo,Vizcaya,830,910,-80
2008,48046,Gernika-Lumo,Vizcaya,113,104,9
2008,48054,Leioa,Vizcaya,260,272,-12
2008,48069,Mungia,Vizcaya,131,126,5
2008,48078,Portugalete,Vizcaya,361,423,-62
2008,48080,Valle de Trápaga-Trapagaran,Vizcaya,94,134,-40
2008,48082,Santurtzi,Vizcaya,457,565,-108
2008,48084,Sestao,Vizcaya,257,327,-70
2008,48085,Sopela,Vizcaya,104,114,-10
2008,48902,Erandio,Vizcaya,215,219,-4
2008,49021,Benavente,Zamora,420,518,-98
2008,49275,Zamora,Zamora,862,1236,-374
2008,50067,Calatayud,Zaragoza,283,308,-25
2008,50095,Ejea de los Caballeros,Zaragoza,171,199,-28
2008,50251,Tarazona,Zaragoza,220,186,34
2008,50272,Utebo,Zaragoza,305,245,60
2008,50297,Zaragoza,Zaragoza,9109,8592,517
2008,51001,Ceuta,Ceuta,2527,2356,171
2008,52001,Melilla,Melilla,2789,2431,358
2009,01002,Amurrio,Álava,171,173,-2
2009,01036,Laudio/Llodio,Álava,374,317,57
2009,01059,Vitoria-Gasteiz,Álava,4350,3544,806
2009,02003,Albacete,Albacete,2854,2701,153
2009,02009,Almansa,Albacete,414,473,-59
2009,02025,Caudete,Albacete,269,234,35
2009,02037,Hellín,Albacete,693,614,79
2009,02069,La Roda,Albacete,300,227,73
2009,02081,Villarrobledo,Albacete,434,478,-44
2009,03005,Albatera,Alicante,116,92,24
2009,03009,Alcoy/Alcoi,Alicante,554,664,-110
2009,03011,L'Alfàs del Pi,Alicante,251,282,-31
2009,03014,Alicante/Alacant,Alicante,5328,5914,-586
2009,03015,Almoradí,Alicante,313,356,-43
2009,03018,Altea,Alicante,365,400,-35
2009,03019,Aspe,Alicante,207,173,34
2009,03031,Benidorm,Alicante,1938,2132,-194
2009,03041,Benissa,Alicante,108,147,-39
2009,03047,Calp,Alicante,447,528,-81
2009,03049,Callosa de Segura,Alicante,170,192,-22
2009,03050,El Campello,Alicante,390,426,-36
2009,03053,Castalla,Alicante,74,71,3
2009,03056,Cocentaina,Alicante,124,142,-18
2009,03059,Crevillent,Alicante,307,325,-18
2009,03063,Dénia,Alicante,892,915,-23
2009,03065,Elche/Elx,Alicante,2381,2881,-500
2009,03066,Elda,Alicante,484,700,-216
2009,03076,Guardamar del Segura,Alicante,310,306,4
2009,03079,Ibi,Alicante,190,271,-81
2009,03082,Jávea/Xàbia,Alicante,462,480,-18
2009,03089,Monóvar/Monòver,Alicante,89,136,-47
2009,03090,Mutxamel,Alicante,233,232,1
2009,03093,Novelda,Alicante,176,241,-65
2009,03094,La Nucia,Alicante,240,287,-47
2009,03099,Orihuela,Alicante,1148,1305,-157
2009,03102,Pego,Alicante,154,148,6
2009,03104,Petrer,Alicante,189,275,-86
2009,03113,Rojales,Alicante,130,162,-32
2009,03118,San Fulgencio,Alicante,87,79,8
2009,03119,Sant Joan d'Alacant,Alicante,324,303,21
2009,03121,Santa Pola,Alicante,659,600,59
2009,03122,San Vicente del Raspeig/Sant Vicent del Raspeig,Alicante,554,621,-67
2009,03123,Sax,Alicante,80,88,-8
2009,03128,Teulada,Alicante,165,157,8
2009,03133,Torrevieja,Alicante,3045,3668,-623
2009,03139,Villajoyosa/La Vila Joiosa,Alicante,631,670,-39
2009,03140,Villena,Alicante,370,502,-132
2009,03902,Pilar de la Horadada,Alicante,795,730,65
2009,04003,Adra,Almería,243,274,-31
2009,04006,Albox,Almería,111,237,-126
2009,04013,Almería,Almería,2328,2381,-53
2009,04029,Berja,Almería,152,129,23
2009,04035,Cuevas del Almanzora,Almería,167,284,-117
2009,04052,Huércal de Almería,Almería,171,100,71
2009,04053,Huércal-Overa,Almería,262,347,-85
2009,04066,Níjar,Almería,648,484,164
2009,04079,Roquetas de Mar,Almería,2251,1892,359
2009,04100,Vera,Almería,421,417,4
2009,04102,Vícar,Almería,446,395,51
2009,04902,El Ejido,Almería,1641,1590,51
2009,05019,Ávila,Ávila,1064,1257,-193
2009,06011,Almendralejo,Badajoz,548,502,46
2009,06015,Badajoz,Badajoz,2017,1844,173
2009,06044,Don Benito,Badajoz,661,487,174
2009,06070,Jerez de los Caballeros,Badajoz,96,70,26
2009,06083,Mérida,Badajoz,1029,953,76
2009,06088,Montijo,Badajoz,248,209,39
2009,06095,Olivenza,Badajoz,136,158,-22
2009,06149,Villafranca de los Barros,Badajoz,147,110,37
2009,06153,Villanueva de la Serena,Badajoz,410,315,95
2009,06158,Zafra,Badajoz,244,210,34
2009,07003,Alcúdia,Baleares,500,530,-30
2009,07005,Andratx,Baleares,115,133,-18
2009,07011,Calvià,Baleares,987,885,102
2009,07014,Capdepera,Baleares,297,295,2
2009,07015,Ciutadella de Menorca,Baleares,988,1019,-31
2009,07022,Felanitx,Baleares,210,227,-17
2009,07026,Eivissa,Baleares,2136,1881,255
2009,07027,Inca,Baleares,332,449,-117
2009,07031,Llucmajor,Baleares,665,649,16
2009,07032,Maó-Mahón,Baleares,942,1087,-145
2009,07033,Manacor,Baleares,643,777,-134
2009,07036,Marratxí,Baleares,248,237,11
2009,07040,Palma,Baleares,7444,7989,-545
2009,07042,Pollença,Baleares,260,207,53
2009,07044,Sa Pobla,Baleares,129,145,-16
2009,07046,Sant Antoni de Portmany,Baleares,662,739,-77
2009,07048,Sant Josep de sa Talaia,Baleares,1013,859,154
2009,07054,Santa Eulària des Riu,Baleares,1384,992,392
2009,07055,Santa Margalida,Baleares,276,342,-66
2009,07057,Santanyí,Baleares,265,293,-28
2009,07061,Sóller,Baleares,173,161,12
2009,07062,Son Servera,Baleares,257,317,-60
2009,08001,Abrera,Barcelona,83,109,-26
2009,08006,Arenys de Mar,Barcelona,144,170,-26
2009,08009,Argentona,Barcelona,49,63,-14
2009,08015,Badalona,Barcelona,2477,2451,26
2009,08019,Barcelona,Barcelona,23300,21352,1948
2009,08022,Berga,Barcelona,144,133,11
2009,08033,Caldes de Montbui,Barcelona,122,143,-21
2009,08035,Calella,Barcelona,262,277,-15
2009,08040,Canet de Mar,Barcelona,122,111,11
2009,08041,Canovelles,Barcelona,161,236,-75
2009,08046,Cardedeu,Barcelona,144,147,-3
2009,08051,Castellar del Vallès,Barcelona,114,207,-93
2009,08054,Castellbisbal,Barcelona,115,110,5
2009,08056,Castelldefels,Barcelona,899,984,-85
2009,08072,Corbera de Llobregat,Barcelona,110,149,-39
2009,08073,Cornellà de Llobregat,Barcelona,874,921,-47
2009,08074,Cubelles,Barcelona,268,398,-130
2009,08076,Esparreguera,Barcelona,148,210,-62
2009,08077,Esplugues de Llobregat,Barcelona,454,493,-39
2009,08086,Les Franqueses del Vallès,Barcelona,141,176,-35
2009,08088,La Garriga,Barcelona,126,128,-2
2009,08089,Gavà,Barcelona,559,578,-19
2009,08096,Granollers,Barcelona,641,788,-147
2009,08101,L'Hospitalet de Llobregat,Barcelona,3492,3392,100
2009,08102,Igualada,Barcelona,404,486,-82
2009,08105,La Llagosta,Barcelona,136,174,-38
2009,08107,Lliçà d'Amunt,Barcelona,103,104,-1
2009,08110,Malgrat de Mar,Barcelona,321,306,15
2009,08112,Manlleu,Barcelona,141,237,-96
2009,08113,Manresa,Barcelona,732,851,-119
2009,08114,Martorell,Barcelona,270,351,-81
2009,08118,El Masnou,Barcelona,179,213,-34
2009,08121,Mataró,Barcelona,1360,1361,-1
2009,08123,Molins de Rei,Barcelona,168,181,-13
2009,08124,Mollet del Vallès,Barcelona,493,607,-114
2009,08125,Montcada i Reixac,Barcelona,340,387,-47
2009,08126,Montgat,Barcelona,69,75,-6
2009,08136,Montornès del Vallès,Barcelona,185,247,-62
2009,08147,Olesa de Montserrat,Barcelona,194,217,-23
2009,08156,Palau-solità i Plegamans,Barcelona,79,105,-26
2009,08157,Pallejà,Barcelona,97,114,-17
2009,08159,Parets del Vallès,Barcelona,126,178,-52
2009,08161,Piera,Barcelona,138,130,8
2009,08163,Pineda de Mar,Barcelona,277,393,-116
2009,08169,El Prat de Llobregat,Barcelona,645,691,-46
2009,08172,Premià de Mar,Barcelona,257,281,-24
2009,08180,Ripollet,Barcelona,362,395,-33
2009,08181,La Roca del Vallès,Barcelona,65,76,-11
2009,08184,Rubí,Barcelona,756,840,-84
2009,08187,Sabadell,Barcelona,2191,2186,5
2009,08194,Sant Adrià de Besòs,Barcelona,372,420,-48
2009,08196,Sant Andreu de la Barca,Barcelona,277,372,-95
2009,08197,Sant Andreu de Llavaneres,Barcelona,73,88,-15
2009,08200,Sant Boi de Llobregat,Barcelona,906,925,-19
2009,08202,Sant Celoni,Barcelona,225,291,-66
2009,08205,Sant Cugat del Vallès,Barcelona,837,774,63
2009,08211,Sant Feliu de Llobregat,Barcelona,330,404,-74
2009,08217,Sant Joan Despí,Barcelona,260,289,-29
2009,08218,Sant Joan de Vilatorrada,Barcelona,45,67,-22
2009,08219,Vilassar de Mar,Barcelona,165,148,17
2009,08221,Sant Just Desvern,Barcelona,154,150,4
2009,08231,Sant Pere de Ribes,Barcelona,308,350,-42
2009,08238,Sant Quirze del Vallès,Barcelona,135,147,-12
2009,08240,Sant Sadurní d'Anoia,Barcelona,87,105,-18
2009,08245,Santa Coloma de Gramenet,Barcelona,1486,1759,-273
2009,08252,Barberà del Vallès,Barcelona,296,265,31
2009,08260,Santa Perpètua de Mogoda,Barcelona,268,281,-13
2009,08263,Sant Vicenç dels Horts,Barcelona,238,315,-77
2009,08266,Cerdanyola del Vallès,Barcelona,462,577,-115
2009,08270,Sitges,Barcelona,300,363,-63
2009,08279,Terrassa,Barcelona,2281,2360,-79
2009,08284,Tordera,Barcelona,442,394,48
2009,08285,Torelló,Barcelona,126,120,6
2009,08295,Vallirana,Barcelona,103,131,-28
2009,08298,Vic,Barcelona,486,494,-8
2009,08301,Viladecans,Barcelona,653,751,-98
2009,08302,Vilanova del Camí,Barcelona,83,134,-51
2009,08305,Vilafranca del Penedès,Barcelona,465,559,-94
2009,08307,Vilanova i la Geltrú,Barcelona,909,977,-68
2009,08904,Badia del Vallès,Barcelona,148,113,35
2009,09018,Aranda de Duero,Burgos,641,701,-60
2009,09059,Burgos,Burgos,2238,2648,-410
2009,09219,Miranda de Ebro,Burgos,739,992,-253
2009,10037,Cáceres,Cáceres,1485,1350,135
2009,10067,Coria,Cáceres,186,164,22
2009,10121,Miajadas,Cáceres,187,191,-4
2009,10131,Navalmoral de la Mata,Cáceres,347,363,-16
2009,10148,Plasencia,Cáceres,592,624,-32
2009,11004,Algeciras,Cádiz,1762,2055,-293
2009,11006,Arcos de la Frontera,Cádiz,335,306,29
2009,11007,Barbate,Cádiz,251,228,23
2009,11008,Los Barrios,Cádiz,243,323,-80
2009,11012,Cádiz,Cádiz,1126,1342,-216
2009,11014,Conil de la Frontera,Cádiz,262,214,48
2009,11015,Chiclana de la Frontera,Cádiz,898,830,68
2009,11016,Chipiona,Cádiz,233,217,16
2009,11020,Jerez de la Frontera,Cádiz,2366,2392,-26
2009,11021,Jimena de la Frontera,Cádiz,138,172,-34
2009,11022,La Línea de la Concepción,Cádiz,648,778,-130
2009,11023,Medina-Sidonia,Cádiz,64,64,0
2009,11027,El Puerto de Santa María,Cádiz,1275,1329,-54
2009,11028,Puerto Real,Cádiz,419,397,22
2009,11030,Rota,Cádiz,586,474,112
2009,11031,San Fernando,Cádiz,956,1052,-96
2009,11032,Sanlúcar de Barrameda,Cádiz,493,450,43
2009,11033,San Roque,Cádiz,538,579,-41
2009,11035,Tarifa,Cádiz,228,279,-51
2009,11038,Ubrique,Cádiz,148,204,-56
2009,11039,Vejer de la Frontera,Cádiz,85,91,-6
2009,11041,Villamartín,Cádiz,163,117,46
2009,12005,L'Alcora,Castellón,102,198,-96
2009,12009,Almassora,Castellón,296,337,-41
2009,12027,Benicarló,Castellón,604,638,-34
2009,12028,Benicasim/Benicàssim,Castellón,308,337,-29
2009,12032,Borriana/Burriana,Castellón,484,555,-71
2009,12040,Castellón de la Plana/Castelló de la Plana,Castellón,2516,2935,-419
2009,12082,Nules,Castellón,173,179,-6
2009,12084,Onda,Castellón,300,421,-121
2009,12085,Oropesa del Mar/Orpesa,Castellón,454,650,-196
2009,12126,La Vall d'Uixó,Castellón,361,417,-56
2009,12135,Vila-real,Castellón,535,761,-226
2009,12138,Vinaròs,Castellón,747,737,10
2009,13005,Alcázar de San Juan,Ciudad Real,729,676,53
2009,13023,Bolaños de Calatrava,Ciudad Real,115,107,8
2009,13028,Campo de Criptana,Ciudad Real,161,187,-26
2009,13034,Ciudad Real,Ciudad Real,1187,1250,-63
2009,13039,Daimiel,Ciudad Real,191,189,2
2009,13053,Manzanares,Ciudad Real,310,338,-28
2009,13056,Miguelturra,Ciudad Real,182,170,12
2009,13071,Puertollano,Ciudad Real,1116,958,158
2009,13078,Socuéllamos,Ciudad Real,251,260,-9
2009,13079,La Solana,Ciudad Real,149,186,-37
2009,13082,Tomelloso,Ciudad Real,608,615,-7
2009,13087,Valdepeñas,Ciudad Real,596,625,-29
2009,13096,Villarrubia de los Ojos,Ciudad Real,83,116,-33
2009,14002,Aguilar de la Frontera,Córdoba,60,104,-44
2009,14007,Baena,Córdoba,199,321,-122
2009,14013,Cabra,Córdoba,208,241,-33
2009,14017,La Carlota,Córdoba,185,161,24
2009,14021,Córdoba,Córdoba,3363,4131,-768
2009,14030,Fuente Palmera,Córdoba,137,144,-7
2009,14038,Lucena,Córdoba,487,660,-173
2009,14042,Montilla,Córdoba,205,201,4
2009,14049,Palma del Río,Córdoba,401,369,32
2009,14052,Peñarroya-Pueblonuevo,Córdoba,202,215,-13
2009,14054,Pozoblanco,Córdoba,200,187,13
2009,14055,Priego de Córdoba,Córdoba,307,337,-30
2009,14056,Puente Genil,Córdoba,447,433,14
2009,14058,Rute,Córdoba,109,135,-26
2009,15002,Ames,A Coruña,654,361,293
2009,15005,Arteixo,A Coruña,375,304,71
2009,15009,Betanzos,A Coruña,137,96,41
2009,15011,Boiro,A Coruña,209,152,57
2009,15017,Cambre,A Coruña,222,198,24
2009,15019,Carballo,A Coruña,259,188,71
2009,15030,A Coruña,A Coruña,3391,2947,444
2009,15031,Culleredo,A Coruña,384,298,86
2009,15035,Fene,A Coruña,101,72,29
2009,15036,Ferrol,A Coruña,1050,971,79
2009,15041,A Laracha,A Coruña,53,39,14
2009,15054,Narón,A Coruña,396,338,58
2009,15057,Noia,A Coruña,175,118,57
2009,15058,Oleiros,A Coruña,332,368,-36
2009,15059,Ordes,A Coruña,117,78,39
2009,15070,As Pontes de García Rodríguez,A Coruña,131,127,4
2009,15072,Rianxo,A Coruña,126,94,32
2009,15073,Ribeira,A Coruña,299,243,56
2009,15075,Sada (A Coruña),A Coruña,205,174,31
2009,15077,Santa Comba,A Coruña,62,26,36
2009,15078,Santiago de Compostela,A Coruña,1622,1207,415
2009,15082,Teo,A Coruña,239,179,60
2009,16078,Cuenca,Cuenca,1064,1241,-177
2009,16203,Tarancón,Cuenca,420,521,-101
2009,17015,Banyoles,Girona,231,200,31
2009,17022,La Bisbal d'Empordà,Girona,145,142,3
2009,17023,Blanes,Girona,1326,1368,-42
2009,17034,Calonge i Sant Antoni,Girona,271,250,21
2009,17047,Castelló d'Empúries,Girona,226,195,31
2009,17048,Castell-Platja d'Aro,Girona,289,345,-56
2009,17062,L'Escala,Girona,250,243,7
2009,17066,Figueres,Girona,694,801,-107
2009,17079,Girona,Girona,1741,1978,-237
2009,17095,Lloret de Mar,Girona,1215,1536,-321
2009,17114,Olot,Girona,448,701,-253
2009,17117,Palafrugell,Girona,341,443,-102
2009,17118,Palamós,Girona,327,345,-18
2009,17147,Ripoll,Girona,171,237,-66
2009,17152,Roses,Girona,389,407,-18
2009,17155,Salt,Girona,643,674,-31
2009,17160,Sant Feliu de Guíxols,Girona,345,427,-82
2009,17180,Santa Coloma de Farners,Girona,212,160,52
2009,17199,Torroella de Montgrí,Girona,238,202,36
2009,18003,Albolote,Granada,190,178,12
2009,18017,Almuñécar,Granada,407,499,-92
2009,18021,Armilla,Granada,519,420,99
2009,18022,Atarfe,Granada,287,208,79
2009,18023,Baza,Granada,424,420,4
2009,18062,Churriana de la Vega,Granada,217,175,42
2009,18087,Granada,Granada,4105,4282,-177
2009,18089,Guadix,Granada,325,336,-11
2009,18101,Huétor Vega,Granada,112,106,6
2009,18102,Illora,Granada,110,95,15
2009,18122,Loja,Granada,257,258,-1
2009,18127,Maracena,Granada,260,278,-18
2009,18140,Motril,Granada,593,757,-164
2009,18145,Ogíjares,Granada,142,137,5
2009,18153,Peligros,Granada,119,114,5
2009,18158,Pinos Puente,Granada,128,125,3
2009,18173,Salobreña,Granada,173,187,-14
2009,18175,Santa Fe,Granada,203,206,-3
2009,18193,La Zubia,Granada,271,221,50
2009,18905,Las Gabias,Granada,363,288,75
2009,19024,Alovera,Guadalajara,650,388,262
2009,19046,Azuqueca de Henares,Guadalajara,2038,1500,538
2009,19071,El Casar,Guadalajara,772,410,362
2009,19130,Guadalajara,Guadalajara,2032,1986,46
2009,20009,Andoain,Guipúzcoa,85,131,-46
2009,20017,Azkoitia,Guipúzcoa,93,91,2
2009,20018,Azpeitia,Guipúzcoa,83,111,-28
2009,20019,Beasain,Guipúzcoa,132,133,-1
2009,20030,Eibar,Guipúzcoa,414,400,14
2009,20032,Elgoibar,Guipúzcoa,139,101,38
2009,20036,Hondarribia,Guipúzcoa,122,143,-21
2009,20040,Hernani,Guipúzcoa,125,144,-19
2009,20045,Irun,Guipúzcoa,772,738,34
2009,20055,Arrasate/Mondragón,Guipúzcoa,222,314,-92
2009,20059,Oñati,Guipúzcoa,64,79,-15
2009,20064,Pasaia,Guipúzcoa,151,141,10
2009,20067,Errenteria,Guipúzcoa,334,272,62
2009,20069,Donostia/San Sebastián,Guipúzcoa,2008,2074,-66
2009,20071,Tolosa,Guipúzcoa,110,107,3
2009,20074,Bergara,Guipúzcoa,122,150,-28
2009,20079,Zarautz,Guipúzcoa,245,245,0
2009,20080,Zumarraga,Guipúzcoa,90,91,-1
2009,20902,Lasarte-Oria,Guipúzcoa,182,179,3
2009,21002,Aljaraque,Huelva,180,217,-37
2009,21005,Almonte,Huelva,257,252,5
2009,21010,Ayamonte,Huelva,308,270,38
2009,21013,Bollullos Par del Condado,Huelva,113,117,-4
2009,21021,Cartaya,Huelva,298,251,47
2009,21035,Gibraleón,Huelva,93,101,-8
2009,21041,Huelva,Huelva,1602,1681,-79
2009,21042,Isla Cristina,Huelva,395,301,94
2009,21044,Lepe,Huelva,505,396,109
2009,21050,Moguer,Huelva,334,288,46
2009,21054,La Palma del Condado,Huelva,97,117,-20
2009,21060,Punta Umbría,Huelva,180,210,-30
2009,21072,Valverde del Camino,Huelva,67,107,-40
2009,22048,Barbastro,Huesca,296,291,5
2009,22112,Fraga,Huesca,368,361,7
2009,22125,Huesca,Huesca,955,946,9
2009,22130,Jaca,Huesca,404,392,12
2009,22158,Monzón,Huesca,328,351,-23
2009,22199,Sabiñánigo,Huesca,179,245,-66
2009,23002,Alcalá la Real,Jaén,352,401,-49
2009,23003,Alcaudete,Jaén,160,151,9
2009,23005,Andújar,Jaén,527,604,-77
2009,23009,Baeza,Jaén,202,193,9
2009,23010,Bailén,Jaén,177,223,-46
2009,23024,La Carolina,Jaén,240,266,-26
2009,23050,Jaén,Jaén,1054,1468,-414
2009,23053,Jódar,Jaén,102,116,-14
2009,23055,Linares,Jaén,773,1016,-243
2009,23058,Mancha Real,Jaén,109,109,0
2009,23060,Martos,Jaén,232,240,-8
2009,23086,Torredelcampo,Jaén,86,115,-29
2009,23087,Torredonjimeno,Jaén,109,179,-70
2009,23092,Úbeda,Jaén,524,580,-56
2009,23095,Villacarrillo,Jaén,175,168,7
2009,24008,Astorga,León,203,228,-25
2009,24010,La Bañeza,León,179,181,-2
2009,24014,Bembibre,León,193,172,21
2009,24089,León,León,2082,2404,-322
2009,24115,Ponferrada,León,1098,1110,-12
2009,24142,San Andrés del Rabanedo,León,470,378,92
2009,24202,Villablino,León,128,166,-38
2009,24222,Villaquilambre,León,293,243,50
2009,25040,Balaguer,Lleida,275,302,-27
2009,25120,Lleida,Lleida,2776,3016,-240
2009,25137,Mollerussa,Lleida,317,309,8
2009,25203,La Seu d'Urgell,Lleida,332,353,-21
2009,25217,Tàrrega,Lleida,366,425,-59
2009,26018,Arnedo,La Rioja,138,192,-54
2009,26036,Calahorra,La Rioja,505,671,-166
2009,26071,Haro,La Rioja,335,326,9
2009,26089,Logroño,La Rioja,2577,2816,-239
2009,27028,Lugo,Lugo,1620,1437,183
2009,27031,Monforte de Lemos,Lugo,375,348,27
2009,27057,Sarria,Lugo,217,142,75
2009,27065,Vilalba,Lugo,173,168,5
2009,27066,Viveiro,Lugo,240,293,-53
2009,28005,Alcalá de Henares,Madrid,3441,4375,-934
2009,28006,Alcobendas,Madrid,1304,1356,-52
2009,28007,Alcorcón,Madrid,1765,2153,-388
2009,28009,Algete,Madrid,250,264,-14
2009,28010,Alpedrete,Madrid,141,166,-25
2009,28013,Aranjuez,Madrid,1257,1314,-57
2009,28014,Arganda del Rey,Madrid,740,638,102
2009,28015,Arroyomolinos (Madrid),Madrid,234,170,64
2009,28022,Boadilla del Monte,Madrid,492,464,28
2009,28040,Ciempozuelos,Madrid,382,418,-36
2009,28045,Colmenar Viejo,Madrid,535,427,108
2009,28047,Collado Villalba,Madrid,785,811,-26
2009,28049,Coslada,Madrid,811,947,-136
2009,28054,El Escorial,Madrid,154,166,-12
2009,28058,Fuenlabrada,Madrid,2609,3770,-1161
2009,28061,Galapagar,Madrid,377,421,-44
2009,28065,Getafe,Madrid,2199,2496,-297
2009,28068,Guadarrama,Madrid,206,193,13
2009,28073,Humanes de Madrid,Madrid,359,431,-72
2009,28074,Leganés,Madrid,2203,2696,-493
2009,28079,Madrid,Madrid,50797,48469,2328
2009,28080,Majadahonda,Madrid,847,776,71
2009,28083,Meco,Madrid,230,288,-58
2009,28084,Mejorada del Campo,Madrid,248,254,-6
2009,28090,Moralzarzal,Madrid,102,115,-13
2009,28092,Móstoles,Madrid,2657,3305,-648
2009,28096,Navalcarnero,Madrid,433,382,51
2009,28104,Paracuellos de Jarama,Madrid,317,155,162
2009,28106,Parla,Madrid,2296,2644,-348
2009,28113,Pinto,Madrid,635,705,-70
2009,28115,Pozuelo de Alarcón,Madrid,907,741,166
2009,28123,Rivas-Vaciamadrid,Madrid,671,589,82
2009,28127,Las Rozas de Madrid,Madrid,1137,1016,121
2009,28129,San Agustín del Guadalix,Madrid,212,132,80
2009,28130,San Fernando de Henares,Madrid,350,405,-55
2009,28131,San Lorenzo de El Escorial,Madrid,263,260,3
2009,28132,San Martín de la Vega,Madrid,267,261,6
2009,28134,San Sebastián de los Reyes,Madrid,1074,976,98
2009,28148,Torrejón de Ardoz,Madrid,1292,1838,-546
2009,28152,Torrelodones,Madrid,208,201,7
2009,28160,Valdemorillo,Madrid,90,159,-69
2009,28161,Valdemoro,Madrid,1194,1153,41
2009,28167,Velilla de San Antonio,Madrid,109,143,-34
2009,28176,Villanueva de la Cañada,Madrid,242,245,-3
2009,28177,Villanueva del Pardillo,Madrid,230,173,57
2009,28181,Villaviciosa de Odón,Madrid,329,290,39
2009,28903,Tres Cantos,Madrid,452,427,25
2009,29007,Alhaurín de la Torre,Málaga,349,289,60
2009,29008,Alhaurín el Grande,Málaga,159,149,10
2009,29012,Álora,Málaga,78,90,-12
2009,29015,Antequera,Málaga,414,427,-13
2009,29025,Benalmádena,Málaga,1352,890,462
2009,29038,Cártama,Málaga,144,132,12
2009,29042,Coín,Málaga,177,191,-14
2009,29051,Estepona,Málaga,1280,1457,-177
2009,29054,Fuengirola,Málaga,1524,1466,58
2009,29067,Málaga,Málaga,6148,5850,298
2009,29068,Manilva,Málaga,494,424,70
2009,29069,Marbella,Málaga,2499,2398,101
2009,29070,Mijas,Málaga,1193,971,222
2009,29075,Nerja,Málaga,262,301,-39
2009,29082,Rincón de la Victoria,Málaga,654,456,198
2009,29084,Ronda,Málaga,545,529,16
2009,29091,Torrox,Málaga,242,225,17
2009,29094,Vélez-Málaga,Málaga,950,815,135
2009,29901,Torremolinos,Málaga,1382,1071,311
2009,30002,Abarán,Murcia,150,91,59
2009,30003,Águilas,Murcia,681,625,56
2009,30005,Alcantarilla,Murcia,413,483,-70
2009,30008,Alhama de Murcia,Murcia,244,208,36
2009,30009,Archena,Murcia,443,383,60
2009,30010,Beniel,Murcia,239,187,52
2009,30012,Bullas,Murcia,117,155,-38
2009,30013,Calasparra,Murcia,166,99,67
2009,30015,Caravaca de la Cruz,Murcia,396,420,-24
2009,30016,Cartagena,Murcia,2792,2662,130
2009,30017,Cehegín,Murcia,158,112,46
2009,30018,Ceutí,Murcia,109,99,10
2009,30019,Cieza (Murcia),Murcia,287,255,32
2009,30021,Fuente Álamo de Murcia,Murcia,318,238,80
2009,30022,Jumilla,Murcia,446,353,93
2009,30024,Lorca,Murcia,1640,1346,294
2009,30026,Mazarrón,Murcia,494,680,-186
2009,30027,Molina de Segura,Murcia,981,839,142
2009,30029,Mula,Murcia,257,203,54
2009,30030,Murcia,Murcia,5573,5196,377
2009,30033,Puerto Lumbreras,Murcia,200,155,45
2009,30035,San Javier,Murcia,760,714,46
2009,30036,San Pedro del Pinatar,Murcia,668,774,-106
2009,30037,Torre-Pacheco,Murcia,481,471,10
2009,30038,Las Torres de Cotillas,Murcia,216,201,15
2009,30039,Totana,Murcia,444,317,127
2009,30041,La Unión,Murcia,259,188,71
2009,30043,Yecla,Murcia,434,596,-162
2009,30901,Santomera,Murcia,231,235,-4
2009,30902,Los Alcázares,Murcia,444,435,9
2009,31016,Ansoáin/Antsoain,Navarra,86,67,19
2009,31060,Burlada/Burlata,Navarra,228,178,50
2009,31086,Valle de Egüés,Navarra,151,86,65
2009,31097,Estella-Lizarra,Navarra,205,170,35
2009,31201,Pamplona/Iruña,Navarra,2811,2304,507
2009,31227,Tafalla,Navarra,101,95,6
2009,31232,Tudela,Navarra,817,642,175
2009,31258,Villava/Atarrabia,Navarra,95,67,28
2009,31901,Barañain,Navarra,243,249,-6
2009,31907,Zizur Mayor/Zizur Nagusia,Navarra,150,111,39
2009,32009,O Barco de Valdeorras,Ourense,269,310,-41
2009,32019,O Carballiño,Ourense,201,212,-11
2009,32032,Xinzo de Limia,Ourense,185,149,36
2009,32054,Ourense,Ourense,1996,1744,252
2009,32085,Verín,Ourense,443,304,139
2009,33002,Aller,Asturias,86,82,4
2009,33004,Avilés,Asturias,879,826,53
2009,33011,Cangas del Narcea,Asturias,111,104,7
2009,33014,Carreño,Asturias,113,85,28
2009,33016,Castrillón,Asturias,182,189,-7
2009,33020,Corvera de Asturias,Asturias,150,129,21
2009,33024,Gijón,Asturias,3000,2959,41
2009,33025,Gozón,Asturias,107,63,44
2009,33026,Grado,Asturias,85,80,5
2009,33031,Langreo,Asturias,371,343,28
2009,33032,Laviana,Asturias,75,76,-1
2009,33033,Lena,Asturias,173,132,41
2009,33034,Valdés,Asturias,86,80,6
2009,33035,Llanera,Asturias,112,96,16
2009,33036,Llanes,Asturias,175,184,-9
2009,33037,Mieres (Asturias),Asturias,279,320,-41
2009,33044,Oviedo,Asturias,2965,3009,-44
2009,33060,San Martín del Rey Aurelio,Asturias,124,110,14
2009,33066,Siero,Asturias,499,406,93
2009,33073,Tineo,Asturias,62,53,9
2009,33076,Villaviciosa,Asturias,138,84,54
2009,34120,Palencia,Palencia,1060,1374,-314
2009,35002,Agüimes,Las Palmas,250,337,-87
2009,35003,Antigua,Las Palmas,256,459,-203
2009,35004,Arrecife,Las Palmas,1210,2206,-996
2009,35006,Arucas,Las Palmas,173,195,-22
2009,35009,Gáldar,Las Palmas,112,121,-9
2009,35011,Ingenio,Las Palmas,202,183,19
2009,35012,Mogán,Las Palmas,307,298,9
2009,35014,La Oliva,Las Palmas,617,963,-346
2009,35015,Pájara,Las Palmas,516,1167,-651
2009,35016,Las Palmas de Gran Canaria,Las Palmas,5017,5190,-173
2009,35017,Puerto del Rosario,Las Palmas,881,1701,-820
2009,35018,San Bartolomé,Las Palmas,377,572,-195
2009,35019,San Bartolomé de Tirajana,Las Palmas,666,761,-95
2009,35021,Santa Brígida,Las Palmas,116,148,-32
2009,35022,Santa Lucía de Tirajana,Las Palmas,849,950,-101
2009,35023,Santa María de Guía de Gran Canaria,Las Palmas,55,47,8
2009,35024,Teguise,Las Palmas,370,466,-96
2009,35026,Telde,Las Palmas,739,765,-26
2009,35027,Teror,Las Palmas,49,56,-7
2009,35028,Tías,Las Palmas,386,566,-180
2009,35030,Tuineje,Las Palmas,228,501,-273
2009,35034,Yaiza,Las Palmas,584,844,-260
2009,36003,Baiona,Pontevedra,131,102,29
2009,36004,Bueu,Pontevedra,103,78,25
2009,36005,Caldas de Reis,Pontevedra,117,90,27
2009,36006,Cambados,Pontevedra,142,81,61
2009,36008,Cangas,Pontevedra,235,180,55
2009,36017,A Estrada,Pontevedra,243,242,1
2009,36021,Gondomar,Pontevedra,101,62,39
2009,36022,O Grove,Pontevedra,132,103,29
2009,36023,A Guarda,Pontevedra,143,122,21
2009,36024,Lalín,Pontevedra,285,347,-62
2009,36026,Marín,Pontevedra,367,314,53
2009,36029,Moaña,Pontevedra,168,94,74
2009,36033,Mos,Pontevedra,105,86,19
2009,36035,Nigrán,Pontevedra,143,146,-3
2009,36038,Pontevedra,Pontevedra,1156,1057,99
2009,36039,O Porriño,Pontevedra,216,160,56
2009,36041,Poio,Pontevedra,220,185,35
2009,36042,Ponteareas,Pontevedra,287,209,78
2009,36045,Redondela,Pontevedra,258,189,69
2009,36051,Sanxenxo,Pontevedra,257,162,95
2009,36054,Tomiño,Pontevedra,114,76,38
2009,36055,Tui,Pontevedra,163,156,7
2009,36057,Vigo,Pontevedra,3774,3497,277
2009,36060,Vilagarcía de Arousa,Pontevedra,623,490,133
2009,36061,Vilanova de Arousa,Pontevedra,118,92,26
2009,37046,Béjar,Salamanca,227,287,-60
2009,37107,Ciudad Rodrigo,Salamanca,166,218,-52
2009,37274,Salamanca,Salamanca,2314,2817,-503
2009,37294,Santa Marta de Tormes,Salamanca,260,260,0
2009,38001,Adeje,Santa Cruz de Tenerife,895,1273,-378
2009,38006,Arona,Santa Cruz de Tenerife,1646,2470,-824
2009,38011,Candelaria,Santa Cruz de Tenerife,482,471,11
2009,38017,Granadilla de Abona,Santa Cruz de Tenerife,877,1141,-264
2009,38019,Guía de Isora,Santa Cruz de Tenerife,188,292,-104
2009,38020,Güímar,Santa Cruz de Tenerife,101,116,-15
2009,38022,Icod de los Vinos,Santa Cruz de Tenerife,135,130,5
2009,38023,San Cristóbal de La Laguna,Santa Cruz de Tenerife,1551,1540,11
2009,38024,Los Llanos de Aridane,Santa Cruz de Tenerife,302,301,1
2009,38026,La Orotava,Santa Cruz de Tenerife,198,253,-55
2009,38028,Puerto de la Cruz,Santa Cruz de Tenerife,496,546,-50
2009,38031,Los Realejos,Santa Cruz de Tenerife,164,208,-44
2009,38032,El Rosario,Santa Cruz de Tenerife,166,249,-83
2009,38035,San Miguel de Abona,Santa Cruz de Tenerife,241,236,5
2009,38037,Santa Cruz de la Palma,Santa Cruz de Tenerife,323,327,-4
2009,38038,Santa Cruz de Tenerife,Santa Cruz de Tenerife,2591,2885,-294
2009,38039,Santa Úrsula,Santa Cruz de Tenerife,90,111,-21
2009,38040,Santiago del Teide,Santa Cruz de Tenerife,76,127,-51
2009,38043,Tacoronte,Santa Cruz de Tenerife,93,116,-23
2009,38046,Tegueste,Santa Cruz de Tenerife,54,47,7
2009,39008,El Astillero,Cantabria,156,136,20
2009,39016,Camargo,Cantabria,279,300,-21
2009,39020,Castro-Urdiales,Cantabria,1617,1374,243
2009,39025,Los Corrales de Buelna,Cantabria,80,69,11
2009,39035,Laredo,Cantabria,204,257,-53
2009,39052,Piélagos,Cantabria,299,241,58
2009,39059,Reinosa,Cantabria,103,114,-11
2009,39073,Santa Cruz de Bezana,Cantabria,143,126,17
2009,39075,Santander,Cantabria,2200,2352,-152
2009,39079,Santoña,Cantabria,204,213,-9
2009,39087,Torrelavega,Cantabria,525,602,-77
2009,40194,Segovia,Segovia,938,1170,-232
2009,41004,Alcalá de Guadaíra,Sevilla,615,500,115
2009,41005,Alcalá del Río,Sevilla,63,74,-11
2009,41007,La Algaba,Sevilla,106,81,25
2009,41011,Arahal,Sevilla,69,72,-3
2009,41017,Bormujos,Sevilla,213,170,43
2009,41018,Brenes,Sevilla,105,90,15
2009,41020,Las Cabezas de San Juan,Sevilla,130,128,2
2009,41021,Camas,Sevilla,272,205,67
2009,41023,Cantillana,Sevilla,85,95,-10
2009,41024,Carmona,Sevilla,265,194,71
2009,41029,Castilleja de la Cuesta,Sevilla,195,134,61
2009,41034,Coria del Río,Sevilla,273,228,45
2009,41038,Dos Hermanas,Sevilla,1129,976,153
2009,41039,Écija,Sevilla,391,455,-64
2009,41040,Espartinas,Sevilla,190,126,64
2009,41041,Estepa,Sevilla,131,129,2
2009,41047,Gines,Sevilla,118,92,26
2009,41049,Guillena,Sevilla,106,74,32
2009,41053,Lebrija,Sevilla,282,214,68
2009,41055,Lora del Río,Sevilla,195,157,38
2009,41058,Mairena del Alcor,Sevilla,191,128,63
2009,41059,Mairena del Aljarafe,Sevilla,618,434,184
2009,41060,Marchena,Sevilla,147,150,-3
2009,41065,Morón de la Frontera,Sevilla,268,230,38
2009,41068,Osuna,Sevilla,151,140,11
2009,41069,Los Palacios y Villafranca,Sevilla,232,173,59
2009,41075,Pilas,Sevilla,148,124,24
2009,41077,La Puebla de Cazalla,Sevilla,160,111,49
2009,41079,La Puebla del Río,Sevilla,122,86,36
2009,41081,La Rinconada,Sevilla,290,252,38
2009,41086,San Juan de Aznalfarache,Sevilla,402,362,40
2009,41087,Sanlúcar la Mayor,Sevilla,168,119,49
2009,41091,Sevilla,Sevilla,7935,6938,997
2009,41093,Tomares,Sevilla,319,259,60
2009,41095,Utrera,Sevilla,445,386,59
2009,41102,El Viso del Alcor,Sevilla,127,68,59
2009,42173,Soria,Soria,793,801,-8
2009,43004,Alcanar,Tarragona,206,253,-47
2009,43014,Amposta,Tarragona,346,360,-14
2009,43037,Calafell,Tarragona,1601,1275,326
2009,43038,Cambrils,Tarragona,846,812,34
2009,43051,Cunit,Tarragona,1074,749,325
2009,43092,Mont-roig del Camp,Tarragona,441,333,108
2009,43123,Reus,Tarragona,1150,1676,-526
2009,43136,Sant Carles de la Ràpita,Tarragona,399,354,45
2009,43148,Tarragona,Tarragona,2434,2840,-406
2009,43153,Torredembarra,Tarragona,495,481,14
2009,43155,Tortosa,Tarragona,441,756,-315
2009,43161,Valls,Tarragona,404,479,-75
2009,43163,El Vendrell,Tarragona,1387,1284,103
2009,43171,Vila-seca,Tarragona,531,539,-8
2009,43901,Deltebre,Tarragona,150,135,15
2009,43905,Salou,Tarragona,994,901,93
2009,44013,Alcañiz,Teruel,266,351,-85
2009,44216,Teruel,Teruel,592,727,-135
2009,45053,Consuegra,Toledo,110,128,-18
2009,45066,Fuensalida,Toledo,404,383,21
2009,45081,Illescas,Toledo,1754,1046,708
2009,45087,Madridejos,Toledo,128,194,-66
2009,45106,Mora,Toledo,143,180,-37
2009,45142,Quintanar de la Orden,Toledo,255,290,-35
2009,45161,Seseña,Toledo,2399,1448,951
2009,45163,Sonseca,Toledo,181,185,-4
2009,45165,Talavera de la Reina,Toledo,1652,1833,-181
2009,45168,Toledo,Toledo,1772,1660,112
2009,45173,Torrijos,Toledo,313,295,18
2009,45185,Villacañas,Toledo,172,203,-31
2009,46005,Alaquàs,Valencia,273,303,-30
2009,46007,Albal,Valencia,111,156,-45
2009,46011,Alberic,Valencia,135,148,-13
2009,46013,Alboraya,Valencia,226,287,-61
2009,46017,Alzira,Valencia,398,458,-60
2009,46019,L'Alcúdia,Valencia,47,68,-21
2009,46021,Aldaia,Valencia,242,243,-1
2009,46022,Alfafar,Valencia,255,263,-8
2009,46029,Algemesí,Valencia,229,304,-75
2009,46031,Alginet,Valencia,98,122,-24
2009,46051,Benaguasil,Valencia,139,124,15
2009,46054,Benetússer,Valencia,158,193,-35
2009,46060,Benifaió,Valencia,71,67,4
2009,46070,Bétera,Valencia,238,259,-21
2009,46077,Buñol,Valencia,103,127,-24
2009,46078,Burjassot,Valencia,374,397,-23
2009,46081,Canals,Valencia,87,56,31
2009,46083,Carcaixent,Valencia,178,180,-2
2009,46085,Carlet,Valencia,117,95,22
2009,46094,Catarroja,Valencia,254,273,-19
2009,46102,Quart de Poblet,Valencia,207,232,-25
2009,46105,Cullera,Valencia,249,337,-88
2009,46110,Xirivella,Valencia,421,437,-16
2009,46111,Chiva,Valencia,169,174,-5
2009,46116,L'Eliana,Valencia,101,132,-31
2009,46131,Gandia,Valencia,1530,1721,-191
2009,46135,Godella,Valencia,136,122,14
2009,46145,Xátiva,Valencia,286,286,0
2009,46147,Llíria,Valencia,299,285,14
2009,46159,Manises,Valencia,318,367,-49
2009,46164,Massamagrell,Valencia,168,180,-12
2009,46166,Meliana,Valencia,87,88,-1
2009,46169,Mislata,Valencia,512,618,-106
2009,46171,Moncada,Valencia,117,135,-18
2009,46181,Oliva,Valencia,393,453,-60
2009,46184,Ontinyent,Valencia,316,389,-73
2009,46186,Paiporta,Valencia,216,210,6
2009,46190,Paterna,Valencia,808,730,78
2009,46193,Picanya,Valencia,78,100,-22
2009,46194,Picassent,Valencia,181,179,2
2009,46202,La Pobla de Vallbona,Valencia,207,193,14
2009,46205,Puçol,Valencia,229,226,3
2009,46213,Requena,Valencia,258,185,73
2009,46214,Riba-roja de Túria,Valencia,192,198,-6
2009,46220,Sagunto/Sagunt,Valencia,1058,1044,14
2009,46230,Silla,Valencia,184,219,-35
2009,46235,Sueca,Valencia,206,205,1
2009,46238,Tavernes de la Valldigna,Valencia,121,161,-40
2009,46244,Torrent (Valencia),Valencia,837,982,-145
2009,46249,Utiel,Valencia,89,81,8
2009,46250,València,Valencia,11813,12268,-455
2009,47010,Arroyo de la Encomienda,Valladolid,285,180,105
2009,47076,Laguna de Duero,Valladolid,280,207,73
2009,47085,Medina del Campo,Valladolid,298,310,-12
2009,47186,Valladolid,Valladolid,4328,4423,-95
2009,48003,Amorebieta-Etxano,Vizcaya,130,114,16
2009,48011,Arrigorriaga,Vizcaya,107,141,-34
2009,48013,Barakaldo,Vizcaya,1167,1089,78
2009,48015,Basauri,Vizcaya,368,395,-27
2009,48017,Bermeo,Vizcaya,193,119,74
2009,48020,Bilbao,Vizcaya,5194,4362,832
2009,48027,Durango,Vizcaya,295,303,-8
2009,48034,Ermua,Vizcaya,205,285,-80
2009,48036,Galdakao,Vizcaya,150,209,-59
2009,48044,Getxo,Vizcaya,791,836,-45
2009,48046,Gernika-Lumo,Vizcaya,110,87,23
2009,48054,Leioa,Vizcaya,250,285,-35
2009,48069,Mungia,Vizcaya,158,98,60
2009,48078,Portugalete,Vizcaya,351,414,-63
2009,48080,Valle de Trápaga-Trapagaran,Vizcaya,110,114,-4
2009,48082,Santurtzi,Vizcaya,562,528,34
2009,48084,Sestao,Vizcaya,320,334,-14
2009,48085,Sopela,Vizcaya,109,103,6
2009,48902,Erandio,Vizcaya,243,250,-7
2009,49021,Benavente,Zamora,349,453,-104
2009,49275,Zamora,Zamora,930,1027,-97
2009,50067,Calatayud,Zaragoza,290,330,-40
2009,50095,Ejea de los Caballeros,Zaragoza,182,201,-19
2009,50251,Tarazona,Zaragoza,177,236,-59
2009,50272,Utebo,Zaragoza,255,222,33
2009,50297,Zaragoza,Zaragoza,8198,9173,-975
2009,51001,Ceuta,Ceuta,3151,2277,874
2009,52001,Melilla,Melilla,3806,2539,1267
2010,01002,Amurrio,Álava,138,167,-29
2010,01036,Laudio/Llodio,Álava,356,273,83
2010,01059,Vitoria-Gasteiz,Álava,4811,3437,1374
2010,02003,Albacete,Albacete,2932,2752,180
2010,02009,Almansa,Albacete,410,507,-97
2010,02025,Caudete,Albacete,247,229,18
2010,02037,Hellín,Albacete,572,606,-34
2010,02069,La Roda,Albacete,263,253,10
2010,02081,Villarrobledo,Albacete,414,423,-9
2010,03005,Albatera,Alicante,80,109,-29
2010,03009,Alcoy/Alcoi,Alicante,564,701,-137
2010,03011,L'Alfàs del Pi,Alicante,269,292,-23
2010,03014,Alicante/Alacant,Alicante,5449,5574,-125
2010,03015,Almoradí,Alicante,284,232,52
2010,03018,Altea,Alicante,419,385,34
2010,03019,Aspe,Alicante,194,181,13
2010,03031,Benidorm,Alicante,2086,1929,157
2010,03041,Benissa,Alicante,119,118,1
2010,03047,Calp,Alicante,429,494,-65
2010,03049,Callosa de Segura,Alicante,162,191,-29
2010,03050,El Campello,Alicante,438,370,68
2010,03053,Castalla,Alicante,83,79,4
2010,03056,Cocentaina,Alicante,123,115,8
2010,03059,Crevillent,Alicante,260,332,-72
2010,03063,Dénia,Alicante,957,972,-15
2010,03065,Elche/Elx,Alicante,2664,2766,-102
2010,03066,Elda,Alicante,498,586,-88
2010,03076,Guardamar del Segura,Alicante,368,311,57
2010,03079,Ibi,Alicante,162,248,-86
2010,03082,Jávea/Xàbia,Alicante,473,453,20
2010,03089,Monóvar/Monòver,Alicante,72,106,-34
2010,03090,Mutxamel,Alicante,235,210,25
2010,03093,Novelda,Alicante,188,235,-47
2010,03094,La Nucia,Alicante,249,281,-32
2010,03099,Orihuela,Alicante,1353,1152,201
2010,03102,Pego,Alicante,131,165,-34
2010,03104,Petrer,Alicante,224,261,-37
2010,03113,Rojales,Alicante,135,130,5
2010,03118,San Fulgencio,Alicante,110,78,32
2010,03119,Sant Joan d'Alacant,Alicante,341,288,53
2010,03121,Santa Pola,Alicante,697,620,77
2010,03122,San Vicente del Raspeig/Sant Vicent del Raspeig,Alicante,573,568,5
2010,03123,Sax,Alicante,69,98,-29
2010,03128,Teulada,Alicante,146,188,-42
2010,03133,Torrevieja,Alicante,3153,3280,-127
2010,03139,Villajoyosa/La Vila Joiosa,Alicante,717,654,63
2010,03140,Villena,Alicante,392,485,-93
2010,03902,Pilar de la Horadada,Alicante,763,598,165
2010,04003,Adra,Almería,214,265,-51
2010,04006,Albox,Almería,161,216,-55
2010,04013,Almería,Almería,2192,2431,-239
2010,04029,Berja,Almería,130,133,-3
2010,04035,Cuevas del Almanzora,Almería,177,209,-32
2010,04052,Huércal de Almería,Almería,158,146,12
2010,04053,Huércal-Overa,Almería,309,349,-40
2010,04066,Níjar,Almería,601,475,126
2010,04079,Roquetas de Mar,Almería,2039,1953,86
2010,04100,Vera,Almería,411,370,41
2010,04102,Vícar,Almería,441,400,41
2010,04902,El Ejido,Almería,1502,1620,-118
2010,05019,Ávila,Ávila,1003,1278,-275
2010,06011,Almendralejo,Badajoz,444,452,-8
2010,06015,Badajoz,Badajoz,1904,1905,-1
2010,06044,Don Benito,Badajoz,567,477,90
2010,06083,Mérida,Badajoz,950,824,126
2010,06088,Montijo,Badajoz,241,201,40
2010,06095,Olivenza,Badajoz,142,102,40
2010,06149,Villafranca de los Barros,Badajoz,106,88,18
2010,06153,Villanueva de la Serena,Badajoz,327,357,-30
2010,06158,Zafra,Badajoz,227,217,10
2010,07003,Alcúdia,Baleares,478,530,-52
2010,07005,Andratx,Baleares,126,120,6
2010,07011,Calvià,Baleares,936,914,22
2010,07014,Capdepera,Baleares,279,311,-32
2010,07015,Ciutadella de Menorca,Baleares,1019,1092,-73
2010,07022,Felanitx,Baleares,222,272,-50
2010,07026,Eivissa,Baleares,2211,1948,263
2010,07027,Inca,Baleares,435,441,-6
2010,07031,Llucmajor,Baleares,672,667,5
2010,07032,Maó-Mahón,Baleares,856,1064,-208
2010,07033,Manacor,Baleares,645,826,-181
2010,07036,Marratxí,Baleares,215,234,-19
2010,07040,Palma,Baleares,6382,7676,-1294
2010,07042,Pollença,Baleares,213,232,-19
2010,07044,Sa Pobla,Baleares,100,146,-46
2010,07046,Sant Antoni de Portmany,Baleares,728,714,14
2010,07048,Sant Josep de sa Talaia,Baleares,1188,888,300
2010,07054,Santa Eulària des Riu,Baleares,1357,1189,168
2010,07055,Santa Margalida,Baleares,278,303,-25
2010,07057,Santanyí,Baleares,300,313,-13
2010,07061,Sóller,Baleares,135,152,-17
2010,07062,Son Servera,Baleares,205,304,-99
2010,08001,Abrera,Barcelona,81,116,-35
2010,08006,Arenys de Mar,Barcelona,149,157,-8
2010,08009,Argentona,Barcelona,70,75,-5
2010,08015,Badalona,Barcelona,2218,2555,-337
2010,08019,Barcelona,Barcelona,23211,20982,2229
2010,08022,Berga,Barcelona,142,131,11
2010,08033,Caldes de Montbui,Barcelona,117,145,-28
2010,08035,Calella,Barcelona,234,238,-4
2010,08040,Canet de Mar,Barcelona,73,125,-52
2010,08041,Canovelles,Barcelona,141,150,-9
2010,08046,Cardedeu,Barcelona,131,156,-25
2010,08051,Castellar del Vallès,Barcelona,133,157,-24
2010,08054,Castellbisbal,Barcelona,92,114,-22
2010,08056,Castelldefels,Barcelona,1013,946,67
2010,08072,Corbera de Llobregat,Barcelona,65,115,-50
2010,08073,Cornellà de Llobregat,Barcelona,826,925,-99
2010,08074,Cubelles,Barcelona,243,307,-64
2010,08076,Esparreguera,Barcelona,177,249,-72
2010,08077,Esplugues de Llobregat,Barcelona,433,476,-43
2010,08086,Les Franqueses del Vallès,Barcelona,150,155,-5
2010,08088,La Garriga,Barcelona,122,121,1
2010,08089,Gavà,Barcelona,429,568,-139
2010,08096,Granollers,Barcelona,649,677,-28
2010,08101,L'Hospitalet de Llobregat,Barcelona,3218,3309,-91
2010,08102,Igualada,Barcelona,386,467,-81
2010,08105,La Llagosta,Barcelona,116,175,-59
2010,08107,Lliçà d'Amunt,Barcelona,102,112,-10
2010,08110,Malgrat de Mar,Barcelona,276,292,-16
2010,08112,Manlleu,Barcelona,152,156,-4
2010,08113,Manresa,Barcelona,678,822,-144
2010,08114,Martorell,Barcelona,344,331,13
2010,08118,El Masnou,Barcelona,193,209,-16
2010,08121,Mataró,Barcelona,1230,1287,-57
2010,08123,Molins de Rei,Barcelona,163,180,-17
2010,08124,Mollet del Vallès,Barcelona,500,546,-46
2010,08125,Montcada i Reixac,Barcelona,314,297,17
2010,08126,Montgat,Barcelona,87,80,7
2010,08136,Montornès del Vallès,Barcelona,157,177,-20
2010,08147,Olesa de Montserrat,Barcelona,253,213,40
2010,08156,Palau-solità i Plegamans,Barcelona,62,93,-31
2010,08157,Pallejà,Barcelona,77,76,1
2010,08159,Parets del Vallès,Barcelona,171,144,27
2010,08161,Piera,Barcelona,130,167,-37
2010,08163,Pineda de Mar,Barcelona,250,339,-89
2010,08169,El Prat de Llobregat,Barcelona,608,715,-107
2010,08172,Premià de Mar,Barcelona,223,262,-39
2010,08180,Ripollet,Barcelona,303,385,-82
2010,08181,La Roca del Vallès,Barcelona,50,85,-35
2010,08184,Rubí,Barcelona,767,822,-55
2010,08187,Sabadell,Barcelona,1985,2140,-155
2010,08194,Sant Adrià de Besòs,Barcelona,328,361,-33
2010,08196,Sant Andreu de la Barca,Barcelona,264,284,-20
2010,08197,Sant Andreu de Llavaneres,Barcelona,73,80,-7
2010,08200,Sant Boi de Llobregat,Barcelona,769,911,-142
2010,08202,Sant Celoni,Barcelona,257,274,-17
2010,08205,Sant Cugat del Vallès,Barcelona,969,901,68
2010,08211,Sant Feliu de Llobregat,Barcelona,367,430,-63
2010,08217,Sant Joan Despí,Barcelona,319,263,56
2010,08218,Sant Joan de Vilatorrada,Barcelona,59,66,-7
2010,08219,Vilassar de Mar,Barcelona,130,165,-35
2010,08221,Sant Just Desvern,Barcelona,172,149,23
2010,08230,Premià de Dalt,Barcelona,71,83,-12
2010,08231,Sant Pere de Ribes,Barcelona,314,342,-28
2010,08238,Sant Quirze del Vallès,Barcelona,114,138,-24
2010,08240,Sant Sadurní d'Anoia,Barcelona,106,119,-13
2010,08245,Santa Coloma de Gramenet,Barcelona,1407,1746,-339
2010,08252,Barberà del Vallès,Barcelona,277,334,-57
2010,08260,Santa Perpètua de Mogoda,Barcelona,237,232,5
2010,08263,Sant Vicenç dels Horts,Barcelona,250,307,-57
2010,08266,Cerdanyola del Vallès,Barcelona,477,535,-58
2010,08270,Sitges,Barcelona,355,298,57
2010,08279,Terrassa,Barcelona,2162,2343,-181
2010,08284,Tordera,Barcelona,443,359,84
2010,08285,Torelló,Barcelona,98,110,-12
2010,08295,Vallirana,Barcelona,118,117,1
2010,08298,Vic,Barcelona,526,424,102
2010,08301,Viladecans,Barcelona,721,705,16
2010,08302,Vilanova del Camí,Barcelona,79,127,-48
2010,08305,Vilafranca del Penedès,Barcelona,494,462,32
2010,08307,Vilanova i la Geltrú,Barcelona,949,965,-16
2010,08904,Badia del Vallès,Barcelona,122,156,-34
2010,09018,Aranda de Duero,Burgos,559,642,-83
2010,09059,Burgos,Burgos,2300,2672,-372
2010,09219,Miranda de Ebro,Burgos,865,991,-126
2010,10037,Cáceres,Cáceres,1417,1496,-79
2010,10067,Coria,Cáceres,180,183,-3
2010,10121,Miajadas,Cáceres,125,185,-60
2010,10131,Navalmoral de la Mata,Cáceres,385,395,-10
2010,10148,Plasencia,Cáceres,534,651,-117
2010,11004,Algeciras,Cádiz,1978,1796,182
2010,11006,Arcos de la Frontera,Cádiz,283,327,-44
2010,11007,Barbate,Cádiz,267,240,27
2010,11008,Los Barrios,Cádiz,311,295,16
2010,11012,Cádiz,Cádiz,1182,1429,-247
2010,11014,Conil de la Frontera,Cádiz,306,260,46
2010,11015,Chiclana de la Frontera,Cádiz,1045,916,129
2010,11016,Chipiona,Cádiz,231,221,10
2010,11020,Jerez de la Frontera,Cádiz,2639,2211,428
2010,11021,Jimena de la Frontera,Cádiz,148,164,-16
2010,11022,La Línea de la Concepción,Cádiz,701,742,-41
2010,11023,Medina-Sidonia,Cádiz,55,67,-12
2010,11027,El Puerto de Santa María,Cádiz,1386,1560,-174
2010,11028,Puerto Real,Cádiz,442,371,71
2010,11030,Rota,Cádiz,713,573,140
2010,11031,San Fernando,Cádiz,982,1239,-257
2010,11032,Sanlúcar de Barrameda,Cádiz,510,544,-34
2010,11033,San Roque,Cádiz,486,514,-28
2010,11035,Tarifa,Cádiz,289,267,22
2010,11038,Ubrique,Cádiz,162,201,-39
2010,11039,Vejer de la Frontera,Cádiz,78,82,-4
2010,11041,Villamartín,Cádiz,83,171,-88
2010,12005,L'Alcora,Castellón,94,214,-120
2010,12009,Almassora,Castellón,316,347,-31
2010,12027,Benicarló,Castellón,598,680,-82
2010,12028,Benicasim/Benicàssim,Castellón,294,359,-65
2010,12032,Borriana/Burriana,Castellón,560,622,-62
2010,12040,Castellón de la Plana/Castelló de la Plana,Castellón,2246,2900,-654
2010,12082,Nules,Castellón,178,173,5
2010,12084,Onda,Castellón,273,378,-105
2010,12085,Oropesa del Mar/Orpesa,Castellón,454,530,-76
2010,12126,La Vall d'Uixó,Castellón,354,425,-71
2010,12135,Vila-real,Castellón,606,773,-167
2010,12138,Vinaròs,Castellón,826,748,78
2010,13005,Alcázar de San Juan,Ciudad Real,655,669,-14
2010,13023,Bolaños de Calatrava,Ciudad Real,106,120,-14
2010,13028,Campo de Criptana,Ciudad Real,166,197,-31
2010,13034,Ciudad Real,Ciudad Real,1146,1241,-95
2010,13039,Daimiel,Ciudad Real,215,190,25
2010,13053,Manzanares,Ciudad Real,302,319,-17
2010,13056,Miguelturra,Ciudad Real,156,187,-31
2010,13071,Puertollano,Ciudad Real,877,998,-121
2010,13078,Socuéllamos,Ciudad Real,287,293,-6
2010,13079,La Solana,Ciudad Real,135,152,-17
2010,13082,Tomelloso,Ciudad Real,619,704,-85
2010,13087,Valdepeñas,Ciudad Real,462,666,-204
2010,13096,Villarrubia de los Ojos,Ciudad Real,64,108,-44
2010,14002,Aguilar de la Frontera,Córdoba,78,100,-22
2010,14007,Baena,Córdoba,291,223,68
2010,14013,Cabra,Córdoba,202,251,-49
2010,14017,La Carlota,Córdoba,174,175,-1
2010,14021,Córdoba,Córdoba,3549,4150,-601
2010,14030,Fuente Palmera,Córdoba,142,94,48
2010,14038,Lucena,Córdoba,507,542,-35
2010,14042,Montilla,Córdoba,149,193,-44
2010,14049,Palma del Río,Córdoba,296,305,-9
2010,14052,Peñarroya-Pueblonuevo,Córdoba,161,154,7
2010,14054,Pozoblanco,Córdoba,166,221,-55
2010,14055,Priego de Córdoba,Córdoba,279,335,-56
2010,14056,Puente Genil,Córdoba,401,443,-42
2010,14058,Rute,Córdoba,154,147,7
2010,15002,Ames,A Coruña,662,379,283
2010,15005,Arteixo,A Coruña,364,322,42
2010,15009,Betanzos,A Coruña,142,141,1
2010,15011,Boiro,A Coruña,185,146,39
2010,15017,Cambre,A Coruña,214,197,17
2010,15019,Carballo,A Coruña,243,216,27
2010,15030,A Coruña,A Coruña,3297,2949,348
2010,15031,Culleredo,A Coruña,367,279,88
2010,15035,Fene,A Coruña,91,105,-14
2010,15036,Ferrol,A Coruña,1264,1230,34
2010,15041,A Laracha,A Coruña,54,54,0
2010,15054,Narón,A Coruña,499,455,44
2010,15057,Noia,A Coruña,136,128,8
2010,15058,Oleiros,A Coruña,475,393,82
2010,15059,Ordes,A Coruña,84,80,4
2010,15070,As Pontes de García Rodríguez,A Coruña,72,153,-81
2010,15072,Rianxo,A Coruña,99,100,-1
2010,15073,Ribeira,A Coruña,316,275,41
2010,15075,Sada (A Coruña),A Coruña,205,169,36
2010,15077,Santa Comba,A Coruña,50,26,24
2010,15078,Santiago de Compostela,A Coruña,1651,1379,272
2010,15082,Teo,A Coruña,187,154,33
2010,16078,Cuenca,Cuenca,1028,1222,-194
2010,16203,Tarancón,Cuenca,374,494,-120
2010,17015,Banyoles,Girona,237,271,-34
2010,17022,La Bisbal d'Empordà,Girona,129,155,-26
2010,17023,Blanes,Girona,1209,1376,-167
2010,17034,Calonge i Sant Antoni,Girona,253,239,14
2010,17047,Castelló d'Empúries,Girona,223,277,-54
2010,17048,Castell-Platja d'Aro,Girona,302,311,-9
2010,17062,L'Escala,Girona,212,245,-33
2010,17066,Figueres,Girona,731,775,-44
2010,17079,Girona,Girona,1861,1787,74
2010,17095,Lloret de Mar,Girona,1143,1366,-223
2010,17114,Olot,Girona,416,617,-201
2010,17117,Palafrugell,Girona,354,343,11
2010,17118,Palamós,Girona,348,300,48
2010,17147,Ripoll,Girona,149,194,-45
2010,17152,Roses,Girona,365,416,-51
2010,17155,Salt,Girona,463,651,-188
2010,17160,Sant Feliu de Guíxols,Girona,382,382,0
2010,17180,Santa Coloma de Farners,Girona,188,194,-6
2010,17199,Torroella de Montgrí,Girona,185,196,-11
2010,18003,Albolote,Granada,202,195,7
2010,18017,Almuñécar,Granada,427,451,-24
2010,18021,Armilla,Granada,492,412,80
2010,18022,Atarfe,Granada,279,263,16
2010,18023,Baza,Granada,476,429,47
2010,18062,Churriana de la Vega,Granada,193,187,6
2010,18087,Granada,Granada,3972,4337,-365
2010,18089,Guadix,Granada,281,323,-42
2010,18101,Huétor Vega,Granada,101,108,-7
2010,18102,Illora,Granada,92,85,7
2010,18122,Loja,Granada,282,292,-10
2010,18127,Maracena,Granada,288,267,21
2010,18140,Motril,Granada,677,747,-70
2010,18145,Ogíjares,Granada,172,177,-5
2010,18153,Peligros,Granada,107,153,-46
2010,18158,Pinos Puente,Granada,119,131,-12
2010,18173,Salobreña,Granada,183,168,15
2010,18175,Santa Fe,Granada,160,162,-2
2010,18193,La Zubia,Granada,268,253,15
2010,18905,Las Gabias,Granada,338,320,18
2010,19024,Alovera,Guadalajara,544,341,203
2010,19046,Azuqueca de Henares,Guadalajara,2109,1453,656
2010,19071,El Casar,Guadalajara,906,557,349
2010,19130,Guadalajara,Guadalajara,2146,1833,313
2010,20009,Andoain,Guipúzcoa,102,116,-14
2010,20017,Azkoitia,Guipúzcoa,72,95,-23
2010,20018,Azpeitia,Guipúzcoa,77,66,11
2010,20019,Beasain,Guipúzcoa,176,109,67
2010,20030,Eibar,Guipúzcoa,416,378,38
2010,20032,Elgoibar,Guipúzcoa,135,130,5
2010,20036,Hondarribia,Guipúzcoa,133,159,-26
2010,20040,Hernani,Guipúzcoa,148,138,10
2010,20045,Irun,Guipúzcoa,854,711,143
2010,20055,Arrasate/Mondragón,Guipúzcoa,251,317,-66
2010,20059,Oñati,Guipúzcoa,63,67,-4
2010,20064,Pasaia,Guipúzcoa,119,110,9
2010,20067,Errenteria,Guipúzcoa,308,324,-16
2010,20069,Donostia/San Sebastián,Guipúzcoa,2107,2015,92
2010,20071,Tolosa,Guipúzcoa,114,101,13
2010,20074,Bergara,Guipúzcoa,119,141,-22
2010,20079,Zarautz,Guipúzcoa,222,211,11
2010,20080,Zumarraga,Guipúzcoa,80,103,-23
2010,20902,Lasarte-Oria,Guipúzcoa,202,173,29
2010,21002,Aljaraque,Huelva,234,218,16
2010,21005,Almonte,Huelva,310,355,-45
2010,21010,Ayamonte,Huelva,326,251,75
2010,21013,Bollullos Par del Condado,Huelva,115,117,-2
2010,21021,Cartaya,Huelva,277,297,-20
2010,21035,Gibraleón,Huelva,87,102,-15
2010,21041,Huelva,Huelva,1399,1945,-546
2010,21042,Isla Cristina,Huelva,284,270,14
2010,21044,Lepe,Huelva,427,509,-82
2010,21050,Moguer,Huelva,371,367,4
2010,21054,La Palma del Condado,Huelva,148,131,17
2010,21060,Punta Umbría,Huelva,185,179,6
2010,21072,Valverde del Camino,Huelva,79,94,-15
2010,22048,Barbastro,Huesca,259,348,-89
2010,22112,Fraga,Huesca,365,339,26
2010,22125,Huesca,Huesca,987,1191,-204
2010,22130,Jaca,Huesca,447,448,-1
2010,22158,Monzón,Huesca,297,323,-26
2010,22199,Sabiñánigo,Huesca,206,273,-67
2010,23002,Alcalá la Real,Jaén,280,358,-78
2010,23003,Alcaudete,Jaén,193,127,66
2010,23005,Andújar,Jaén,475,656,-181
2010,23009,Baeza,Jaén,233,237,-4
2010,23010,Bailén,Jaén,188,259,-71
2010,23024,La Carolina,Jaén,181,241,-60
2010,23050,Jaén,Jaén,1305,1560,-255
2010,23053,Jódar,Jaén,99,124,-25
2010,23055,Linares,Jaén,730,990,-260
2010,23058,Mancha Real,Jaén,104,107,-3
2010,23060,Martos,Jaén,210,235,-25
2010,23086,Torredelcampo,Jaén,88,140,-52
2010,23087,Torredonjimeno,Jaén,131,180,-49
2010,23092,Úbeda,Jaén,476,593,-117
2010,23095,Villacarrillo,Jaén,226,173,53
2010,24008,Astorga,León,181,179,2
2010,24010,La Bañeza,León,139,188,-49
2010,24014,Bembibre,León,172,174,-2
2010,24089,León,León,2004,2506,-502
2010,24115,Ponferrada,León,1085,1076,9
2010,24142,San Andrés del Rabanedo,León,458,409,49
2010,24202,Villablino,León,129,219,-90
2010,24222,Villaquilambre,León,297,284,13
2010,25040,Balaguer,Lleida,322,309,13
2010,25120,Lleida,Lleida,2796,3148,-352
2010,25137,Mollerussa,Lleida,223,302,-79
2010,25203,La Seu d'Urgell,Lleida,405,404,1
2010,25217,Tàrrega,Lleida,318,401,-83
2010,26018,Arnedo,La Rioja,172,192,-20
2010,26036,Calahorra,La Rioja,493,600,-107
2010,26071,Haro,La Rioja,306,329,-23
2010,26089,Logroño,La Rioja,2473,2588,-115
2010,27028,Lugo,Lugo,1442,1484,-42
2010,27031,Monforte de Lemos,Lugo,423,396,27
2010,27057,Sarria,Lugo,174,166,8
2010,27065,Vilalba,Lugo,147,143,4
2010,27066,Viveiro,Lugo,238,334,-96
2010,28005,Alcalá de Henares,Madrid,3265,4406,-1141
2010,28006,Alcobendas,Madrid,1322,1376,-54
2010,28007,Alcorcón,Madrid,1806,2290,-484
2010,28009,Algete,Madrid,246,288,-42
2010,28010,Alpedrete,Madrid,134,151,-17
2010,28013,Aranjuez,Madrid,1292,1391,-99
2010,28014,Arganda del Rey,Madrid,656,710,-54
2010,28015,Arroyomolinos (Madrid),Madrid,385,179,206
2010,28022,Boadilla del Monte,Madrid,445,423,22
2010,28040,Ciempozuelos,Madrid,349,360,-11
2010,28045,Colmenar Viejo,Madrid,625,431,194
2010,28047,Collado Villalba,Madrid,780,867,-87
2010,28049,Coslada,Madrid,806,956,-150
2010,28054,El Escorial,Madrid,157,156,1
2010,28058,Fuenlabrada,Madrid,2588,3944,-1356
2010,28061,Galapagar,Madrid,356,428,-72
2010,28065,Getafe,Madrid,2090,2687,-597
2010,28068,Guadarrama,Madrid,178,189,-11
2010,28073,Humanes de Madrid,Madrid,329,476,-147
2010,28074,Leganés,Madrid,2228,2746,-518
2010,28079,Madrid,Madrid,51475,47097,4378
2010,28080,Majadahonda,Madrid,825,811,14
2010,28083,Meco,Madrid,187,281,-94
2010,28084,Mejorada del Campo,Madrid,214,284,-70
2010,28090,Moralzarzal,Madrid,84,117,-33
2010,28092,Móstoles,Madrid,2636,3390,-754
2010,28096,Navalcarnero,Madrid,465,350,115
2010,28104,Paracuellos de Jarama,Madrid,417,234,183
2010,28106,Parla,Madrid,2141,2612,-471
2010,28113,Pinto,Madrid,641,645,-4
2010,28115,Pozuelo de Alarcón,Madrid,836,741,95
2010,28123,Rivas-Vaciamadrid,Madrid,591,609,-18
2010,28127,Las Rozas de Madrid,Madrid,1192,1044,148
2010,28129,San Agustín del Guadalix,Madrid,176,132,44
2010,28130,San Fernando de Henares,Madrid,275,418,-143
2010,28131,San Lorenzo de El Escorial,Madrid,237,245,-8
2010,28132,San Martín de la Vega,Madrid,293,300,-7
2010,28134,San Sebastián de los Reyes,Madrid,1129,1001,128
2010,28148,Torrejón de Ardoz,Madrid,1758,1738,20
2010,28152,Torrelodones,Madrid,207,232,-25
2010,28160,Valdemorillo,Madrid,98,119,-21
2010,28161,Valdemoro,Madrid,1232,1131,101
2010,28167,Velilla de San Antonio,Madrid,113,127,-14
2010,28176,Villanueva de la Cañada,Madrid,207,205,2
2010,28177,Villanueva del Pardillo,Madrid,227,216,11
2010,28181,Villaviciosa de Odón,Madrid,319,294,25
2010,28903,Tres Cantos,Madrid,456,402,54
2010,29007,Alhaurín de la Torre,Málaga,368,314,54
2010,29008,Alhaurín el Grande,Málaga,177,133,44
2010,29012,Álora,Málaga,49,50,-1
2010,29015,Antequera,Málaga,396,434,-38
2010,29025,Benalmádena,Málaga,1289,875,414
2010,29038,Cártama,Málaga,189,114,75
2010,29042,Coín,Málaga,213,203,10
2010,29051,Estepona,Málaga,1240,1330,-90
2010,29054,Fuengirola,Málaga,1695,1581,114
2010,29067,Málaga,Málaga,6400,6077,323
2010,29068,Manilva,Málaga,494,391,103
2010,29069,Marbella,Málaga,2610,2356,254
2010,29070,Mijas,Málaga,1206,1014,192
2010,29075,Nerja,Málaga,289,231,58
2010,29082,Rincón de la Victoria,Málaga,554,499,55
2010,29084,Ronda,Málaga,543,614,-71
2010,29091,Torrox,Málaga,357,265,92
2010,29094,Vélez-Málaga,Málaga,1050,798,252
2010,29901,Torremolinos,Málaga,1396,1077,319
2010,30002,Abarán,Murcia,90,109,-19
2010,30003,Águilas,Murcia,584,627,-43
2010,30005,Alcantarilla,Murcia,423,477,-54
2010,30008,Alhama de Murcia,Murcia,214,242,-28
2010,30009,Archena,Murcia,289,422,-133
2010,30010,Beniel,Murcia,232,223,9
2010,30012,Bullas,Murcia,64,122,-58
2010,30013,Calasparra,Murcia,108,155,-47
2010,30015,Caravaca de la Cruz,Murcia,333,319,14
2010,30016,Cartagena,Murcia,2957,2624,333
2010,30017,Cehegín,Murcia,117,146,-29
2010,30018,Ceutí,Murcia,138,94,44
2010,30019,Cieza (Murcia),Murcia,283,269,14
2010,30021,Fuente Álamo de Murcia,Murcia,275,199,76
2010,30022,Jumilla,Murcia,381,434,-53
2010,30024,Lorca,Murcia,1293,1305,-12
2010,30026,Mazarrón,Murcia,457,633,-176
2010,30027,Molina de Segura,Murcia,812,876,-64
2010,30029,Mula,Murcia,215,274,-59
2010,30030,Murcia,Murcia,4678,5178,-500
2010,30033,Puerto Lumbreras,Murcia,193,177,16
2010,30035,San Javier,Murcia,791,722,69
2010,30036,San Pedro del Pinatar,Murcia,603,665,-62
2010,30037,Torre-Pacheco,Murcia,487,481,6
2010,30038,Las Torres de Cotillas,Murcia,202,280,-78
2010,30039,Totana,Murcia,368,309,59
2010,30041,La Unión,Murcia,306,205,101
2010,30043,Yecla,Murcia,417,499,-82
2010,30901,Santomera,Murcia,195,232,-37
2010,30902,Los Alcázares,Murcia,506,419,87
2010,31016,Ansoáin/Antsoain,Navarra,88,74,14
2010,31060,Burlada/Burlata,Navarra,212,166,46
2010,31086,Valle de Egüés,Navarra,134,105,29
2010,31097,Estella-Lizarra,Navarra,236,183,53
2010,31201,Pamplona/Iruña,Navarra,2902,2244,658
2010,31227,Tafalla,Navarra,120,98,22
2010,31232,Tudela,Navarra,820,678,142
2010,31258,Villava/Atarrabia,Navarra,76,64,12
2010,31901,Barañain,Navarra,293,250,43
2010,31907,Zizur Mayor/Zizur Nagusia,Navarra,138,94,44
2010,32009,O Barco de Valdeorras,Ourense,294,279,15
2010,32019,O Carballiño,Ourense,225,215,10
2010,32032,Xinzo de Limia,Ourense,134,117,17
2010,32054,Ourense,Ourense,1735,1877,-142
2010,32085,Verín,Ourense,354,324,30
2010,33002,Aller,Asturias,51,75,-24
2010,33004,Avilés,Asturias,753,802,-49
2010,33011,Cangas del Narcea,Asturias,115,93,22
2010,33014,Carreño,Asturias,121,90,31
2010,33016,Castrillón,Asturias,150,173,-23
2010,33020,Corvera de Asturias,Asturias,136,115,21
2010,33024,Gijón,Asturias,3017,3066,-49
2010,33025,Gozón,Asturias,100,78,22
2010,33026,Grado,Asturias,73,73,0
2010,33031,Langreo,Asturias,297,367,-70
2010,33032,Laviana,Asturias,67,64,3
2010,33033,Lena,Asturias,114,187,-73
2010,33034,Valdés,Asturias,121,78,43
2010,33035,Llanera,Asturias,117,98,19
2010,33036,Llanes,Asturias,199,183,16
2010,33037,Mieres (Asturias),Asturias,281,414,-133
2010,33044,Oviedo,Asturias,2944,3170,-226
2010,33060,San Martín del Rey Aurelio,Asturias,142,156,-14
2010,33066,Siero,Asturias,474,496,-22
2010,33073,Tineo,Asturias,59,65,-6
2010,33076,Villaviciosa,Asturias,150,129,21
2010,34120,Palencia,Palencia,1048,1358,-310
2010,35002,Agüimes,Las Palmas,265,274,-9
2010,35003,Antigua,Las Palmas,268,365,-97
2010,35004,Arrecife,Las Palmas,1244,1669,-425
2010,35006,Arucas,Las Palmas,187,211,-24
2010,35009,Gáldar,Las Palmas,109,142,-33
2010,35011,Ingenio,Las Palmas,231,193,38
2010,35012,Mogán,Las Palmas,258,307,-49
2010,35014,La Oliva,Las Palmas,617,790,-173
2010,35015,Pájara,Las Palmas,560,887,-327
2010,35016,Las Palmas de Gran Canaria,Las Palmas,4833,5410,-577
2010,35017,Puerto del Rosario,Las Palmas,925,1312,-387
2010,35018,San Bartolomé,Las Palmas,339,523,-184
2010,35019,San Bartolomé de Tirajana,Las Palmas,771,758,13
2010,35021,Santa Brígida,Las Palmas,120,137,-17
2010,35022,Santa Lucía de Tirajana,Las Palmas,843,936,-93
2010,35023,Santa María de Guía de Gran Canaria,Las Palmas,48,50,-2
2010,35024,Teguise,Las Palmas,399,409,-10
2010,35026,Telde,Las Palmas,711,782,-71
2010,35027,Teror,Las Palmas,47,57,-10
2010,35028,Tías,Las Palmas,450,537,-87
2010,35030,Tuineje,Las Palmas,207,361,-154
2010,35034,Yaiza,Las Palmas,628,613,15
2010,36003,Baiona,Pontevedra,158,122,36
2010,36004,Bueu,Pontevedra,83,87,-4
2010,36005,Caldas de Reis,Pontevedra,99,111,-12
2010,36006,Cambados,Pontevedra,131,109,22
2010,36008,Cangas,Pontevedra,249,209,40
2010,36017,A Estrada,Pontevedra,229,272,-43
2010,36021,Gondomar,Pontevedra,58,92,-34
2010,36022,O Grove,Pontevedra,92,126,-34
2010,36023,A Guarda,Pontevedra,102,86,16
2010,36024,Lalín,Pontevedra,329,316,13
2010,36026,Marín,Pontevedra,334,361,-27
2010,36029,Moaña,Pontevedra,152,134,18
2010,36033,Mos,Pontevedra,82,89,-7
2010,36035,Nigrán,Pontevedra,167,159,8
2010,36038,Pontevedra,Pontevedra,1127,1053,74
2010,36039,O Porriño,Pontevedra,143,179,-36
2010,36041,Poio,Pontevedra,241,206,35
2010,36042,Ponteareas,Pontevedra,288,260,28
2010,36045,Redondela,Pontevedra,269,279,-10
2010,36051,Sanxenxo,Pontevedra,209,173,36
2010,36054,Tomiño,Pontevedra,113,73,40
2010,36055,Tui,Pontevedra,159,161,-2
2010,36057,Vigo,Pontevedra,3479,3320,159
2010,36060,Vilagarcía de Arousa,Pontevedra,548,544,4
2010,36061,Vilanova de Arousa,Pontevedra,87,80,7
2010,37046,Béjar,Salamanca,231,310,-79
2010,37107,Ciudad Rodrigo,Salamanca,257,213,44
2010,37274,Salamanca,Salamanca,2349,2743,-394
2010,37294,Santa Marta de Tormes,Salamanca,261,254,7
2010,38001,Adeje,Santa Cruz de Tenerife,1028,991,37
2010,38006,Arona,Santa Cruz de Tenerife,1808,2134,-326
2010,38011,Candelaria,Santa Cruz de Tenerife,414,419,-5
2010,38017,Granadilla de Abona,Santa Cruz de Tenerife,883,1071,-188
2010,38019,Guía de Isora,Santa Cruz de Tenerife,180,249,-69
2010,38020,Güímar,Santa Cruz de Tenerife,112,123,-11
2010,38022,Icod de los Vinos,Santa Cruz de Tenerife,104,111,-7
2010,38023,San Cristóbal de La Laguna,Santa Cruz de Tenerife,1398,1630,-232
2010,38024,Los Llanos de Aridane,Santa Cruz de Tenerife,263,252,11
2010,38026,La Orotava,Santa Cruz de Tenerife,208,234,-26
2010,38028,Puerto de la Cruz,Santa Cruz de Tenerife,538,606,-68
2010,38031,Los Realejos,Santa Cruz de Tenerife,176,198,-22
2010,38032,El Rosario,Santa Cruz de Tenerife,181,242,-61
2010,38035,San Miguel de Abona,Santa Cruz de Tenerife,201,279,-78
2010,38037,Santa Cruz de la Palma,Santa Cruz de Tenerife,239,313,-74
2010,38038,Santa Cruz de Tenerife,Santa Cruz de Tenerife,2445,3079,-634
2010,38039,Santa Úrsula,Santa Cruz de Tenerife,94,132,-38
2010,38040,Santiago del Teide,Santa Cruz de Tenerife,102,96,6
2010,38043,Tacoronte,Santa Cruz de Tenerife,118,125,-7
2010,38046,Tegueste,Santa Cruz de Tenerife,43,52,-9
2010,39008,El Astillero,Cantabria,196,183,13
2010,39016,Camargo,Cantabria,261,293,-32
2010,39020,Castro-Urdiales,Cantabria,1577,1432,145
2010,39025,Los Corrales de Buelna,Cantabria,74,75,-1
2010,39035,Laredo,Cantabria,180,211,-31
2010,39052,Piélagos,Cantabria,306,231,75
2010,39059,Reinosa,Cantabria,134,117,17
2010,39073,Santa Cruz de Bezana,Cantabria,126,134,-8
2010,39075,Santander,Cantabria,2173,2439,-266
2010,39079,Santoña,Cantabria,182,238,-56
2010,39087,Torrelavega,Cantabria,547,571,-24
2010,40194,Segovia,Segovia,959,1010,-51
2010,41004,Alcalá de Guadaíra,Sevilla,602,526,76
2010,41005,Alcalá del Río,Sevilla,115,63,52
2010,41007,La Algaba,Sevilla,96,111,-15
2010,41011,Arahal,Sevilla,105,85,20
2010,41017,Bormujos,Sevilla,267,198,69
2010,41018,Brenes,Sevilla,111,75,36
2010,41020,Las Cabezas de San Juan,Sevilla,117,134,-17
2010,41021,Camas,Sevilla,252,240,12
2010,41023,Cantillana,Sevilla,84,91,-7
2010,41024,Carmona,Sevilla,199,218,-19
2010,41029,Castilleja de la Cuesta,Sevilla,237,193,44
2010,41034,Coria del Río,Sevilla,323,273,50
2010,41038,Dos Hermanas,Sevilla,1204,996,208
2010,41039,Écija,Sevilla,363,412,-49
2010,41040,Espartinas,Sevilla,191,173,18
2010,41041,Estepa,Sevilla,88,139,-51
2010,41047,Gines,Sevilla,134,122,12
2010,41049,Guillena,Sevilla,146,91,55
2010,41053,Lebrija,Sevilla,327,245,82
2010,41055,Lora del Río,Sevilla,163,205,-42
2010,41058,Mairena del Alcor,Sevilla,189,149,40
2010,41059,Mairena del Aljarafe,Sevilla,566,404,162
2010,41060,Marchena,Sevilla,102,135,-33
2010,41065,Morón de la Frontera,Sevilla,219,229,-10
2010,41068,Osuna,Sevilla,151,148,3
2010,41069,Los Palacios y Villafranca,Sevilla,188,209,-21
2010,41075,Pilas,Sevilla,102,121,-19
2010,41077,La Puebla de Cazalla,Sevilla,99,111,-12
2010,41079,La Puebla del Río,Sevilla,120,130,-10
2010,41081,La Rinconada,Sevilla,294,263,31
2010,41086,San Juan de Aznalfarache,Sevilla,374,280,94
2010,41087,Sanlúcar la Mayor,Sevilla,178,121,57
2010,41091,Sevilla,Sevilla,8191,7439,752
2010,41093,Tomares,Sevilla,308,293,15
2010,41095,Utrera,Sevilla,445,373,72
2010,41102,El Viso del Alcor,Sevilla,81,86,-5
2010,42173,Soria,Soria,812,801,11
2010,43004,Alcanar,Tarragona,213,227,-14
2010,43014,Amposta,Tarragona,380,337,43
2010,43037,Calafell,Tarragona,1595,1339,256
2010,43038,Cambrils,Tarragona,784,757,27
2010,43051,Cunit,Tarragona,886,680,206
2010,43092,Mont-roig del Camp,Tarragona,424,384,40
2010,43123,Reus,Tarragona,1501,1605,-104
2010,43136,Sant Carles de la Ràpita,Tarragona,357,331,26
2010,43148,Tarragona,Tarragona,2604,2777,-173
2010,43153,Torredembarra,Tarragona,539,523,16
2010,43155,Tortosa,Tarragona,461,645,-184
2010,43161,Valls,Tarragona,369,403,-34
2010,43163,El Vendrell,Tarragona,1388,1351,37
2010,43171,Vila-seca,Tarragona,491,538,-47
2010,43901,Deltebre,Tarragona,141,139,2
2010,43905,Salou,Tarragona,967,870,97
2010,44013,Alcañiz,Teruel,342,282,60
2010,44216,Teruel,Teruel,654,748,-94
2010,45053,Consuegra,Toledo,118,147,-29
2010,45066,Fuensalida,Toledo,374,353,21
2010,45081,Illescas,Toledo,1696,1012,684
2010,45087,Madridejos,Toledo,117,148,-31
2010,45106,Mora,Toledo,120,185,-65
2010,45121,Ocaña,Toledo,900,549,351
2010,45142,Quintanar de la Orden,Toledo,241,327,-86
2010,45161,Seseña,Toledo,2241,1502,739
2010,45163,Sonseca,Toledo,156,206,-50
2010,45165,Talavera de la Reina,Toledo,1526,1787,-261
2010,45168,Toledo,Toledo,2080,1769,311
2010,45173,Torrijos,Toledo,354,317,37
2010,45185,Villacañas,Toledo,150,199,-49
2010,46005,Alaquàs,Valencia,290,309,-19
2010,46007,Albal,Valencia,113,138,-25
2010,46011,Alberic,Valencia,114,133,-19
2010,46013,Alboraya,Valencia,275,222,53
2010,46017,Alzira,Valencia,382,471,-89
2010,46019,L'Alcúdia,Valencia,60,69,-9
2010,46021,Aldaia,Valencia,278,283,-5
2010,46022,Alfafar,Valencia,222,257,-35
2010,46029,Algemesí,Valencia,203,270,-67
2010,46031,Alginet,Valencia,71,119,-48
2010,46051,Benaguasil,Valencia,95,93,2
2010,46054,Benetússer,Valencia,145,180,-35
2010,46060,Benifaió,Valencia,67,101,-34
2010,46070,Bétera,Valencia,240,203,37
2010,46077,Buñol,Valencia,95,120,-25
2010,46078,Burjassot,Valencia,351,360,-9
2010,46081,Canals,Valencia,83,99,-16
2010,46083,Carcaixent,Valencia,137,216,-79
2010,46085,Carlet,Valencia,85,166,-81
2010,46094,Catarroja,Valencia,233,305,-72
2010,46102,Quart de Poblet,Valencia,211,244,-33
2010,46105,Cullera,Valencia,297,351,-54
2010,46110,Xirivella,Valencia,373,429,-56
2010,46111,Chiva,Valencia,138,159,-21
2010,46116,L'Eliana,Valencia,144,169,-25
2010,46131,Gandia,Valencia,1343,1677,-334
2010,46135,Godella,Valencia,118,97,21
2010,46145,Xátiva,Valencia,257,340,-83
2010,46147,Llíria,Valencia,273,255,18
2010,46159,Manises,Valencia,343,355,-12
2010,46164,Massamagrell,Valencia,191,175,16
2010,46166,Meliana,Valencia,110,96,14
2010,46169,Mislata,Valencia,513,696,-183
2010,46171,Moncada,Valencia,173,161,12
2010,46181,Oliva,Valencia,383,522,-139
2010,46184,Ontinyent,Valencia,225,369,-144
2010,46186,Paiporta,Valencia,237,233,4
2010,46190,Paterna,Valencia,805,860,-55
2010,46193,Picanya,Valencia,90,95,-5
2010,46194,Picassent,Valencia,165,158,7
2010,46202,La Pobla de Vallbona,Valencia,209,196,13
2010,46205,Puçol,Valencia,231,294,-63
2010,46213,Requena,Valencia,207,248,-41
2010,46214,Riba-roja de Túria,Valencia,226,190,36
2010,46220,Sagunto/Sagunt,Valencia,1009,1059,-50
2010,46230,Silla,Valencia,194,189,5
2010,46235,Sueca,Valencia,184,225,-41
2010,46238,Tavernes de la Valldigna,Valencia,118,174,-56
2010,46244,Torrent (Valencia),Valencia,907,1034,-127
2010,46249,Utiel,Valencia,112,83,29
2010,46250,València,Valencia,11875,12122,-247
2010,47010,Arroyo de la Encomienda,Valladolid,414,225,189
2010,47076,Laguna de Duero,Valladolid,290,312,-22
2010,47085,Medina del Campo,Valladolid,269,352,-83
2010,47186,Valladolid,Valladolid,4122,4453,-331
2010,48003,Amorebieta-Etxano,Vizcaya,132,137,-5
2010,48011,Arrigorriaga,Vizcaya,104,103,1
2010,48013,Barakaldo,Vizcaya,1098,1114,-16
2010,48015,Basauri,Vizcaya,367,480,-113
2010,48017,Bermeo,Vizcaya,174,106,68
2010,48020,Bilbao,Vizcaya,4788,4485,303
2010,48027,Durango,Vizcaya,278,272,6
2010,48034,Ermua,Vizcaya,240,251,-11
2010,48036,Galdakao,Vizcaya,181,269,-88
2010,48044,Getxo,Vizcaya,833,875,-42
2010,48046,Gernika-Lumo,Vizcaya,138,103,35
2010,48054,Leioa,Vizcaya,255,278,-23
2010,48069,Mungia,Vizcaya,189,135,54
2010,48078,Portugalete,Vizcaya,359,465,-106
2010,48080,Valle de Trápaga-Trapagaran,Vizcaya,66,97,-31
2010,48082,Santurtzi,Vizcaya,521,576,-55
2010,48084,Sestao,Vizcaya,308,298,10
2010,48085,Sopela,Vizcaya,122,102,20
2010,48902,Erandio,Vizcaya,203,243,-40
2010,49021,Benavente,Zamora,367,394,-27
2010,49275,Zamora,Zamora,921,1205,-284
2010,50067,Calatayud,Zaragoza,292,354,-62
2010,50095,Ejea de los Caballeros,Zaragoza,162,208,-46
2010,50251,Tarazona,Zaragoza,169,192,-23
2010,50272,Utebo,Zaragoza,254,211,43
2010,50297,Zaragoza,Zaragoza,8353,8997,-644
2010,51001,Ceuta,Ceuta,2943,2600,343
2010,52001,Melilla,Melilla,3938,2893,1045
2011,01002,Amurrio,Álava,188,136,52
2011,01036,Laudio/Llodio,Álava,349,267,82
2011,01059,Vitoria-Gasteiz,Álava,4921,3573,1348
2011,02003,Albacete,Albacete,2753,2894,-141
2011,02009,Almansa,Albacete,401,465,-64
2011,02025,Caudete,Albacete,280,255,25
2011,02037,Hellín,Albacete,561,598,-37
2011,02069,La Roda,Albacete,184,227,-43
2011,02081,Villarrobledo,Albacete,464,464,0
2011,03005,Albatera,Alicante,79,118,-39
2011,03009,Alcoy/Alcoi,Alicante,551,675,-124
2011,03011,L'Alfàs del Pi,Alicante,281,254,27
2011,03014,Alicante/Alacant,Alicante,5304,5374,-70
2011,03015,Almoradí,Alicante,230,227,3
2011,03018,Altea,Alicante,407,406,1
2011,03019,Aspe,Alicante,151,185,-34
2011,03031,Benidorm,Alicante,2124,1885,239
2011,03041,Benissa,Alicante,126,122,4
2011,03047,Calp,Alicante,373,473,-100
2011,03049,Callosa de Segura,Alicante,184,146,38
2011,03050,El Campello,Alicante,460,401,59
2011,03053,Castalla,Alicante,77,86,-9
2011,03056,Cocentaina,Alicante,156,160,-4
2011,03059,Crevillent,Alicante,268,244,24
2011,03063,Dénia,Alicante,784,965,-181
2011,03065,Elche/Elx,Alicante,2455,2627,-172
2011,03066,Elda,Alicante,468,492,-24
2011,03076,Guardamar del Segura,Alicante,325,305,20
2011,03079,Ibi,Alicante,184,230,-46
2011,03082,Jávea/Xàbia,Alicante,527,418,109
2011,03089,Monóvar/Monòver,Alicante,67,84,-17
2011,03090,Mutxamel,Alicante,159,223,-64
2011,03093,Novelda,Alicante,221,211,10
2011,03094,La Nucia,Alicante,275,224,51
2011,03099,Orihuela,Alicante,1292,1194,98
2011,03102,Pego,Alicante,122,139,-17
2011,03104,Petrer,Alicante,214,218,-4
2011,03113,Rojales,Alicante,115,106,9
2011,03118,San Fulgencio,Alicante,89,98,-9
2011,03119,Sant Joan d'Alacant,Alicante,347,319,28
2011,03121,Santa Pola,Alicante,731,610,121
2011,03122,San Vicente del Raspeig/Sant Vicent del Raspeig,Alicante,531,572,-41
2011,03123,Sax,Alicante,73,71,2
2011,03128,Teulada,Alicante,151,148,3
2011,03133,Torrevieja,Alicante,3036,2987,49
2011,03139,Villajoyosa/La Vila Joiosa,Alicante,670,584,86
2011,03140,Villena,Alicante,446,455,-9
2011,03902,Pilar de la Horadada,Alicante,777,705,72
2011,04003,Adra,Almería,255,311,-56
2011,04006,Albox,Almería,171,182,-11
2011,04013,Almería,Almería,2311,2570,-259
2011,04029,Berja,Almería,86,184,-98
2011,04035,Cuevas del Almanzora,Almería,175,265,-90
2011,04052,Huércal de Almería,Almería,123,185,-62
2011,04053,Huércal-Overa,Almería,325,331,-6
2011,04066,Níjar,Almería,464,890,-426
2011,04079,Roquetas de Mar,Almería,1922,2799,-877
2011,04100,Vera,Almería,373,373,0
2011,04102,Vícar,Almería,437,487,-50
2011,04902,El Ejido,Almería,1449,1716,-267
2011,05019,Ávila,Ávila,987,1349,-362
2011,06011,Almendralejo,Badajoz,441,528,-87
2011,06015,Badajoz,Badajoz,1933,2076,-143
2011,06044,Don Benito,Badajoz,597,504,93
2011,06083,Mérida,Badajoz,910,938,-28
2011,06088,Montijo,Badajoz,194,202,-8
2011,06095,Olivenza,Badajoz,138,142,-4
2011,06149,Villafranca de los Barros,Badajoz,133,120,13
2011,06153,Villanueva de la Serena,Badajoz,364,361,3
2011,06158,Zafra,Badajoz,232,210,22
2011,07003,Alcúdia,Baleares,485,437,48
2011,07005,Andratx,Baleares,113,107,6
2011,07011,Calvià,Baleares,980,954,26
2011,07014,Capdepera,Baleares,264,240,24
2011,07015,Ciutadella de Menorca,Baleares,1187,1173,14
2011,07022,Felanitx,Baleares,174,264,-90
2011,07024,Formentera,Baleares,740,509,231
2011,07026,Eivissa,Baleares,2473,2013,460
2011,07027,Inca,Baleares,364,452,-88
2011,07031,Llucmajor,Baleares,655,665,-10
2011,07032,Maó-Mahón,Baleares,1066,977,89
2011,07033,Manacor,Baleares,533,841,-308
2011,07036,Marratxí,Baleares,241,276,-35
2011,07040,Palma,Baleares,7001,7576,-575
2011,07042,Pollença,Baleares,226,246,-20
2011,07044,Sa Pobla,Baleares,94,154,-60
2011,07046,Sant Antoni de Portmany,Baleares,813,724,89
2011,07048,Sant Josep de sa Talaia,Baleares,1233,936,297
2011,07054,Santa Eulària des Riu,Baleares,1563,1214,349
2011,07055,Santa Margalida,Baleares,246,263,-17
2011,07057,Santanyí,Baleares,268,247,21
2011,07061,Sóller,Baleares,152,150,2
2011,07062,Son Servera,Baleares,235,255,-20
2011,08001,Abrera,Barcelona,113,89,24
2011,08006,Arenys de Mar,Barcelona,171,167,4
2011,08009,Argentona,Barcelona,96,76,20
2011,08015,Badalona,Barcelona,2314,2490,-176
2011,08019,Barcelona,Barcelona,22928,20758,2170
2011,08022,Berga,Barcelona,114,193,-79
2011,08033,Caldes de Montbui,Barcelona,126,139,-13
2011,08035,Calella,Barcelona,213,289,-76
2011,08040,Canet de Mar,Barcelona,128,118,10
2011,08041,Canovelles,Barcelona,138,122,16
2011,08046,Cardedeu,Barcelona,126,131,-5
2011,08051,Castellar del Vallès,Barcelona,152,167,-15
2011,08054,Castellbisbal,Barcelona,81,100,-19
2011,08056,Castelldefels,Barcelona,1025,975,50
2011,08072,Corbera de Llobregat,Barcelona,100,110,-10
2011,08073,Cornellà de Llobregat,Barcelona,828,845,-17
2011,08074,Cubelles,Barcelona,305,315,-10
2011,08076,Esparreguera,Barcelona,173,203,-30
2011,08077,Esplugues de Llobregat,Barcelona,472,482,-10
2011,08086,Les Franqueses del Vallès,Barcelona,185,179,6
2011,08088,La Garriga,Barcelona,103,94,9
2011,08089,Gavà,Barcelona,547,535,12
2011,08096,Granollers,Barcelona,697,639,58
2011,08101,L'Hospitalet de Llobregat,Barcelona,3103,3096,7
2011,08102,Igualada,Barcelona,479,467,12
2011,08105,La Llagosta,Barcelona,93,129,-36
2011,08107,Lliçà d'Amunt,Barcelona,91,86,5
2011,08110,Malgrat de Mar,Barcelona,306,280,26
2011,08112,Manlleu,Barcelona,154,168,-14
2011,08113,Manresa,Barcelona,831,870,-39
2011,08114,Martorell,Barcelona,356,316,40
2011,08118,El Masnou,Barcelona,158,177,-19
2011,08121,Mataró,Barcelona,1258,1379,-121
2011,08123,Molins de Rei,Barcelona,165,235,-70
2011,08124,Mollet del Vallès,Barcelona,462,515,-53
2011,08125,Montcada i Reixac,Barcelona,304,306,-2
2011,08126,Montgat,Barcelona,94,100,-6
2011,08136,Montornès del Vallès,Barcelona,163,153,10
2011,08147,Olesa de Montserrat,Barcelona,227,268,-41
2011,08156,Palau-solità i Plegamans,Barcelona,97,93,4
2011,08157,Pallejà,Barcelona,82,80,2
2011,08159,Parets del Vallès,Barcelona,154,160,-6
2011,08161,Piera,Barcelona,124,130,-6
2011,08163,Pineda de Mar,Barcelona,302,323,-21
2011,08169,El Prat de Llobregat,Barcelona,634,694,-60
2011,08172,Premià de Mar,Barcelona,223,271,-48
2011,08180,Ripollet,Barcelona,339,358,-19
2011,08181,La Roca del Vallès,Barcelona,81,81,0
2011,08184,Rubí,Barcelona,736,769,-33
2011,08187,Sabadell,Barcelona,2067,1969,98
2011,08194,Sant Adrià de Besòs,Barcelona,347,382,-35
2011,08196,Sant Andreu de la Barca,Barcelona,297,302,-5
2011,08197,Sant Andreu de Llavaneres,Barcelona,105,109,-4
2011,08200,Sant Boi de Llobregat,Barcelona,804,804,0
2011,08202,Sant Celoni,Barcelona,260,246,14
2011,08205,Sant Cugat del Vallès,Barcelona,836,844,-8
2011,08211,Sant Feliu de Llobregat,Barcelona,354,367,-13
2011,08217,Sant Joan Despí,Barcelona,279,289,-10
2011,08218,Sant Joan de Vilatorrada,Barcelona,70,70,0
2011,08219,Vilassar de Mar,Barcelona,142,141,1
2011,08221,Sant Just Desvern,Barcelona,66,129,-63
2011,08230,Premià de Dalt,Barcelona,74,82,-8
2011,08231,Sant Pere de Ribes,Barcelona,336,329,7
2011,08238,Sant Quirze del Vallès,Barcelona,100,120,-20
2011,08240,Sant Sadurní d'Anoia,Barcelona,159,123,36
2011,08245,Santa Coloma de Gramenet,Barcelona,1453,1590,-137
2011,08252,Barberà del Vallès,Barcelona,286,311,-25
2011,08260,Santa Perpètua de Mogoda,Barcelona,245,251,-6
2011,08263,Sant Vicenç dels Horts,Barcelona,218,271,-53
2011,08266,Cerdanyola del Vallès,Barcelona,514,508,6
2011,08270,Sitges,Barcelona,405,365,40
2011,08279,Terrassa,Barcelona,2060,2039,21
2011,08284,Tordera,Barcelona,486,365,121
2011,08285,Torelló,Barcelona,79,79,0
2011,08295,Vallirana,Barcelona,128,151,-23
2011,08298,Vic,Barcelona,543,465,78
2011,08301,Viladecans,Barcelona,596,705,-109
2011,08302,Vilanova del Camí,Barcelona,98,85,13
2011,08305,Vilafranca del Penedès,Barcelona,455,445,10
2011,08307,Vilanova i la Geltrú,Barcelona,770,871,-101
2011,08904,Badia del Vallès,Barcelona,128,113,15
2011,09018,Aranda de Duero,Burgos,728,679,49
2011,09059,Burgos,Burgos,2443,2693,-250
2011,09219,Miranda de Ebro,Burgos,758,938,-180
2011,10037,Cáceres,Cáceres,1428,1480,-52
2011,10067,Coria,Cáceres,185,158,27
2011,10121,Miajadas,Cáceres,137,164,-27
2011,10131,Navalmoral de la Mata,Cáceres,354,428,-74
2011,10148,Plasencia,Cáceres,510,685,-175
2011,11004,Algeciras,Cádiz,1626,1995,-369
2011,11006,Arcos de la Frontera,Cádiz,275,389,-114
2011,11007,Barbate,Cádiz,221,261,-40
2011,11008,Los Barrios,Cádiz,323,273,50
2011,11012,Cádiz,Cádiz,1107,1443,-336
2011,11014,Conil de la Frontera,Cádiz,239,249,-10
2011,11015,Chiclana de la Frontera,Cádiz,1064,966,98
2011,11016,Chipiona,Cádiz,217,214,3
2011,11020,Jerez de la Frontera,Cádiz,2470,2548,-78
2011,11021,Jimena de la Frontera,Cádiz,136,175,-39
2011,11022,La Línea de la Concepción,Cádiz,590,647,-57
2011,11023,Medina-Sidonia,Cádiz,61,78,-17
2011,11027,El Puerto de Santa María,Cádiz,1397,1445,-48
2011,11028,Puerto Real,Cádiz,434,401,33
2011,11030,Rota,Cádiz,554,568,-14
2011,11031,San Fernando,Cádiz,1149,1193,-44
2011,11032,Sanlúcar de Barrameda,Cádiz,506,580,-74
2011,11033,San Roque,Cádiz,540,436,104
2011,11035,Tarifa,Cádiz,265,276,-11
2011,11038,Ubrique,Cádiz,152,162,-10
2011,11039,Vejer de la Frontera,Cádiz,98,100,-2
2011,11041,Villamartín,Cádiz,105,152,-47
2011,12005,L'Alcora,Castellón,102,156,-54
2011,12009,Almassora,Castellón,276,363,-87
2011,12027,Benicarló,Castellón,674,705,-31
2011,12028,Benicasim/Benicàssim,Castellón,339,315,24
2011,12032,Borriana/Burriana,Castellón,504,624,-120
2011,12040,Castellón de la Plana/Castelló de la Plana,Castellón,2265,2758,-493
2011,12082,Nules,Castellón,190,231,-41
2011,12084,Onda,Castellón,288,364,-76
2011,12085,Oropesa del Mar/Orpesa,Castellón,409,530,-121
2011,12126,La Vall d'Uixó,Castellón,345,445,-100
2011,12135,Vila-real,Castellón,576,719,-143
2011,12138,Vinaròs,Castellón,807,735,72
2011,13005,Alcázar de San Juan,Ciudad Real,786,661,125
2011,13023,Bolaños de Calatrava,Ciudad Real,105,104,1
2011,13028,Campo de Criptana,Ciudad Real,145,182,-37
2011,13034,Ciudad Real,Ciudad Real,1224,1278,-54
2011,13039,Daimiel,Ciudad Real,205,216,-11
2011,13053,Manzanares,Ciudad Real,281,344,-63
2011,13056,Miguelturra,Ciudad Real,154,195,-41
2011,13071,Puertollano,Ciudad Real,915,978,-63
2011,13078,Socuéllamos,Ciudad Real,254,307,-53
2011,13079,La Solana,Ciudad Real,115,132,-17
2011,13082,Tomelloso,Ciudad Real,629,715,-86
2011,13087,Valdepeñas,Ciudad Real,522,587,-65
2011,13096,Villarrubia de los Ojos,Ciudad Real,92,100,-8
2011,14002,Aguilar de la Frontera,Córdoba,79,92,-13
2011,14007,Baena,Córdoba,247,303,-56
2011,14013,Cabra,Córdoba,161,228,-67
2011,14017,La Carlota,Córdoba,186,195,-9
2011,14021,Córdoba,Córdoba,3746,4241,-495
2011,14030,Fuente Palmera,Córdoba,120,120,0
2011,14038,Lucena,Córdoba,508,698,-190
2011,14042,Montilla,Córdoba,151,197,-46
2011,14049,Palma del Río,Córdoba,272,351,-79
2011,14052,Peñarroya-Pueblonuevo,Córdoba,187,191,-4
2011,14054,Pozoblanco,Córdoba,211,218,-7
2011,14055,Priego de Córdoba,Córdoba,263,301,-38
2011,14056,Puente Genil,Córdoba,346,494,-148
2011,14058,Rute,Córdoba,153,175,-22
2011,15002,Ames,A Coruña,556,477,79
2011,15005,Arteixo,A Coruña,339,327,12
2011,15009,Betanzos,A Coruña,128,111,17
2011,15011,Boiro,A Coruña,212,161,51
2011,15017,Cambre,A Coruña,245,201,44
2011,15019,Carballo,A Coruña,221,214,7
2011,15030,A Coruña,A Coruña,3476,3140,336
2011,15031,Culleredo,A Coruña,315,310,5
2011,15035,Fene,A Coruña,103,124,-21
2011,15036,Ferrol,A Coruña,1197,1232,-35
2011,15041,A Laracha,A Coruña,44,41,3
2011,15054,Narón,A Coruña,452,511,-59
2011,15057,Noia,A Coruña,136,116,20
2011,15058,Oleiros,A Coruña,413,354,59
2011,15059,Ordes,A Coruña,97,97,0
2011,15070,As Pontes de García Rodríguez,A Coruña,96,106,-10
2011,15072,Rianxo,A Coruña,103,95,8
2011,15073,Ribeira,A Coruña,297,316,-19
2011,15075,Sada (A Coruña),A Coruña,213,185,28
2011,15077,Santa Comba,A Coruña,48,44,4
2011,15078,Santiago de Compostela,A Coruña,1629,1407,222
2011,15082,Teo,A Coruña,238,223,15
2011,16078,Cuenca,Cuenca,911,1113,-202
2011,16203,Tarancón,Cuenca,434,482,-48
2011,17015,Banyoles,Girona,219,230,-11
2011,17022,La Bisbal d'Empordà,Girona,129,156,-27
2011,17023,Blanes,Girona,1308,1314,-6
2011,17034,Calonge i Sant Antoni,Girona,229,205,24
2011,17047,Castelló d'Empúries,Girona,206,201,5
2011,17048,Castell-Platja d'Aro,Girona,268,278,-10
2011,17062,L'Escala,Girona,162,205,-43
2011,17066,Figueres,Girona,804,809,-5
2011,17079,Girona,Girona,1827,1851,-24
2011,17095,Lloret de Mar,Girona,1019,1257,-238
2011,17114,Olot,Girona,449,563,-114
2011,17117,Palafrugell,Girona,296,334,-38
2011,17118,Palamós,Girona,329,302,27
2011,17147,Ripoll,Girona,165,203,-38
2011,17152,Roses,Girona,356,388,-32
2011,17155,Salt,Girona,455,696,-241
2011,17160,Sant Feliu de Guíxols,Girona,362,406,-44
2011,17180,Santa Coloma de Farners,Girona,179,198,-19
2011,17199,Torroella de Montgrí,Girona,203,176,27
2011,18003,Albolote,Granada,197,202,-5
2011,18017,Almuñécar,Granada,445,481,-36
2011,18021,Armilla,Granada,529,524,5
2011,18022,Atarfe,Granada,254,260,-6
2011,18023,Baza,Granada,392,425,-33
2011,18062,Churriana de la Vega,Granada,236,222,14
2011,18087,Granada,Granada,4226,4565,-339
2011,18089,Guadix,Granada,303,311,-8
2011,18100,Huétor Tájar,Granada,146,129,17
2011,18101,Huétor Vega,Granada,129,138,-9
2011,18102,Illora,Granada,83,70,13
2011,18122,Loja,Granada,291,328,-37
2011,18127,Maracena,Granada,255,266,-11
2011,18140,Motril,Granada,636,782,-146
2011,18145,Ogíjares,Granada,138,181,-43
2011,18153,Peligros,Granada,99,133,-34
2011,18158,Pinos Puente,Granada,100,132,-32
2011,18173,Salobreña,Granada,143,198,-55
2011,18175,Santa Fe,Granada,184,166,18
2011,18193,La Zubia,Granada,260,281,-21
2011,18905,Las Gabias,Granada,322,341,-19
2011,19024,Alovera,Guadalajara,596,432,164
2011,19046,Azuqueca de Henares,Guadalajara,2141,1594,547
2011,19071,El Casar,Guadalajara,830,628,202
2011,19130,Guadalajara,Guadalajara,2379,2048,331
2011,20009,Andoain,Guipúzcoa,115,127,-12
2011,20017,Azkoitia,Guipúzcoa,87,87,0
2011,20018,Azpeitia,Guipúzcoa,116,68,48
2011,20019,Beasain,Guipúzcoa,183,144,39
2011,20030,Eibar,Guipúzcoa,508,392,116
2011,20032,Elgoibar,Guipúzcoa,128,122,6
2011,20036,Hondarribia,Guipúzcoa,167,120,47
2011,20040,Hernani,Guipúzcoa,120,96,24
2011,20045,Irun,Guipúzcoa,858,799,59
2011,20055,Arrasate/Mondragón,Guipúzcoa,294,266,28
2011,20059,Oñati,Guipúzcoa,66,68,-2
2011,20063,Oiartzun,Guipúzcoa,61,52,9
2011,20064,Pasaia,Guipúzcoa,142,115,27
2011,20067,Errenteria,Guipúzcoa,339,277,62
2011,20069,Donostia/San Sebastián,Guipúzcoa,2211,2156,55
2011,20071,Tolosa,Guipúzcoa,160,105,55
2011,20074,Bergara,Guipúzcoa,176,116,60
2011,20079,Zarautz,Guipúzcoa,204,207,-3
2011,20080,Zumarraga,Guipúzcoa,77,101,-24
2011,20902,Lasarte-Oria,Guipúzcoa,197,184,13
2011,21002,Aljaraque,Huelva,216,223,-7
2011,21005,Almonte,Huelva,347,315,32
2011,21010,Ayamonte,Huelva,291,274,17
2011,21013,Bollullos Par del Condado,Huelva,118,104,14
2011,21021,Cartaya,Huelva,265,284,-19
2011,21035,Gibraleón,Huelva,116,124,-8
2011,21041,Huelva,Huelva,1530,1906,-376
2011,21042,Isla Cristina,Huelva,281,357,-76
2011,21044,Lepe,Huelva,362,504,-142
2011,21050,Moguer,Huelva,305,360,-55
2011,21054,La Palma del Condado,Huelva,95,123,-28
2011,21060,Punta Umbría,Huelva,225,227,-2
2011,21072,Valverde del Camino,Huelva,75,77,-2
2011,22048,Barbastro,Huesca,297,324,-27
2011,22112,Fraga,Huesca,340,356,-16
2011,22125,Huesca,Huesca,973,1169,-196
2011,22130,Jaca,Huesca,412,435,-23
2011,22158,Monzón,Huesca,232,352,-120
2011,22199,Sabiñánigo,Huesca,216,311,-95
2011,23002,Alcalá la Real,Jaén,446,388,58
2011,23003,Alcaudete,Jaén,133,200,-67
2011,23005,Andújar,Jaén,626,653,-27
2011,23009,Baeza,Jaén,299,235,64
2011,23010,Bailén,Jaén,163,229,-66
2011,23024,La Carolina,Jaén,209,275,-66
2011,23050,Jaén,Jaén,1349,1576,-227
2011,23053,Jódar,Jaén,101,101,0
2011,23055,Linares,Jaén,770,883,-113
2011,23058,Mancha Real,Jaén,145,105,40
2011,23060,Martos,Jaén,225,246,-21
2011,23086,Torredelcampo,Jaén,88,125,-37
2011,23087,Torredonjimeno,Jaén,159,176,-17
2011,23092,Úbeda,Jaén,602,543,59
2011,23095,Villacarrillo,Jaén,235,168,67
2011,24008,Astorga,León,180,218,-38
2011,24010,La Bañeza,León,155,120,35
2011,24014,Bembibre,León,109,185,-76
2011,24089,León,León,1989,2305,-316
2011,24115,Ponferrada,León,1072,1038,34
2011,24142,San Andrés del Rabanedo,León,433,432,1
2011,24202,Villablino,León,95,168,-73
2011,24222,Villaquilambre,León,223,258,-35
2011,25040,Balaguer,Lleida,315,275,40
2011,25120,Lleida,Lleida,2783,2977,-194
2011,25137,Mollerussa,Lleida,253,329,-76
2011,25203,La Seu d'Urgell,Lleida,300,343,-43
2011,25217,Tàrrega,Lleida,272,382,-110
2011,26018,Arnedo,La Rioja,205,173,32
2011,26036,Calahorra,La Rioja,490,508,-18
2011,26071,Haro,La Rioja,273,313,-40
2011,26089,Logroño,La Rioja,2534,2723,-189
2011,27028,Lugo,Lugo,1515,1521,-6
2011,27031,Monforte de Lemos,Lugo,390,397,-7
2011,27051,Ribadeo,Lugo,288,240,48
2011,27057,Sarria,Lugo,138,174,-36
2011,27065,Vilalba,Lugo,154,128,26
2011,27066,Viveiro,Lugo,265,270,-5
2011,28005,Alcalá de Henares,Madrid,3492,4137,-645
2011,28006,Alcobendas,Madrid,1495,1305,190
2011,28007,Alcorcón,Madrid,1768,2004,-236
2011,28009,Algete,Madrid,230,310,-80
2011,28010,Alpedrete,Madrid,167,149,18
2011,28013,Aranjuez,Madrid,1404,1215,189
2011,28014,Arganda del Rey,Madrid,695,688,7
2011,28015,Arroyomolinos (Madrid),Madrid,284,251,33
2011,28022,Boadilla del Monte,Madrid,526,407,119
2011,28040,Ciempozuelos,Madrid,367,355,12
2011,28045,Colmenar Viejo,Madrid,653,490,163
2011,28047,Collado Villalba,Madrid,815,768,47
2011,28049,Coslada,Madrid,816,912,-96
2011,28054,El Escorial,Madrid,129,155,-26
2011,28058,Fuenlabrada,Madrid,2812,3630,-818
2011,28061,Galapagar,Madrid,398,404,-6
2011,28065,Getafe,Madrid,2341,2391,-50
2011,28068,Guadarrama,Madrid,175,161,14
2011,28073,Humanes de Madrid,Madrid,392,449,-57
2011,28074,Leganés,Madrid,2279,2430,-151
2011,28079,Madrid,Madrid,54774,45234,9540
2011,28080,Majadahonda,Madrid,816,879,-63
2011,28083,Meco,Madrid,207,279,-72
2011,28084,Mejorada del Campo,Madrid,241,237,4
2011,28090,Moralzarzal,Madrid,86,101,-15
2011,28092,Móstoles,Madrid,2960,2889,71
2011,28096,Navalcarnero,Madrid,477,426,51
2011,28104,Paracuellos de Jarama,Madrid,381,225,156
2011,28106,Parla,Madrid,2054,2576,-522
2011,28113,Pinto,Madrid,771,664,107
2011,28115,Pozuelo de Alarcón,Madrid,998,789,209
2011,28123,Rivas-Vaciamadrid,Madrid,642,627,15
2011,28127,Las Rozas de Madrid,Madrid,1073,983,90
2011,28129,San Agustín del Guadalix,Madrid,158,175,-17
2011,28130,San Fernando de Henares,Madrid,333,339,-6
2011,28131,San Lorenzo de El Escorial,Madrid,275,273,2
2011,28132,San Martín de la Vega,Madrid,265,295,-30
2011,28134,San Sebastián de los Reyes,Madrid,1173,998,175
2011,28148,Torrejón de Ardoz,Madrid,1797,1813,-16
2011,28152,Torrelodones,Madrid,250,225,25
2011,28160,Valdemorillo,Madrid,145,113,32
2011,28161,Valdemoro,Madrid,1163,1225,-62
2011,28167,Velilla de San Antonio,Madrid,110,119,-9
2011,28172,Villalbilla,Madrid,154,121,33
2011,28176,Villanueva de la Cañada,Madrid,260,196,64
2011,28177,Villanueva del Pardillo,Madrid,163,166,-3
2011,28181,Villaviciosa de Odón,Madrid,342,343,-1
2011,28903,Tres Cantos,Madrid,488,406,82
2011,29007,Alhaurín de la Torre,Málaga,335,302,33
2011,29008,Alhaurín el Grande,Málaga,196,151,45
2011,29012,Álora,Málaga,67,86,-19
2011,29015,Antequera,Málaga,354,413,-59
2011,29025,Benalmádena,Málaga,1404,907,497
2011,29038,Cártama,Málaga,195,160,35
2011,29042,Coín,Málaga,183,169,14
2011,29051,Estepona,Málaga,1264,1132,132
2011,29054,Fuengirola,Málaga,1758,1314,444
2011,29067,Málaga,Málaga,6769,5882,887
2011,29068,Manilva,Málaga,505,360,145
2011,29069,Marbella,Málaga,2739,2130,609
2011,29070,Mijas,Málaga,1277,1030,247
2011,29075,Nerja,Málaga,335,269,66
2011,29082,Rincón de la Victoria,Málaga,599,429,170
2011,29084,Ronda,Málaga,611,578,33
2011,29091,Torrox,Málaga,342,261,81
2011,29094,Vélez-Málaga,Málaga,1135,795,340
2011,29901,Torremolinos,Málaga,1278,1092,186
2011,30002,Abarán,Murcia,101,107,-6
2011,30003,Águilas,Murcia,654,591,63
2011,30005,Alcantarilla,Murcia,406,477,-71
2011,30008,Alhama de Murcia,Murcia,244,223,21
2011,30009,Archena,Murcia,383,379,4
2011,30010,Beniel,Murcia,209,169,40
2011,30012,Bullas,Murcia,64,79,-15
2011,30013,Calasparra,Murcia,119,124,-5
2011,30015,Caravaca de la Cruz,Murcia,303,325,-22
2011,30016,Cartagena,Murcia,2937,2960,-23
2011,30017,Cehegín,Murcia,79,114,-35
2011,30018,Ceutí,Murcia,118,150,-32
2011,30019,Cieza (Murcia),Murcia,299,295,4
2011,30020,Fortuna,Murcia,120,114,6
2011,30021,Fuente Álamo de Murcia,Murcia,198,248,-50
2011,30022,Jumilla,Murcia,334,425,-91
2011,30024,Lorca,Murcia,1304,1231,73
2011,30026,Mazarrón,Murcia,438,603,-165
2011,30027,Molina de Segura,Murcia,876,819,57
2011,30029,Mula,Murcia,241,235,6
2011,30030,Murcia,Murcia,4683,5011,-328
2011,30033,Puerto Lumbreras,Murcia,244,182,62
2011,30035,San Javier,Murcia,764,851,-87
2011,30036,San Pedro del Pinatar,Murcia,706,669,37
2011,30037,Torre-Pacheco,Murcia,360,513,-153
2011,30038,Las Torres de Cotillas,Murcia,196,200,-4
2011,30039,Totana,Murcia,400,256,144
2011,30041,La Unión,Murcia,200,247,-47
2011,30043,Yecla,Murcia,397,466,-69
2011,30901,Santomera,Murcia,212,196,16
2011,30902,Los Alcázares,Murcia,392,525,-133
2011,31016,Ansoáin/Antsoain,Navarra,113,69,44
2011,31060,Burlada/Burlata,Navarra,210,191,19
2011,31086,Valle de Egüés,Navarra,160,96,64
2011,31097,Estella-Lizarra,Navarra,195,209,-14
2011,31201,Pamplona/Iruña,Navarra,3011,2362,649
2011,31227,Tafalla,Navarra,81,97,-16
2011,31232,Tudela,Navarra,794,767,27
2011,31258,Villava/Atarrabia,Navarra,75,62,13
2011,31901,Barañain,Navarra,270,218,52
2011,31907,Zizur Mayor/Zizur Nagusia,Navarra,159,120,39
2011,32009,O Barco de Valdeorras,Ourense,272,313,-41
2011,32019,O Carballiño,Ourense,208,201,7
2011,32032,Xinzo de Limia,Ourense,144,143,1
2011,32054,Ourense,Ourense,1812,1855,-43
2011,32085,Verín,Ourense,354,291,63
2011,33002,Aller,Asturias,86,86,0
2011,33004,Avilés,Asturias,765,741,24
2011,33011,Cangas del Narcea,Asturias,103,93,10
2011,33014,Carreño,Asturias,117,79,38
2011,33016,Castrillón,Asturias,190,173,17
2011,33020,Corvera de Asturias,Asturias,129,136,-7
2011,33024,Gijón,Asturias,3202,3026,176
2011,33025,Gozón,Asturias,74,75,-1
2011,33026,Grado,Asturias,60,64,-4
2011,33031,Langreo,Asturias,321,331,-10
2011,33032,Laviana,Asturias,75,84,-9
2011,33033,Lena,Asturias,150,142,8
2011,33034,Valdés,Asturias,128,92,36
2011,33035,Llanera,Asturias,129,131,-2
2011,33036,Llanes,Asturias,208,194,14
2011,33037,Mieres (Asturias),Asturias,348,300,48
2011,33044,Oviedo,Asturias,2849,3078,-229
2011,33060,San Martín del Rey Aurelio,Asturias,112,146,-34
2011,33066,Siero,Asturias,542,500,42
2011,33073,Tineo,Asturias,61,58,3
2011,33076,Villaviciosa,Asturias,140,144,-4
2011,34120,Palencia,Palencia,1035,1289,-254
2011,35002,Agüimes,Las Palmas,277,292,-15
2011,35003,Antigua,Las Palmas,380,310,70
2011,35004,Arrecife,Las Palmas,1354,1452,-98
2011,35006,Arucas,Las Palmas,228,213,15
2011,35009,Gáldar,Las Palmas,130,118,12
2011,35011,Ingenio,Las Palmas,266,238,28
2011,35012,Mogán,Las Palmas,316,279,37
2011,35014,La Oliva,Las Palmas,908,793,115
2011,35015,Pájara,Las Palmas,689,768,-79
2011,35016,Las Palmas de Gran Canaria,Las Palmas,5161,5679,-518
2011,35017,Puerto del Rosario,Las Palmas,974,1109,-135
2011,35018,San Bartolomé,Las Palmas,475,493,-18
2011,35019,San Bartolomé de Tirajana,Las Palmas,905,824,81
2011,35021,Santa Brígida,Las Palmas,163,143,20
2011,35022,Santa Lucía de Tirajana,Las Palmas,908,1006,-98
2011,35023,Santa María de Guía de Gran Canaria,Las Palmas,63,78,-15
2011,35024,Teguise,Las Palmas,514,418,96
2011,35026,Telde,Las Palmas,636,810,-174
2011,35027,Teror,Las Palmas,56,61,-5
2011,35028,Tías,Las Palmas,496,509,-13
2011,35030,Tuineje,Las Palmas,332,286,46
2011,35034,Yaiza,Las Palmas,823,676,147
2011,36003,Baiona,Pontevedra,124,108,16
2011,36004,Bueu,Pontevedra,79,92,-13
2011,36005,Caldas de Reis,Pontevedra,112,121,-9
2011,36006,Cambados,Pontevedra,118,107,11
2011,36008,Cangas,Pontevedra,217,217,0
2011,36017,A Estrada,Pontevedra,246,275,-29
2011,36021,Gondomar,Pontevedra,64,69,-5
2011,36022,O Grove,Pontevedra,138,111,27
2011,36023,A Guarda,Pontevedra,80,95,-15
2011,36024,Lalín,Pontevedra,302,384,-82
2011,36026,Marín,Pontevedra,211,369,-158
2011,36029,Moaña,Pontevedra,116,134,-18
2011,36033,Mos,Pontevedra,104,81,23
2011,36035,Nigrán,Pontevedra,131,132,-1
2011,36038,Pontevedra,Pontevedra,1243,1210,33
2011,36039,O Porriño,Pontevedra,102,190,-88
2011,36041,Poio,Pontevedra,224,210,14
2011,36042,Ponteareas,Pontevedra,238,246,-8
2011,36045,Redondela,Pontevedra,214,235,-21
2011,36051,Sanxenxo,Pontevedra,212,209,3
2011,36054,Tomiño,Pontevedra,97,78,19
2011,36055,Tui,Pontevedra,172,174,-2
2011,36057,Vigo,Pontevedra,3612,3475,137
2011,36060,Vilagarcía de Arousa,Pontevedra,458,503,-45
2011,36061,Vilanova de Arousa,Pontevedra,83,94,-11
2011,37046,Béjar,Salamanca,242,274,-32
2011,37107,Ciudad Rodrigo,Salamanca,227,237,-10
2011,37274,Salamanca,Salamanca,2278,2795,-517
2011,37294,Santa Marta de Tormes,Salamanca,247,297,-50
2011,38001,Adeje,Santa Cruz de Tenerife,1116,956,160
2011,38006,Arona,Santa Cruz de Tenerife,1976,1943,33
2011,38011,Candelaria,Santa Cruz de Tenerife,405,423,-18
2011,38017,Granadilla de Abona,Santa Cruz de Tenerife,912,975,-63
2011,38019,Guía de Isora,Santa Cruz de Tenerife,281,228,53
2011,38020,Güímar,Santa Cruz de Tenerife,141,135,6
2011,38022,Icod de los Vinos,Santa Cruz de Tenerife,111,116,-5
2011,38023,San Cristóbal de La Laguna,Santa Cruz de Tenerife,1460,1661,-201
2011,38024,Los Llanos de Aridane,Santa Cruz de Tenerife,245,258,-13
2011,38026,La Orotava,Santa Cruz de Tenerife,191,244,-53
2011,38028,Puerto de la Cruz,Santa Cruz de Tenerife,543,557,-14
2011,38031,Los Realejos,Santa Cruz de Tenerife,126,165,-39
2011,38032,El Rosario,Santa Cruz de Tenerife,186,214,-28
2011,38035,San Miguel de Abona,Santa Cruz de Tenerife,250,238,12
2011,38037,Santa Cruz de la Palma,Santa Cruz de Tenerife,281,338,-57
2011,38038,Santa Cruz de Tenerife,Santa Cruz de Tenerife,2517,2851,-334
2011,38039,Santa Úrsula,Santa Cruz de Tenerife,157,163,-6
2011,38040,Santiago del Teide,Santa Cruz de Tenerife,132,128,4
2011,38043,Tacoronte,Santa Cruz de Tenerife,100,142,-42
2011,38046,Tegueste,Santa Cruz de Tenerife,82,56,26
2011,39008,El Astillero,Cantabria,193,185,8
2011,39016,Camargo,Cantabria,286,282,4
2011,39020,Castro-Urdiales,Cantabria,1547,1595,-48
2011,39025,Los Corrales de Buelna,Cantabria,75,80,-5
2011,39035,Laredo,Cantabria,207,209,-2
2011,39052,Piélagos,Cantabria,334,247,87
2011,39059,Reinosa,Cantabria,118,130,-12
2011,39073,Santa Cruz de Bezana,Cantabria,123,96,27
2011,39075,Santander,Cantabria,2225,2314,-89
2011,39079,Santoña,Cantabria,223,210,13
2011,39087,Torrelavega,Cantabria,603,628,-25
2011,40194,Segovia,Segovia,995,1178,-183
2011,41004,Alcalá de Guadaíra,Sevilla,541,556,-15
2011,41005,Alcalá del Río,Sevilla,95,94,1
2011,41007,La Algaba,Sevilla,108,105,3
2011,41011,Arahal,Sevilla,109,94,15
2011,41017,Bormujos,Sevilla,293,196,97
2011,41018,Brenes,Sevilla,126,133,-7
2011,41020,Las Cabezas de San Juan,Sevilla,134,157,-23
2011,41021,Camas,Sevilla,262,223,39
2011,41023,Cantillana,Sevilla,101,84,17
2011,41024,Carmona,Sevilla,170,226,-56
2011,41029,Castilleja de la Cuesta,Sevilla,190,165,25
2011,41034,Coria del Río,Sevilla,284,255,29
2011,41038,Dos Hermanas,Sevilla,1163,1111,52
2011,41039,Écija,Sevilla,364,489,-125
2011,41040,Espartinas,Sevilla,214,162,52
2011,41041,Estepa,Sevilla,112,128,-16
2011,41047,Gines,Sevilla,161,83,78
2011,41049,Guillena,Sevilla,124,112,12
2011,41053,Lebrija,Sevilla,261,203,58
2011,41055,Lora del Río,Sevilla,156,213,-57
2011,41058,Mairena del Alcor,Sevilla,185,197,-12
2011,41059,Mairena del Aljarafe,Sevilla,628,581,47
2011,41060,Marchena,Sevilla,123,108,15
2011,41065,Morón de la Frontera,Sevilla,218,259,-41
2011,41068,Osuna,Sevilla,128,147,-19
2011,41069,Los Palacios y Villafranca,Sevilla,197,233,-36
2011,41075,Pilas,Sevilla,120,141,-21
2011,41077,La Puebla de Cazalla,Sevilla,119,163,-44
2011,41079,La Puebla del Río,Sevilla,69,108,-39
2011,41081,La Rinconada,Sevilla,259,279,-20
2011,41086,San Juan de Aznalfarache,Sevilla,348,345,3
2011,41087,Sanlúcar la Mayor,Sevilla,132,135,-3
2011,41091,Sevilla,Sevilla,7903,7537,366
2011,41093,Tomares,Sevilla,337,300,37
2011,41095,Utrera,Sevilla,504,455,49
2011,41102,El Viso del Alcor,Sevilla,90,87,3
2011,42173,Soria,Soria,764,827,-63
2011,43004,Alcanar,Tarragona,246,240,6
2011,43014,Amposta,Tarragona,343,439,-96
2011,43037,Calafell,Tarragona,1326,1354,-28
2011,43038,Cambrils,Tarragona,741,749,-8
2011,43051,Cunit,Tarragona,884,774,110
2011,43092,Mont-roig del Camp,Tarragona,346,353,-7
2011,43123,Reus,Tarragona,1540,1618,-78
2011,43136,Sant Carles de la Ràpita,Tarragona,298,368,-70
2011,43148,Tarragona,Tarragona,2321,2425,-104
2011,43153,Torredembarra,Tarragona,438,431,7
2011,43155,Tortosa,Tarragona,424,601,-177
2011,43161,Valls,Tarragona,346,371,-25
2011,43163,El Vendrell,Tarragona,1195,1313,-118
2011,43171,Vila-seca,Tarragona,443,486,-43
2011,43901,Deltebre,Tarragona,148,165,-17
2011,43905,Salou,Tarragona,885,856,29
2011,44013,Alcañiz,Teruel,248,308,-60
2011,44216,Teruel,Teruel,608,676,-68
2011,45053,Consuegra,Toledo,80,114,-34
2011,45066,Fuensalida,Toledo,384,365,19
2011,45081,Illescas,Toledo,1622,1092,530
2011,45087,Madridejos,Toledo,141,194,-53
2011,45106,Mora,Toledo,110,180,-70
2011,45121,Ocaña,Toledo,877,692,185
2011,45142,Quintanar de la Orden,Toledo,224,322,-98
2011,45161,Seseña,Toledo,1877,1539,338
2011,45163,Sonseca,Toledo,198,202,-4
2011,45165,Talavera de la Reina,Toledo,1585,1859,-274
2011,45168,Toledo,Toledo,1985,1902,83
2011,45173,Torrijos,Toledo,290,328,-38
2011,45185,Villacañas,Toledo,105,189,-84
2011,45205,Yuncos,Toledo,780,535,245
2011,46005,Alaquàs,Valencia,243,315,-72
2011,46007,Albal,Valencia,113,142,-29
2011,46011,Alberic,Valencia,104,156,-52
2011,46013,Alboraya,Valencia,255,231,24
2011,46017,Alzira,Valencia,410,457,-47
2011,46019,L'Alcúdia,Valencia,64,84,-20
2011,46021,Aldaia,Valencia,296,292,4
2011,46022,Alfafar,Valencia,197,232,-35
2011,46029,Algemesí,Valencia,228,265,-37
2011,46031,Alginet,Valencia,106,103,3
2011,46051,Benaguasil,Valencia,80,122,-42
2011,46054,Benetússer,Valencia,125,152,-27
2011,46060,Benifaió,Valencia,57,78,-21
2011,46070,Bétera,Valencia,288,219,69
2011,46078,Burjassot,Valencia,363,376,-13
2011,46081,Canals,Valencia,77,105,-28
2011,46083,Carcaixent,Valencia,144,160,-16
2011,46085,Carlet,Valencia,64,96,-32
2011,46094,Catarroja,Valencia,253,277,-24
2011,46102,Quart de Poblet,Valencia,231,228,3
2011,46105,Cullera,Valencia,223,344,-121
2011,46110,Xirivella,Valencia,324,370,-46
2011,46111,Chiva,Valencia,146,141,5
2011,46116,L'Eliana,Valencia,193,164,29
2011,46131,Gandia,Valencia,1154,1489,-335
2011,46135,Godella,Valencia,105,103,2
2011,46145,Xátiva,Valencia,225,268,-43
2011,46147,Llíria,Valencia,240,221,19
2011,46159,Manises,Valencia,377,293,84
2011,46164,Massamagrell,Valencia,162,156,6
2011,46166,Meliana,Valencia,99,87,12
2011,46169,Mislata,Valencia,526,550,-24
2011,46171,Moncada,Valencia,133,165,-32
2011,46181,Oliva,Valencia,408,468,-60
2011,46184,Ontinyent,Valencia,294,378,-84
2011,46186,Paiporta,Valencia,227,249,-22
2011,46190,Paterna,Valencia,719,744,-25
2011,46193,Picanya,Valencia,89,100,-11
2011,46194,Picassent,Valencia,164,202,-38
2011,46202,La Pobla de Vallbona,Valencia,288,250,38
2011,46205,Puçol,Valencia,216,229,-13
2011,46213,Requena,Valencia,189,200,-11
2011,46214,Riba-roja de Túria,Valencia,202,187,15
2011,46220,Sagunto/Sagunt,Valencia,832,1074,-242
2011,46223,Sedaví,Valencia,93,102,-9
2011,46230,Silla,Valencia,189,211,-22
2011,46235,Sueca,Valencia,213,210,3
2011,46238,Tavernes de la Valldigna,Valencia,124,173,-49
2011,46244,Torrent (Valencia),Valencia,898,873,25
2011,46249,Utiel,Valencia,74,105,-31
2011,46250,València,Valencia,11446,11613,-167
2011,47010,Arroyo de la Encomienda,Valladolid,414,272,142
2011,47076,Laguna de Duero,Valladolid,279,277,2
2011,47085,Medina del Campo,Valladolid,290,319,-29
2011,47186,Valladolid,Valladolid,4429,4544,-115
2011,48003,Amorebieta-Etxano,Vizcaya,157,123,34
2011,48011,Arrigorriaga,Vizcaya,107,126,-19
2011,48013,Barakaldo,Vizcaya,1337,1086,251
2011,48015,Basauri,Vizcaya,344,386,-42
2011,48017,Bermeo,Vizcaya,202,119,83
2011,48020,Bilbao,Vizcaya,5225,4230,995
2011,48027,Durango,Vizcaya,420,267,153
2011,48029,Etxebarri,Vizcaya,69,76,-7
2011,48034,Ermua,Vizcaya,252,299,-47
2011,48036,Galdakao,Vizcaya,201,198,3
2011,48044,Getxo,Vizcaya,960,915,45
2011,48046,Gernika-Lumo,Vizcaya,162,106,56
2011,48054,Leioa,Vizcaya,277,287,-10
2011,48069,Mungia,Vizcaya,227,148,79
2011,48078,Portugalete,Vizcaya,390,392,-2
2011,48080,Valle de Trápaga-Trapagaran,Vizcaya,96,90,6
2011,48082,Santurtzi,Vizcaya,524,496,28
2011,48084,Sestao,Vizcaya,335,302,33
2011,48085,Sopela,Vizcaya,132,113,19
2011,48902,Erandio,Vizcaya,248,203,45
2011,49021,Benavente,Zamora,374,425,-51
2011,49275,Zamora,Zamora,992,1174,-182
2011,50067,Calatayud,Zaragoza,702,550,152
2011,50095,Ejea de los Caballeros,Zaragoza,168,206,-38
2011,50251,Tarazona,Zaragoza,171,201,-30
2011,50272,Utebo,Zaragoza,232,202,30
2011,50297,Zaragoza,Zaragoza,9410,8849,561
2011,51001,Ceuta,Ceuta,2768,2543,225
2011,52001,Melilla,Melilla,4147,3127,1020
2012,01002,Amurrio,Álava,183,164,19
2012,01036,Laudio/Llodio,Álava,343,318,25
2012,01059,Vitoria-Gasteiz,Álava,4151,3358,793
2012,02003,Albacete,Albacete,2574,2772,-198
2012,02009,Almansa,Albacete,398,445,-47
2012,02025,Caudete,Albacete,225,293,-68
2012,02037,Hellín,Albacete,449,628,-179
2012,02069,La Roda,Albacete,242,240,2
2012,02081,Villarrobledo,Albacete,434,461,-27
2012,03005,Albatera,Alicante,114,92,22
2012,03009,Alcoy/Alcoi,Alicante,523,629,-106
2012,03011,L'Alfàs del Pi,Alicante,302,249,53
2012,03014,Alicante/Alacant,Alicante,5122,5322,-200
2012,03015,Almoradí,Alicante,304,279,25
2012,03018,Altea,Alicante,367,332,35
2012,03019,Aspe,Alicante,190,172,18
2012,03031,Benidorm,Alicante,2047,1872,175
2012,03041,Benissa,Alicante,110,98,12
2012,03047,Calp,Alicante,447,386,61
2012,03049,Callosa de Segura,Alicante,180,142,38
2012,03050,El Campello,Alicante,457,367,90
2012,03053,Castalla,Alicante,71,88,-17
2012,03056,Cocentaina,Alicante,135,105,30
2012,03059,Crevillent,Alicante,235,203,32
2012,03063,Dénia,Alicante,926,851,75
2012,03065,Elche/Elx,Alicante,2552,2443,109
2012,03066,Elda,Alicante,443,530,-87
2012,03076,Guardamar del Segura,Alicante,293,312,-19
2012,03079,Ibi,Alicante,204,171,33
2012,03082,Jávea/Xàbia,Alicante,431,462,-31
2012,03089,Monóvar/Monòver,Alicante,63,88,-25
2012,03090,Mutxamel,Alicante,261,239,22
2012,03093,Novelda,Alicante,167,189,-22
2012,03094,La Nucia,Alicante,222,252,-30
2012,03099,Orihuela,Alicante,1435,1151,284
2012,03102,Pego,Alicante,110,159,-49
2012,03104,Petrer,Alicante,224,221,3
2012,03113,Rojales,Alicante,134,102,32
2012,03118,San Fulgencio,Alicante,99,83,16
2012,03119,Sant Joan d'Alacant,Alicante,312,262,50
2012,03121,Santa Pola,Alicante,602,607,-5
2012,03122,San Vicente del Raspeig/Sant Vicent del Raspeig,Alicante,537,540,-3
2012,03123,Sax,Alicante,68,69,-1
2012,03128,Teulada,Alicante,150,125,25
2012,03133,Torrevieja,Alicante,3098,2804,294
2012,03139,Villajoyosa/La Vila Joiosa,Alicante,616,586,30
2012,03140,Villena,Alicante,416,486,-70
2012,03902,Pilar de la Horadada,Alicante,819,630,189
2012,04003,Adra,Almería,267,244,23
2012,04006,Albox,Almería,147,136,11
2012,04013,Almería,Almería,2147,2158,-11
2012,04029,Berja,Almería,134,147,-13
2012,04035,Cuevas del Almanzora,Almería,199,200,-1
2012,04052,Huércal de Almería,Almería,127,145,-18
2012,04053,Huércal-Overa,Almería,324,320,4
2012,04066,Níjar,Almería,511,492,19
2012,04079,Roquetas de Mar,Almería,2513,2067,446
2012,04100,Vera,Almería,352,305,47
2012,04102,Vícar,Almería,474,415,59
2012,04902,El Ejido,Almería,1581,1313,268
2012,05019,Ávila,Ávila,861,1355,-494
2012,06011,Almendralejo,Badajoz,454,489,-35
2012,06015,Badajoz,Badajoz,1904,2001,-97
2012,06044,Don Benito,Badajoz,462,536,-74
2012,06083,Mérida,Badajoz,951,1015,-64
2012,06088,Montijo,Badajoz,167,184,-17
2012,06095,Olivenza,Badajoz,123,110,13
2012,06149,Villafranca de los Barros,Badajoz,115,109,6
2012,06153,Villanueva de la Serena,Badajoz,371,356,15
2012,06158,Zafra,Badajoz,207,254,-47
2012,07003,Alcúdia,Baleares,574,524,50
2012,07005,Andratx,Baleares,153,106,47
2012,07011,Calvià,Baleares,932,781,151
2012,07014,Capdepera,Baleares,368,298,70
2012,07015,Ciutadella de Menorca,Baleares,1143,1187,-44
2012,07022,Felanitx,Baleares,164,193,-29
2012,07024,Formentera,Baleares,823,542,281
2012,07026,Eivissa,Baleares,2591,1869,722
2012,07027,Inca,Baleares,433,390,43
2012,07031,Llucmajor,Baleares,799,584,215
2012,07032,Maó-Mahón,Baleares,961,1005,-44
2012,07033,Manacor,Baleares,636,658,-22
2012,07036,Marratxí,Baleares,323,230,93
2012,07040,Palma,Baleares,7315,6874,441
2012,07042,Pollença,Baleares,223,206,17
2012,07044,Sa Pobla,Baleares,97,96,1
2012,07046,Sant Antoni de Portmany,Baleares,1053,667,386
2012,07048,Sant Josep de sa Talaia,Baleares,1542,972,570
2012,07054,Santa Eulària des Riu,Baleares,1862,1131,731
2012,07055,Santa Margalida,Baleares,269,259,10
2012,07057,Santanyí,Baleares,283,217,66
2012,07061,Sóller,Baleares,200,138,62
2012,07062,Son Servera,Baleares,306,309,-3
2012,08001,Abrera,Barcelona,65,118,-53
2012,08006,Arenys de Mar,Barcelona,146,150,-4
2012,08009,Argentona,Barcelona,77,91,-14
2012,08015,Badalona,Barcelona,1907,2188,-281
2012,08019,Barcelona,Barcelona,21104,20294,810
2012,08022,Berga,Barcelona,147,162,-15
2012,08033,Caldes de Montbui,Barcelona,137,115,22
2012,08035,Calella,Barcelona,224,242,-18
2012,08040,Canet de Mar,Barcelona,98,125,-27
2012,08041,Canovelles,Barcelona,146,150,-4
2012,08046,Cardedeu,Barcelona,96,144,-48
2012,08051,Castellar del Vallès,Barcelona,151,174,-23
2012,08054,Castellbisbal,Barcelona,90,136,-46
2012,08056,Castelldefels,Barcelona,886,977,-91
2012,08072,Corbera de Llobregat,Barcelona,72,125,-53
2012,08073,Cornellà de Llobregat,Barcelona,755,808,-53
2012,08074,Cubelles,Barcelona,241,251,-10
2012,08076,Esparreguera,Barcelona,216,174,42
2012,08077,Esplugues de Llobregat,Barcelona,417,423,-6
2012,08086,Les Franqueses del Vallès,Barcelona,151,164,-13
2012,08088,La Garriga,Barcelona,121,110,11
2012,08089,Gavà,Barcelona,463,566,-103
2012,08096,Granollers,Barcelona,562,681,-119
2012,08101,L'Hospitalet de Llobregat,Barcelona,2983,3003,-20
2012,08102,Igualada,Barcelona,390,408,-18
2012,08105,La Llagosta,Barcelona,135,121,14
2012,08107,Lliçà d'Amunt,Barcelona,87,83,4
2012,08110,Malgrat de Mar,Barcelona,265,346,-81
2012,08112,Manlleu,Barcelona,164,185,-21
2012,08113,Manresa,Barcelona,684,761,-77
2012,08114,Martorell,Barcelona,311,380,-69
2012,08118,El Masnou,Barcelona,162,171,-9
2012,08121,Mataró,Barcelona,1219,1317,-98
2012,08123,Molins de Rei,Barcelona,159,169,-10
2012,08124,Mollet del Vallès,Barcelona,443,456,-13
2012,08125,Montcada i Reixac,Barcelona,283,329,-46
2012,08126,Montgat,Barcelona,79,99,-20
2012,08136,Montornès del Vallès,Barcelona,146,179,-33
2012,08147,Olesa de Montserrat,Barcelona,202,237,-35
2012,08156,Palau-solità i Plegamans,Barcelona,90,89,1
2012,08157,Pallejà,Barcelona,68,86,-18
2012,08159,Parets del Vallès,Barcelona,136,162,-26
2012,08161,Piera,Barcelona,128,133,-5
2012,08163,Pineda de Mar,Barcelona,269,300,-31
2012,08169,El Prat de Llobregat,Barcelona,701,659,42
2012,08172,Premià de Mar,Barcelona,269,300,-31
2012,08180,Ripollet,Barcelona,309,372,-63
2012,08181,La Roca del Vallès,Barcelona,65,71,-6
2012,08184,Rubí,Barcelona,704,798,-94
2012,08187,Sabadell,Barcelona,2021,1962,59
2012,08194,Sant Adrià de Besòs,Barcelona,375,386,-11
2012,08196,Sant Andreu de la Barca,Barcelona,245,270,-25
2012,08197,Sant Andreu de Llavaneres,Barcelona,82,75,7
2012,08200,Sant Boi de Llobregat,Barcelona,781,824,-43
2012,08202,Sant Celoni,Barcelona,301,220,81
2012,08205,Sant Cugat del Vallès,Barcelona,871,776,95
2012,08211,Sant Feliu de Llobregat,Barcelona,379,361,18
2012,08217,Sant Joan Despí,Barcelona,278,247,31
2012,08218,Sant Joan de Vilatorrada,Barcelona,65,79,-14
2012,08219,Vilassar de Mar,Barcelona,154,155,-1
2012,08221,Sant Just Desvern,Barcelona,165,122,43
2012,08230,Premià de Dalt,Barcelona,55,79,-24
2012,08231,Sant Pere de Ribes,Barcelona,363,384,-21
2012,08238,Sant Quirze del Vallès,Barcelona,94,91,3
2012,08240,Sant Sadurní d'Anoia,Barcelona,99,96,3
2012,08245,Santa Coloma de Gramenet,Barcelona,1247,1570,-323
2012,08252,Barberà del Vallès,Barcelona,251,240,11
2012,08260,Santa Perpètua de Mogoda,Barcelona,194,235,-41
2012,08263,Sant Vicenç dels Horts,Barcelona,234,274,-40
2012,08266,Cerdanyola del Vallès,Barcelona,486,506,-20
2012,08270,Sitges,Barcelona,370,356,14
2012,08279,Terrassa,Barcelona,1972,2061,-89
2012,08284,Tordera,Barcelona,498,407,91
2012,08285,Torelló,Barcelona,108,85,23
2012,08295,Vallirana,Barcelona,98,129,-31
2012,08298,Vic,Barcelona,561,456,105
2012,08301,Viladecans,Barcelona,622,602,20
2012,08302,Vilanova del Camí,Barcelona,88,94,-6
2012,08305,Vilafranca del Penedès,Barcelona,443,390,53
2012,08307,Vilanova i la Geltrú,Barcelona,807,778,29
2012,08904,Badia del Vallès,Barcelona,125,138,-13
2012,09018,Aranda de Duero,Burgos,550,622,-72
2012,09059,Burgos,Burgos,2189,2614,-425
2012,09219,Miranda de Ebro,Burgos,670,828,-158
2012,10037,Cáceres,Cáceres,1301,1593,-292
2012,10067,Coria,Cáceres,161,190,-29
2012,10121,Miajadas,Cáceres,156,185,-29
2012,10131,Navalmoral de la Mata,Cáceres,303,401,-98
2012,10148,Plasencia,Cáceres,501,656,-155
2012,11004,Algeciras,Cádiz,1705,1761,-56
2012,11006,Arcos de la Frontera,Cádiz,256,301,-45
2012,11007,Barbate,Cádiz,251,256,-5
2012,11008,Los Barrios,Cádiz,342,340,2
2012,11012,Cádiz,Cádiz,1127,1275,-148
2012,11014,Conil de la Frontera,Cádiz,277,228,49
2012,11015,Chiclana de la Frontera,Cádiz,1026,1073,-47
2012,11016,Chipiona,Cádiz,249,224,25
2012,11020,Jerez de la Frontera,Cádiz,2256,2824,-568
2012,11021,Jimena de la Frontera,Cádiz,113,146,-33
2012,11022,La Línea de la Concepción,Cádiz,775,673,102
2012,11023,Medina-Sidonia,Cádiz,62,87,-25
2012,11027,El Puerto de Santa María,Cádiz,1337,1503,-166
2012,11028,Puerto Real,Cádiz,422,387,35
2012,11030,Rota,Cádiz,582,603,-21
2012,11031,San Fernando,Cádiz,1003,1228,-225
2012,11032,Sanlúcar de Barrameda,Cádiz,513,534,-21
2012,11033,San Roque,Cádiz,588,477,111
2012,11035,Tarifa,Cádiz,296,264,32
2012,11038,Ubrique,Cádiz,134,131,3
2012,11039,Vejer de la Frontera,Cádiz,87,73,14
2012,11041,Villamartín,Cádiz,99,152,-53
2012,12005,L'Alcora,Castellón,94,100,-6
2012,12009,Almassora,Castellón,343,327,16
2012,12027,Benicarló,Castellón,712,644,68
2012,12028,Benicasim/Benicàssim,Castellón,241,257,-16
2012,12032,Borriana/Burriana,Castellón,429,498,-69
2012,12040,Castellón de la Plana/Castelló de la Plana,Castellón,2159,2442,-283
2012,12082,Nules,Castellón,158,207,-49
2012,12084,Onda,Castellón,250,314,-64
2012,12126,La Vall d'Uixó,Castellón,354,407,-53
2012,12135,Vila-real,Castellón,637,674,-37
2012,12138,Vinaròs,Castellón,872,644,228
2012,13005,Alcázar de San Juan,Ciudad Real,590,669,-79
2012,13023,Bolaños de Calatrava,Ciudad Real,99,105,-6
2012,13028,Campo de Criptana,Ciudad Real,138,185,-47
2012,13034,Ciudad Real,Ciudad Real,1015,1355,-340
2012,13039,Daimiel,Ciudad Real,164,232,-68
2012,13053,Manzanares,Ciudad Real,245,352,-107
2012,13056,Miguelturra,Ciudad Real,147,214,-67
2012,13071,Puertollano,Ciudad Real,809,1048,-239
2012,13078,Socuéllamos,Ciudad Real,234,286,-52
2012,13079,La Solana,Ciudad Real,113,131,-18
2012,13082,Tomelloso,Ciudad Real,542,732,-190
2012,13087,Valdepeñas,Ciudad Real,495,571,-76
2012,13096,Villarrubia de los Ojos,Ciudad Real,77,109,-32
2012,14002,Aguilar de la Frontera,Córdoba,85,118,-33
2012,14007,Baena,Córdoba,205,279,-74
2012,14013,Cabra,Córdoba,153,214,-61
2012,14017,La Carlota,Córdoba,154,180,-26
2012,14021,Córdoba,Córdoba,3424,4316,-892
2012,14030,Fuente Palmera,Córdoba,138,160,-22
2012,14038,Lucena,Córdoba,537,601,-64
2012,14042,Montilla,Córdoba,140,184,-44
2012,14049,Palma del Río,Córdoba,311,360,-49
2012,14052,Peñarroya-Pueblonuevo,Córdoba,201,208,-7
2012,14054,Pozoblanco,Córdoba,198,259,-61
2012,14055,Priego de Córdoba,Córdoba,234,339,-105
2012,14056,Puente Genil,Córdoba,325,450,-125
2012,14058,Rute,Córdoba,147,168,-21
2012,15002,Ames,A Coruña,492,506,-14
2012,15005,Arteixo,A Coruña,350,308,42
2012,15009,Betanzos,A Coruña,128,174,-46
2012,15011,Boiro,A Coruña,288,203,85
2012,15017,Cambre,A Coruña,210,193,17
2012,15019,Carballo,A Coruña,227,185,42
2012,15030,A Coruña,A Coruña,3216,3055,161
2012,15031,Culleredo,A Coruña,276,314,-38
2012,15035,Fene,A Coruña,74,91,-17
2012,15036,Ferrol,A Coruña,1145,1161,-16
2012,15041,A Laracha,A Coruña,47,36,11
2012,15054,Narón,A Coruña,492,504,-12
2012,15057,Noia,A Coruña,155,151,4
2012,15058,Oleiros,A Coruña,432,456,-24
2012,15059,Ordes,A Coruña,76,127,-51
2012,15070,As Pontes de García Rodríguez,A Coruña,47,113,-66
2012,15072,Rianxo,A Coruña,118,101,17
2012,15073,Ribeira,A Coruña,299,249,50
2012,15075,Sada (A Coruña),A Coruña,188,180,8
2012,15077,Santa Comba,A Coruña,48,49,-1
2012,15078,Santiago de Compostela,A Coruña,1470,1244,226
2012,15082,Teo,A Coruña,215,218,-3
2012,16078,Cuenca,Cuenca,910,1174,-264
2012,16203,Tarancón,Cuenca,386,500,-114
2012,17015,Banyoles,Girona,225,173,52
2012,17022,La Bisbal d'Empordà,Girona,99,115,-16
2012,17023,Blanes,Girona,1302,1264,38
2012,17034,Calonge i Sant Antoni,Girona,254,234,20
2012,17047,Castelló d'Empúries,Girona,215,211,4
2012,17048,Castell-Platja d'Aro,Girona,232,268,-36
2012,17062,L'Escala,Girona,199,194,5
2012,17066,Figueres,Girona,843,809,34
2012,17079,Girona,Girona,1571,1689,-118
2012,17095,Lloret de Mar,Girona,890,1115,-225
2012,17114,Olot,Girona,461,507,-46
2012,17117,Palafrugell,Girona,302,342,-40
2012,17118,Palamós,Girona,305,328,-23
2012,17147,Ripoll,Girona,176,193,-17
2012,17152,Roses,Girona,325,391,-66
2012,17155,Salt,Girona,401,475,-74
2012,17160,Sant Feliu de Guíxols,Girona,322,354,-32
2012,17180,Santa Coloma de Farners,Girona,197,214,-17
2012,17199,Torroella de Montgrí,Girona,143,163,-20
2012,18003,Albolote,Granada,194,232,-38
2012,18017,Almuñécar,Granada,355,499,-144
2012,18021,Armilla,Granada,452,460,-8
2012,18022,Atarfe,Granada,253,272,-19
2012,18023,Baza,Granada,355,446,-91
2012,18062,Churriana de la Vega,Granada,222,233,-11
2012,18087,Granada,Granada,4088,4362,-274
2012,18089,Guadix,Granada,269,358,-89
2012,18100,Huétor Tájar,Granada,115,133,-18
2012,18101,Huétor Vega,Granada,126,128,-2
2012,18102,Illora,Granada,77,73,4
2012,18122,Loja,Granada,286,334,-48
2012,18127,Maracena,Granada,232,270,-38
2012,18140,Motril,Granada,697,798,-101
2012,18145,Ogíjares,Granada,190,188,2
2012,18153,Peligros,Granada,101,131,-30
2012,18158,Pinos Puente,Granada,97,140,-43
2012,18173,Salobreña,Granada,146,150,-4
2012,18175,Santa Fe,Granada,198,234,-36
2012,18193,La Zubia,Granada,288,252,36
2012,18905,Las Gabias,Granada,317,379,-62
2012,19024,Alovera,Guadalajara,482,542,-60
2012,19046,Azuqueca de Henares,Guadalajara,1999,1937,62
2012,19071,El Casar,Guadalajara,776,676,100
2012,19130,Guadalajara,Guadalajara,2219,2298,-79
2012,20009,Andoain,Guipúzcoa,108,87,21
2012,20017,Azkoitia,Guipúzcoa,84,88,-4
2012,20018,Azpeitia,Guipúzcoa,110,69,41
2012,20019,Beasain,Guipúzcoa,140,131,9
2012,20030,Eibar,Guipúzcoa,494,410,84
2012,20032,Elgoibar,Guipúzcoa,181,112,69
2012,20036,Hondarribia,Guipúzcoa,187,143,44
2012,20040,Hernani,Guipúzcoa,148,96,52
2012,20045,Irun,Guipúzcoa,843,671,172
2012,20055,Arrasate/Mondragón,Guipúzcoa,340,290,50
2012,20059,Oñati,Guipúzcoa,65,70,-5
2012,20063,Oiartzun,Guipúzcoa,48,48,0
2012,20064,Pasaia,Guipúzcoa,114,100,14
2012,20067,Errenteria,Guipúzcoa,304,272,32
2012,20069,Donostia/San Sebastián,Guipúzcoa,2410,1891,519
2012,20071,Tolosa,Guipúzcoa,173,90,83
2012,20074,Bergara,Guipúzcoa,263,142,121
2012,20079,Zarautz,Guipúzcoa,206,165,41
2012,20080,Zumarraga,Guipúzcoa,127,79,48
2012,20902,Lasarte-Oria,Guipúzcoa,198,151,47
2012,21002,Aljaraque,Huelva,179,233,-54
2012,21005,Almonte,Huelva,447,328,119
2012,21010,Ayamonte,Huelva,246,294,-48
2012,21013,Bollullos Par del Condado,Huelva,140,95,45
2012,21021,Cartaya,Huelva,319,278,41
2012,21035,Gibraleón,Huelva,81,108,-27
2012,21041,Huelva,Huelva,1362,1529,-167
2012,21042,Isla Cristina,Huelva,298,292,6
2012,21044,Lepe,Huelva,488,370,118
2012,21050,Moguer,Huelva,380,271,109
2012,21054,La Palma del Condado,Huelva,128,136,-8
2012,21060,Punta Umbría,Huelva,208,194,14
2012,21072,Valverde del Camino,Huelva,65,105,-40
2012,22048,Barbastro,Huesca,251,253,-2
2012,22112,Fraga,Huesca,384,308,76
2012,22125,Huesca,Huesca,880,1020,-140
2012,22130,Jaca,Huesca,462,408,54
2012,22158,Monzón,Huesca,302,312,-10
2012,22199,Sabiñánigo,Huesca,160,260,-100
2012,23002,Alcalá la Real,Jaén,307,388,-81
2012,23003,Alcaudete,Jaén,108,200,-92
2012,23005,Andújar,Jaén,526,696,-170
2012,23009,Baeza,Jaén,170,344,-174
2012,23010,Bailén,Jaén,137,236,-99
2012,23024,La Carolina,Jaén,189,267,-78
2012,23050,Jaén,Jaén,1093,1769,-676
2012,23053,Jódar,Jaén,96,124,-28
2012,23055,Linares,Jaén,691,985,-294
2012,23058,Mancha Real,Jaén,105,136,-31
2012,23060,Martos,Jaén,206,231,-25
2012,23086,Torredelcampo,Jaén,111,116,-5
2012,23087,Torredonjimeno,Jaén,143,180,-37
2012,23092,Úbeda,Jaén,321,607,-286
2012,23095,Villacarrillo,Jaén,136,293,-157
2012,24008,Astorga,León,140,192,-52
2012,24010,La Bañeza,León,142,133,9
2012,24089,León,León,1669,2156,-487
2012,24115,Ponferrada,León,800,1095,-295
2012,24142,San Andrés del Rabanedo,León,392,380,12
2012,24202,Villablino,León,90,158,-68
2012,24222,Villaquilambre,León,180,225,-45
2012,25040,Balaguer,Lleida,237,312,-75
2012,25120,Lleida,Lleida,2749,2940,-191
2012,25137,Mollerussa,Lleida,276,307,-31
2012,25203,La Seu d'Urgell,Lleida,325,307,18
2012,25217,Tàrrega,Lleida,298,333,-35
2012,26018,Arnedo,La Rioja,148,168,-20
2012,26036,Calahorra,La Rioja,436,477,-41
2012,26071,Haro,La Rioja,292,313,-21
2012,26089,Logroño,La Rioja,2414,2504,-90
2012,27028,Lugo,Lugo,1397,1469,-72
2012,27031,Monforte de Lemos,Lugo,389,364,25
2012,27051,Ribadeo,Lugo,248,214,34
2012,27057,Sarria,Lugo,155,154,1
2012,27065,Vilalba,Lugo,155,126,29
2012,27066,Viveiro,Lugo,234,253,-19
2012,28005,Alcalá de Henares,Madrid,3642,3480,162
2012,28006,Alcobendas,Madrid,1533,1188,345
2012,28007,Alcorcón,Madrid,1987,1723,264
2012,28009,Algete,Madrid,246,296,-50
2012,28010,Alpedrete,Madrid,146,132,14
2012,28013,Aranjuez,Madrid,1513,1231,282
2012,28014,Arganda del Rey,Madrid,663,621,42
2012,28015,Arroyomolinos (Madrid),Madrid,411,261,150
2012,28022,Boadilla del Monte,Madrid,509,391,118
2012,28026,Brunete,Madrid,124,117,7
2012,28040,Ciempozuelos,Madrid,377,320,57
2012,28045,Colmenar Viejo,Madrid,682,535,147
2012,28047,Collado Villalba,Madrid,878,774,104
2012,28049,Coslada,Madrid,804,802,2
2012,28054,El Escorial,Madrid,128,167,-39
2012,28058,Fuenlabrada,Madrid,2886,3280,-394
2012,28061,Galapagar,Madrid,360,455,-95
2012,28065,Getafe,Madrid,2447,2174,273
2012,28068,Guadarrama,Madrid,178,180,-2
2012,28073,Humanes de Madrid,Madrid,353,436,-83
2012,28074,Leganés,Madrid,2420,2230,190
2012,28079,Madrid,Madrid,54837,42454,12383
2012,28080,Majadahonda,Madrid,813,705,108
2012,28083,Meco,Madrid,222,286,-64
2012,28084,Mejorada del Campo,Madrid,270,255,15
2012,28090,Moralzarzal,Madrid,91,110,-19
2012,28092,Móstoles,Madrid,2972,2738,234
2012,28096,Navalcarnero,Madrid,459,402,57
2012,28104,Paracuellos de Jarama,Madrid,443,256,187
2012,28106,Parla,Madrid,2251,2341,-90
2012,28113,Pinto,Madrid,667,728,-61
2012,28115,Pozuelo de Alarcón,Madrid,868,719,149
2012,28123,Rivas-Vaciamadrid,Madrid,835,616,219
2012,28127,Las Rozas de Madrid,Madrid,1138,929,209
2012,28129,San Agustín del Guadalix,Madrid,144,148,-4
2012,28130,San Fernando de Henares,Madrid,425,375,50
2012,28131,San Lorenzo de El Escorial,Madrid,246,317,-71
2012,28132,San Martín de la Vega,Madrid,282,259,23
2012,28134,San Sebastián de los Reyes,Madrid,1188,1030,158
2012,28148,Torrejón de Ardoz,Madrid,1815,1635,180
2012,28152,Torrelodones,Madrid,263,269,-6
2012,28160,Valdemorillo,Madrid,124,138,-14
2012,28161,Valdemoro,Madrid,1125,1219,-94
2012,28167,Velilla de San Antonio,Madrid,137,115,22
2012,28172,Villalbilla,Madrid,176,124,52
2012,28176,Villanueva de la Cañada,Madrid,290,258,32
2012,28177,Villanueva del Pardillo,Madrid,206,195,11
2012,28181,Villaviciosa de Odón,Madrid,312,286,26
2012,28903,Tres Cantos,Madrid,550,394,156
2012,29007,Alhaurín de la Torre,Málaga,373,314,59
2012,29008,Alhaurín el Grande,Málaga,195,193,2
2012,29012,Álora,Málaga,93,87,6
2012,29015,Antequera,Málaga,345,358,-13
2012,29025,Benalmádena,Málaga,1499,914,585
2012,29038,Cártama,Málaga,189,166,23
2012,29042,Coín,Málaga,174,181,-7
2012,29051,Estepona,Málaga,1189,1101,88
2012,29054,Fuengirola,Málaga,1646,1111,535
2012,29067,Málaga,Málaga,6734,5897,837
2012,29068,Manilva,Málaga,524,379,145
2012,29069,Marbella,Málaga,2763,2073,690
2012,29070,Mijas,Málaga,1235,889,346
2012,29075,Nerja,Málaga,357,306,51
2012,29082,Rincón de la Victoria,Málaga,606,434,172
2012,29084,Ronda,Málaga,563,600,-37
2012,29091,Torrox,Málaga,327,244,83
2012,29094,Vélez-Málaga,Málaga,988,860,128
2012,29901,Torremolinos,Málaga,1260,1022,238
2012,30002,Abarán,Murcia,77,106,-29
2012,30003,Águilas,Murcia,588,542,46
2012,30005,Alcantarilla,Murcia,338,401,-63
2012,30008,Alhama de Murcia,Murcia,247,200,47
2012,30009,Archena,Murcia,424,368,56
2012,30010,Beniel,Murcia,206,222,-16
2012,30012,Bullas,Murcia,93,77,16
2012,30013,Calasparra,Murcia,127,124,3
2012,30015,Caravaca de la Cruz,Murcia,312,297,15
2012,30016,Cartagena,Murcia,2772,2776,-4
2012,30017,Cehegín,Murcia,144,114,30
2012,30018,Ceutí,Murcia,129,132,-3
2012,30019,Cieza (Murcia),Murcia,299,270,29
2012,30020,Fortuna,Murcia,137,111,26
2012,30021,Fuente Álamo de Murcia,Murcia,210,251,-41
2012,30022,Jumilla,Murcia,436,341,95
2012,30024,Lorca,Murcia,1197,1086,111
2012,30026,Mazarrón,Murcia,445,479,-34
2012,30027,Molina de Segura,Murcia,809,829,-20
2012,30029,Mula,Murcia,244,150,94
2012,30030,Murcia,Murcia,4671,4673,-2
2012,30033,Puerto Lumbreras,Murcia,202,191,11
2012,30035,San Javier,Murcia,785,748,37
2012,30036,San Pedro del Pinatar,Murcia,641,693,-52
2012,30037,Torre-Pacheco,Murcia,475,417,58
2012,30038,Las Torres de Cotillas,Murcia,191,229,-38
2012,30039,Totana,Murcia,441,258,183
2012,30041,La Unión,Murcia,191,201,-10
2012,30043,Yecla,Murcia,405,460,-55
2012,30901,Santomera,Murcia,180,169,11
2012,30902,Los Alcázares,Murcia,406,383,23
2012,31016,Ansoáin/Antsoain,Navarra,124,92,32
2012,31060,Burlada/Burlata,Navarra,203,146,57
2012,31086,Valle de Egüés,Navarra,125,129,-4
2012,31097,Estella-Lizarra,Navarra,179,166,13
2012,31201,Pamplona/Iruña,Navarra,2723,2394,329
2012,31227,Tafalla,Navarra,98,92,6
2012,31232,Tudela,Navarra,1120,794,326
2012,31258,Villava/Atarrabia,Navarra,69,60,9
2012,31901,Barañain,Navarra,220,211,9
2012,31907,Zizur Mayor/Zizur Nagusia,Navarra,101,145,-44
2012,32008,Barbadás,Ourense,129,118,11
2012,32009,O Barco de Valdeorras,Ourense,201,231,-30
2012,32019,O Carballiño,Ourense,227,195,32
2012,32032,Xinzo de Limia,Ourense,144,142,2
2012,32054,Ourense,Ourense,1755,1710,45
2012,32085,Verín,Ourense,378,289,89
2012,33002,Aller,Asturias,49,74,-25
2012,33004,Avilés,Asturias,627,657,-30
2012,33011,Cangas del Narcea,Asturias,73,92,-19
2012,33014,Carreño,Asturias,95,85,10
2012,33016,Castrillón,Asturias,161,168,-7
2012,33020,Corvera de Asturias,Asturias,145,148,-3
2012,33024,Gijón,Asturias,2755,2933,-178
2012,33025,Gozón,Asturias,81,78,3
2012,33026,Grado,Asturias,62,61,1
2012,33031,Langreo,Asturias,279,292,-13
2012,33032,Laviana,Asturias,39,56,-17
2012,33033,Lena,Asturias,100,118,-18
2012,33034,Valdés,Asturias,94,88,6
2012,33035,Llanera,Asturias,100,115,-15
2012,33036,Llanes,Asturias,166,179,-13
2012,33037,Mieres (Asturias),Asturias,230,309,-79
2012,33044,Oviedo,Asturias,2371,2900,-529
2012,33060,San Martín del Rey Aurelio,Asturias,104,97,7
2012,33066,Siero,Asturias,526,475,51
2012,33073,Tineo,Asturias,37,67,-30
2012,33076,Villaviciosa,Asturias,123,113,10
2012,34120,Palencia,Palencia,907,1215,-308
2012,35002,Agüimes,Las Palmas,319,285,34
2012,35003,Antigua,Las Palmas,356,313,43
2012,35004,Arrecife,Las Palmas,1421,1387,34
2012,35006,Arucas,Las Palmas,265,221,44
2012,35009,Gáldar,Las Palmas,137,116,21
2012,35011,Ingenio,Las Palmas,283,249,34
2012,35012,Mogán,Las Palmas,332,262,70
2012,35014,La Oliva,Las Palmas,827,675,152
2012,35015,Pájara,Las Palmas,781,670,111
2012,35016,Las Palmas de Gran Canaria,Las Palmas,6111,5464,647
2012,35017,Puerto del Rosario,Las Palmas,988,1085,-97
2012,35018,San Bartolomé,Las Palmas,419,507,-88
2012,35019,San Bartolomé de Tirajana,Las Palmas,949,796,153
2012,35021,Santa Brígida,Las Palmas,166,137,29
2012,35022,Santa Lucía de Tirajana,Las Palmas,980,936,44
2012,35023,Santa María de Guía de Gran Canaria,Las Palmas,76,77,-1
2012,35024,Teguise,Las Palmas,580,397,183
2012,35026,Telde,Las Palmas,1034,738,296
2012,35027,Teror,Las Palmas,71,66,5
2012,35028,Tías,Las Palmas,587,488,99
2012,35030,Tuineje,Las Palmas,392,302,90
2012,35034,Yaiza,Las Palmas,842,619,223
2012,36003,Baiona,Pontevedra,110,131,-21
2012,36004,Bueu,Pontevedra,76,56,20
2012,36005,Caldas de Reis,Pontevedra,110,100,10
2012,36006,Cambados,Pontevedra,104,112,-8
2012,36008,Cangas,Pontevedra,209,181,28
2012,36017,A Estrada,Pontevedra,244,241,3
2012,36021,Gondomar,Pontevedra,69,82,-13
2012,36022,O Grove,Pontevedra,87,120,-33
2012,36023,A Guarda,Pontevedra,81,81,0
2012,36024,Lalín,Pontevedra,213,342,-129
2012,36026,Marín,Pontevedra,336,317,19
2012,36029,Moaña,Pontevedra,134,167,-33
2012,36033,Mos,Pontevedra,111,87,24
2012,36035,Nigrán,Pontevedra,153,127,26
2012,36038,Pontevedra,Pontevedra,1136,1111,25
2012,36039,O Porriño,Pontevedra,233,208,25
2012,36041,Poio,Pontevedra,255,208,47
2012,36042,Ponteareas,Pontevedra,212,231,-19
2012,36045,Redondela,Pontevedra,199,239,-40
2012,36051,Sanxenxo,Pontevedra,186,189,-3
2012,36054,Tomiño,Pontevedra,109,101,8
2012,36055,Tui,Pontevedra,150,127,23
2012,36057,Vigo,Pontevedra,3256,3231,25
2012,36060,Vilagarcía de Arousa,Pontevedra,576,485,91
2012,36061,Vilanova de Arousa,Pontevedra,67,78,-11
2012,37046,Béjar,Salamanca,297,313,-16
2012,37107,Ciudad Rodrigo,Salamanca,191,235,-44
2012,37274,Salamanca,Salamanca,2110,2599,-489
2012,37294,Santa Marta de Tormes,Salamanca,221,266,-45
2012,38001,Adeje,Santa Cruz de Tenerife,1259,1044,215
2012,38006,Arona,Santa Cruz de Tenerife,2075,1829,246
2012,38011,Candelaria,Santa Cruz de Tenerife,452,448,4
2012,38017,Granadilla de Abona,Santa Cruz de Tenerife,1097,983,114
2012,38019,Guía de Isora,Santa Cruz de Tenerife,242,180,62
2012,38020,Güímar,Santa Cruz de Tenerife,136,109,27
2012,38022,Icod de los Vinos,Santa Cruz de Tenerife,83,106,-23
2012,38023,San Cristóbal de La Laguna,Santa Cruz de Tenerife,1872,1612,260
2012,38024,Los Llanos de Aridane,Santa Cruz de Tenerife,265,287,-22
2012,38026,La Orotava,Santa Cruz de Tenerife,333,214,119
2012,38028,Puerto de la Cruz,Santa Cruz de Tenerife,577,499,78
2012,38031,Los Realejos,Santa Cruz de Tenerife,218,187,31
2012,38032,El Rosario,Santa Cruz de Tenerife,253,244,9
2012,38035,San Miguel de Abona,Santa Cruz de Tenerife,306,271,35
2012,38037,Santa Cruz de la Palma,Santa Cruz de Tenerife,314,285,29
2012,38038,Santa Cruz de Tenerife,Santa Cruz de Tenerife,3042,2713,329
2012,38039,Santa Úrsula,Santa Cruz de Tenerife,149,120,29
2012,38040,Santiago del Teide,Santa Cruz de Tenerife,140,123,17
2012,38043,Tacoronte,Santa Cruz de Tenerife,166,133,33
2012,38046,Tegueste,Santa Cruz de Tenerife,67,54,13
2012,39008,El Astillero,Cantabria,168,177,-9
2012,39016,Camargo,Cantabria,261,281,-20
2012,39020,Castro-Urdiales,Cantabria,1368,1446,-78
2012,39025,Los Corrales de Buelna,Cantabria,54,79,-25
2012,39035,Laredo,Cantabria,184,199,-15
2012,39052,Piélagos,Cantabria,230,282,-52
2012,39059,Reinosa,Cantabria,102,113,-11
2012,39073,Santa Cruz de Bezana,Cantabria,131,123,8
2012,39075,Santander,Cantabria,2077,2252,-175
2012,39079,Santoña,Cantabria,157,190,-33
2012,39087,Torrelavega,Cantabria,490,578,-88
2012,40194,Segovia,Segovia,891,1082,-191
2012,41004,Alcalá de Guadaíra,Sevilla,585,687,-102
2012,41005,Alcalá del Río,Sevilla,79,93,-14
2012,41007,La Algaba,Sevilla,99,113,-14
2012,41011,Arahal,Sevilla,122,124,-2
2012,41017,Bormujos,Sevilla,257,200,57
2012,41018,Brenes,Sevilla,94,98,-4
2012,41020,Las Cabezas de San Juan,Sevilla,118,127,-9
2012,41021,Camas,Sevilla,277,282,-5
2012,41023,Cantillana,Sevilla,85,102,-17
2012,41024,Carmona,Sevilla,198,243,-45
2012,41029,Castilleja de la Cuesta,Sevilla,158,182,-24
2012,41034,Coria del Río,Sevilla,240,294,-54
2012,41038,Dos Hermanas,Sevilla,1086,1234,-148
2012,41039,Écija,Sevilla,356,433,-77
2012,41040,Espartinas,Sevilla,180,161,19
2012,41041,Estepa,Sevilla,111,128,-17
2012,41047,Gines,Sevilla,114,100,14
2012,41049,Guillena,Sevilla,127,119,8
2012,41053,Lebrija,Sevilla,252,244,8
2012,41055,Lora del Río,Sevilla,123,185,-62
2012,41058,Mairena del Alcor,Sevilla,171,168,3
2012,41059,Mairena del Aljarafe,Sevilla,573,548,25
2012,41060,Marchena,Sevilla,107,144,-37
2012,41065,Morón de la Frontera,Sevilla,263,264,-1
2012,41068,Osuna,Sevilla,111,192,-81
2012,41069,Los Palacios y Villafranca,Sevilla,199,217,-18
2012,41075,Pilas,Sevilla,156,119,37
2012,41077,La Puebla de Cazalla,Sevilla,152,202,-50
2012,41079,La Puebla del Río,Sevilla,78,121,-43
2012,41081,La Rinconada,Sevilla,272,287,-15
2012,41086,San Juan de Aznalfarache,Sevilla,314,325,-11
2012,41087,Sanlúcar la Mayor,Sevilla,177,120,57
2012,41091,Sevilla,Sevilla,6866,7423,-557
2012,41093,Tomares,Sevilla,336,287,49
2012,41095,Utrera,Sevilla,462,484,-22
2012,41102,El Viso del Alcor,Sevilla,92,97,-5
2012,42173,Soria,Soria,588,727,-139
2012,43004,Alcanar,Tarragona,161,261,-100
2012,43014,Amposta,Tarragona,332,347,-15
2012,43037,Calafell,Tarragona,1283,1236,47
2012,43038,Cambrils,Tarragona,795,791,4
2012,43051,Cunit,Tarragona,740,859,-119
2012,43092,Mont-roig del Camp,Tarragona,350,317,33
2012,43123,Reus,Tarragona,1324,1552,-228
2012,43136,Sant Carles de la Ràpita,Tarragona,350,353,-3
2012,43148,Tarragona,Tarragona,2297,2640,-343
2012,43153,Torredembarra,Tarragona,496,389,107
2012,43155,Tortosa,Tarragona,456,534,-78
2012,43161,Valls,Tarragona,287,317,-30
2012,43163,El Vendrell,Tarragona,1259,1234,25
2012,43171,Vila-seca,Tarragona,453,503,-50
2012,43901,Deltebre,Tarragona,156,146,10
2012,43905,Salou,Tarragona,829,942,-113
2012,44013,Alcañiz,Teruel,226,308,-82
2012,44216,Teruel,Teruel,619,617,2
2012,45053,Consuegra,Toledo,88,138,-50
2012,45066,Fuensalida,Toledo,340,408,-68
2012,45081,Illescas,Toledo,1401,1203,198
2012,45087,Madridejos,Toledo,103,150,-47
2012,45106,Mora,Toledo,100,142,-42
2012,45121,Ocaña,Toledo,706,797,-91
2012,45142,Quintanar de la Orden,Toledo,197,328,-131
2012,45161,Seseña,Toledo,2792,1706,1086
2012,45163,Sonseca,Toledo,142,202,-60
2012,45165,Talavera de la Reina,Toledo,1438,2021,-583
2012,45168,Toledo,Toledo,1655,2045,-390
2012,45173,Torrijos,Toledo,258,414,-156
2012,45185,Villacañas,Toledo,98,194,-96
2012,45205,Yuncos,Toledo,717,605,112
2012,46005,Alaquàs,Valencia,265,220,45
2012,46007,Albal,Valencia,119,134,-15
2012,46011,Alberic,Valencia,84,152,-68
2012,46013,Alboraya,Valencia,269,286,-17
2012,46017,Alzira,Valencia,457,497,-40
2012,46019,L'Alcúdia,Valencia,69,108,-39
2012,46021,Aldaia,Valencia,273,305,-32
2012,46022,Alfafar,Valencia,247,240,7
2012,46029,Algemesí,Valencia,227,257,-30
2012,46031,Alginet,Valencia,82,112,-30
2012,46051,Benaguasil,Valencia,97,91,6
2012,46054,Benetússer,Valencia,138,112,26
2012,46060,Benifaió,Valencia,100,84,16
2012,46070,Bétera,Valencia,255,212,43
2012,46078,Burjassot,Valencia,376,355,21
2012,46081,Canals,Valencia,90,119,-29
2012,46083,Carcaixent,Valencia,142,219,-77
2012,46085,Carlet,Valencia,149,102,47
2012,46094,Catarroja,Valencia,225,262,-37
2012,46102,Quart de Poblet,Valencia,243,214,29
2012,46105,Cullera,Valencia,237,335,-98
2012,46110,Xirivella,Valencia,330,383,-53
2012,46111,Chiva,Valencia,150,159,-9
2012,46116,L'Eliana,Valencia,183,155,28
2012,46131,Gandia,Valencia,1217,1441,-224
2012,46135,Godella,Valencia,104,87,17
2012,46145,Xátiva,Valencia,228,284,-56
2012,46147,Llíria,Valencia,188,224,-36
2012,46159,Manises,Valencia,329,305,24
2012,46164,Massamagrell,Valencia,142,126,16
2012,46166,Meliana,Valencia,64,94,-30
2012,46169,Mislata,Valencia,517,538,-21
2012,46171,Moncada,Valencia,151,160,-9
2012,46181,Oliva,Valencia,401,395,6
2012,46184,Ontinyent,Valencia,246,333,-87
2012,46186,Paiporta,Valencia,239,266,-27
2012,46190,Paterna,Valencia,773,821,-48
2012,46193,Picanya,Valencia,108,86,22
2012,46194,Picassent,Valencia,187,184,3
2012,46202,La Pobla de Vallbona,Valencia,204,247,-43
2012,46205,Puçol,Valencia,166,213,-47
2012,46213,Requena,Valencia,179,234,-55
2012,46214,Riba-roja de Túria,Valencia,152,192,-40
2012,46220,Sagunto/Sagunt,Valencia,879,947,-68
2012,46223,Sedaví,Valencia,99,106,-7
2012,46230,Silla,Valencia,192,234,-42
2012,46235,Sueca,Valencia,248,233,15
2012,46238,Tavernes de la Valldigna,Valencia,121,156,-35
2012,46244,Torrent (Valencia),Valencia,820,952,-132
2012,46249,Utiel,Valencia,93,126,-33
2012,46250,València,Valencia,11075,11052,23
2012,47010,Arroyo de la Encomienda,Valladolid,421,296,125
2012,47076,Laguna de Duero,Valladolid,265,271,-6
2012,47085,Medina del Campo,Valladolid,300,360,-60
2012,47186,Valladolid,Valladolid,3709,4241,-532
2012,48003,Amorebieta-Etxano,Vizcaya,143,91,52
2012,48011,Arrigorriaga,Vizcaya,105,121,-16
2012,48013,Barakaldo,Vizcaya,1122,1025,97
2012,48015,Basauri,Vizcaya,360,327,33
2012,48017,Bermeo,Vizcaya,182,139,43
2012,48020,Bilbao,Vizcaya,4580,3995,585
2012,48027,Durango,Vizcaya,327,267,60
2012,48029,Etxebarri,Vizcaya,71,70,1
2012,48034,Ermua,Vizcaya,225,271,-46
2012,48036,Galdakao,Vizcaya,182,166,16
2012,48044,Getxo,Vizcaya,797,766,31
2012,48046,Gernika-Lumo,Vizcaya,136,106,30
2012,48054,Leioa,Vizcaya,288,214,74
2012,48069,Mungia,Vizcaya,211,187,24
2012,48078,Portugalete,Vizcaya,333,360,-27
2012,48080,Valle de Trápaga-Trapagaran,Vizcaya,107,99,8
2012,48082,Santurtzi,Vizcaya,416,435,-19
2012,48084,Sestao,Vizcaya,262,300,-38
2012,48085,Sopela,Vizcaya,117,105,12
2012,48902,Erandio,Vizcaya,237,207,30
2012,49021,Benavente,Zamora,364,418,-54
2012,49275,Zamora,Zamora,845,1083,-238
2012,50067,Calatayud,Zaragoza,456,491,-35
2012,50089,Cuarte de Huerva,Zaragoza,215,209,6
2012,50095,Ejea de los Caballeros,Zaragoza,202,208,-6
2012,50251,Tarazona,Zaragoza,129,163,-34
2012,50272,Utebo,Zaragoza,198,232,-34
2012,50297,Zaragoza,Zaragoza,8617,8066,551
2012,51001,Ceuta,Ceuta,2396,2554,-158
2012,52001,Melilla,Melilla,4452,2795,1657
2013,01002,Amurrio,Álava,226,168,58
2013,01036,Laudio/Llodio,Álava,286,346,-60
2013,01059,Vitoria-Gasteiz,Álava,4241,3396,845
2013,02003,Albacete,Albacete,2235,2742,-507
2013,02009,Almansa,Albacete,355,476,-121
2013,02025,Caudete,Albacete,217,298,-81
2013,02037,Hellín,Albacete,438,597,-159
2013,02069,La Roda,Albacete,236,253,-17
2013,02081,Villarrobledo,Albacete,373,452,-79
2013,03005,Albatera,Alicante,126,100,26
2013,03009,Alcoy/Alcoi,Alicante,512,597,-85
2013,03011,L'Alfàs del Pi,Alicante,286,244,42
2013,03014,Alicante/Alacant,Alicante,5137,4936,201
2013,03015,Almoradí,Alicante,263,226,37
2013,03018,Altea,Alicante,381,334,47
2013,03019,Aspe,Alicante,136,157,-21
2013,03031,Benidorm,Alicante,2190,1682,508
2013,03041,Benissa,Alicante,101,112,-11
2013,03047,Calp,Alicante,442,360,82
2013,03049,Callosa de Segura,Alicante,175,143,32
2013,03050,El Campello,Alicante,431,353,78
2013,03053,Castalla,Alicante,83,108,-25
2013,03056,Cocentaina,Alicante,150,115,35
2013,03059,Crevillent,Alicante,209,216,-7
2013,03063,Dénia,Alicante,857,845,12
2013,03065,Elche/Elx,Alicante,2452,2413,39
2013,03066,Elda,Alicante,386,453,-67
2013,03076,Guardamar del Segura,Alicante,286,253,33
2013,03079,Ibi,Alicante,156,172,-16
2013,03082,Jávea/Xàbia,Alicante,534,410,124
2013,03089,Monóvar/Monòver,Alicante,77,74,3
2013,03090,Mutxamel,Alicante,254,196,58
2013,03093,Novelda,Alicante,171,166,5
2013,03094,La Nucia,Alicante,258,221,37
2013,03099,Orihuela,Alicante,1220,1173,47
2013,03102,Pego,Alicante,97,120,-23
2013,03104,Petrer,Alicante,194,248,-54
2013,03113,Rojales,Alicante,114,86,28
2013,03118,San Fulgencio,Alicante,92,82,10
2013,03119,Sant Joan d'Alacant,Alicante,287,308,-21
2013,03121,Santa Pola,Alicante,721,575,146
2013,03122,San Vicente del Raspeig/Sant Vicent del Raspeig,Alicante,565,566,-1
2013,03123,Sax,Alicante,63,67,-4
2013,03128,Teulada,Alicante,162,140,22
2013,03133,Torrevieja,Alicante,3242,2716,526
2013,03139,Villajoyosa/La Vila Joiosa,Alicante,665,541,124
2013,03140,Villena,Alicante,329,445,-116
2013,03902,Pilar de la Horadada,Alicante,747,713,34
2013,04003,Adra,Almería,264,229,35
2013,04006,Albox,Almería,153,168,-15
2013,04013,Almería,Almería,2587,2324,263
2013,04029,Berja,Almería,153,122,31
2013,04035,Cuevas del Almanzora,Almería,214,205,9
2013,04052,Huércal de Almería,Almería,158,135,23
2013,04053,Huércal-Overa,Almería,347,317,30
2013,04066,Níjar,Almería,573,378,195
2013,04079,Roquetas de Mar,Almería,2314,1842,472
2013,04100,Vera,Almería,358,333,25
2013,04102,Vícar,Almería,459,361,98
2013,04902,El Ejido,Almería,1632,1173,459
2013,05019,Ávila,Ávila,945,1222,-277
2013,06011,Almendralejo,Badajoz,447,524,-77
2013,06015,Badajoz,Badajoz,1933,2074,-141
2013,06044,Don Benito,Badajoz,439,580,-141
2013,06083,Mérida,Badajoz,870,970,-100
2013,06088,Montijo,Badajoz,157,205,-48
2013,06095,Olivenza,Badajoz,110,109,1
2013,06149,Villafranca de los Barros,Badajoz,143,145,-2
2013,06153,Villanueva de la Serena,Badajoz,332,370,-38
2013,06158,Zafra,Badajoz,238,255,-17
2013,07003,Alcúdia,Baleares,624,432,192
2013,07005,Andratx,Baleares,170,92,78
2013,07011,Calvià,Baleares,1085,813,272
2013,07013,Campos,Baleares,119,111,8
2013,07014,Capdepera,Baleares,403,243,160
2013,07015,Ciutadella de Menorca,Baleares,1100,1103,-3
2013,07022,Felanitx,Baleares,202,176,26
2013,07024,Formentera,Baleares,831,573,258
2013,07026,Eivissa,Baleares,2345,1679,666
2013,07027,Inca,Baleares,421,372,49
2013,07031,Llucmajor,Baleares,664,534,130
2013,07032,Maó-Mahón,Baleares,859,881,-22
2013,07033,Manacor,Baleares,586,530,56
2013,07036,Marratxí,Baleares,283,228,55
2013,07040,Palma,Baleares,7545,6178,1367
2013,07042,Pollença,Baleares,213,156,57
2013,07044,Sa Pobla,Baleares,96,94,2
2013,07046,Sant Antoni de Portmany,Baleares,1222,709,513
2013,07048,Sant Josep de sa Talaia,Baleares,1493,853,640
2013,07054,Santa Eulària des Riu,Baleares,1733,1129,604
2013,07055,Santa Margalida,Baleares,285,290,-5
2013,07057,Santanyí,Baleares,269,218,51
2013,07061,Sóller,Baleares,162,130,32
2013,07062,Son Servera,Baleares,296,200,96
2013,08001,Abrera,Barcelona,109,98,11
2013,08006,Arenys de Mar,Barcelona,173,133,40
2013,08009,Argentona,Barcelona,71,60,11
2013,08015,Badalona,Barcelona,1908,2055,-147
2013,08019,Barcelona,Barcelona,20565,18336,2229
2013,08022,Berga,Barcelona,108,147,-39
2013,08033,Caldes de Montbui,Barcelona,127,160,-33
2013,08035,Calella,Barcelona,219,226,-7
2013,08040,Canet de Mar,Barcelona,104,98,6
2013,08041,Canovelles,Barcelona,132,150,-18
2013,08046,Cardedeu,Barcelona,116,106,10
2013,08051,Castellar del Vallès,Barcelona,127,138,-11
2013,08054,Castellbisbal,Barcelona,97,102,-5
2013,08056,Castelldefels,Barcelona,962,819,143
2013,08072,Corbera de Llobregat,Barcelona,80,109,-29
2013,08073,Cornellà de Llobregat,Barcelona,764,798,-34
2013,08074,Cubelles,Barcelona,248,282,-34
2013,08076,Esparreguera,Barcelona,184,194,-10
2013,08077,Esplugues de Llobregat,Barcelona,367,407,-40
2013,08086,Les Franqueses del Vallès,Barcelona,162,144,18
2013,08088,La Garriga,Barcelona,142,113,29
2013,08089,Gavà,Barcelona,518,475,43
2013,08096,Granollers,Barcelona,602,611,-9
2013,08101,L'Hospitalet de Llobregat,Barcelona,2984,2911,73
2013,08102,Igualada,Barcelona,346,396,-50
2013,08105,La Llagosta,Barcelona,115,117,-2
2013,08107,Lliçà d'Amunt,Barcelona,93,93,0
2013,08110,Malgrat de Mar,Barcelona,286,282,4
2013,08112,Manlleu,Barcelona,144,191,-47
2013,08113,Manresa,Barcelona,621,782,-161
2013,08114,Martorell,Barcelona,255,282,-27
2013,08118,El Masnou,Barcelona,151,203,-52
2013,08121,Mataró,Barcelona,1199,1224,-25
2013,08123,Molins de Rei,Barcelona,155,163,-8
2013,08124,Mollet del Vallès,Barcelona,422,437,-15
2013,08125,Montcada i Reixac,Barcelona,274,304,-30
2013,08126,Montgat,Barcelona,82,75,7
2013,08136,Montornès del Vallès,Barcelona,113,125,-12
2013,08147,Olesa de Montserrat,Barcelona,193,208,-15
2013,08156,Palau-solità i Plegamans,Barcelona,85,76,9
2013,08157,Pallejà,Barcelona,85,71,14
2013,08159,Parets del Vallès,Barcelona,116,142,-26
2013,08161,Piera,Barcelona,98,128,-30
2013,08163,Pineda de Mar,Barcelona,324,323,1
2013,08169,El Prat de Llobregat,Barcelona,594,619,-25
2013,08172,Premià de Mar,Barcelona,238,233,5
2013,08180,Ripollet,Barcelona,305,317,-12
2013,08181,La Roca del Vallès,Barcelona,66,64,2
2013,08184,Rubí,Barcelona,617,708,-91
2013,08187,Sabadell,Barcelona,1877,1811,66
2013,08194,Sant Adrià de Besòs,Barcelona,437,362,75
2013,08196,Sant Andreu de la Barca,Barcelona,247,243,4
2013,08197,Sant Andreu de Llavaneres,Barcelona,99,83,16
2013,08200,Sant Boi de Llobregat,Barcelona,746,707,39
2013,08202,Sant Celoni,Barcelona,238,255,-17
2013,08205,Sant Cugat del Vallès,Barcelona,869,773,96
2013,08211,Sant Feliu de Llobregat,Barcelona,300,347,-47
2013,08217,Sant Joan Despí,Barcelona,267,234,33
2013,08218,Sant Joan de Vilatorrada,Barcelona,65,66,-1
2013,08219,Vilassar de Mar,Barcelona,139,160,-21
2013,08221,Sant Just Desvern,Barcelona,151,131,20
2013,08230,Premià de Dalt,Barcelona,86,93,-7
2013,08231,Sant Pere de Ribes,Barcelona,371,403,-32
2013,08238,Sant Quirze del Vallès,Barcelona,107,125,-18
2013,08240,Sant Sadurní d'Anoia,Barcelona,95,101,-6
2013,08245,Santa Coloma de Gramenet,Barcelona,1157,1449,-292
2013,08252,Barberà del Vallès,Barcelona,263,252,11
2013,08260,Santa Perpètua de Mogoda,Barcelona,218,226,-8
2013,08263,Sant Vicenç dels Horts,Barcelona,231,262,-31
2013,08266,Cerdanyola del Vallès,Barcelona,437,474,-37
2013,08270,Sitges,Barcelona,331,340,-9
2013,08279,Terrassa,Barcelona,1822,2133,-311
2013,08284,Tordera,Barcelona,442,443,-1
2013,08285,Torelló,Barcelona,111,110,1
2013,08295,Vallirana,Barcelona,142,143,-1
2013,08298,Vic,Barcelona,483,471,12
2013,08301,Viladecans,Barcelona,592,615,-23
2013,08302,Vilanova del Camí,Barcelona,87,110,-23
2013,08305,Vilafranca del Penedès,Barcelona,420,425,-5
2013,08307,Vilanova i la Geltrú,Barcelona,825,751,74
2013,08904,Badia del Vallès,Barcelona,110,118,-8
2013,09018,Aranda de Duero,Burgos,535,603,-68
2013,09059,Burgos,Burgos,1961,2472,-511
2013,09219,Miranda de Ebro,Burgos,584,866,-282
2013,10037,Cáceres,Cáceres,1346,1596,-250
2013,10067,Coria,Cáceres,163,178,-15
2013,10121,Miajadas,Cáceres,159,186,-27
2013,10131,Navalmoral de la Mata,Cáceres,321,372,-51
2013,10148,Plasencia,Cáceres,600,634,-34
2013,11004,Algeciras,Cádiz,1892,1844,48
2013,11006,Arcos de la Frontera,Cádiz,262,304,-42
2013,11007,Barbate,Cádiz,240,282,-42
2013,11008,Los Barrios,Cádiz,314,323,-9
2013,11012,Cádiz,Cádiz,1019,1277,-258
2013,11014,Conil de la Frontera,Cádiz,262,237,25
2013,11015,Chiclana de la Frontera,Cádiz,961,1039,-78
2013,11016,Chipiona,Cádiz,269,215,54
2013,11020,Jerez de la Frontera,Cádiz,2387,2790,-403
2013,11021,Jimena de la Frontera,Cádiz,131,167,-36
2013,11022,La Línea de la Concepción,Cádiz,698,737,-39
2013,11023,Medina-Sidonia,Cádiz,73,70,3
2013,11027,El Puerto de Santa María,Cádiz,1230,1521,-291
2013,11028,Puerto Real,Cádiz,330,461,-131
2013,11030,Rota,Cádiz,541,629,-88
2013,11031,San Fernando,Cádiz,925,1189,-264
2013,11032,Sanlúcar de Barrameda,Cádiz,522,617,-95
2013,11033,San Roque,Cádiz,505,541,-36
2013,11035,Tarifa,Cádiz,276,250,26
2013,11038,Ubrique,Cádiz,145,142,3
2013,11039,Vejer de la Frontera,Cádiz,93,80,13
2013,11041,Villamartín,Cádiz,82,136,-54
2013,12005,L'Alcora,Castellón,71,101,-30
2013,12009,Almassora,Castellón,321,342,-21
2013,12027,Benicarló,Castellón,589,532,57
2013,12028,Benicasim/Benicàssim,Castellón,219,315,-96
2013,12032,Borriana/Burriana,Castellón,411,500,-89
2013,12040,Castellón de la Plana/Castelló de la Plana,Castellón,2009,2256,-247
2013,12082,Nules,Castellón,179,185,-6
2013,12084,Onda,Castellón,270,275,-5
2013,12126,La Vall d'Uixó,Castellón,295,462,-167
2013,12135,Vila-real,Castellón,572,633,-61
2013,12138,Vinaròs,Castellón,711,696,15
2013,13005,Alcázar de San Juan,Ciudad Real,562,613,-51
2013,13023,Bolaños de Calatrava,Ciudad Real,81,106,-25
2013,13028,Campo de Criptana,Ciudad Real,142,150,-8
2013,13034,Ciudad Real,Ciudad Real,1023,1358,-335
2013,13039,Daimiel,Ciudad Real,198,244,-46
2013,13053,Manzanares,Ciudad Real,226,296,-70
2013,13056,Miguelturra,Ciudad Real,165,191,-26
2013,13071,Puertollano,Ciudad Real,604,1079,-475
2013,13078,Socuéllamos,Ciudad Real,207,270,-63
2013,13079,La Solana,Ciudad Real,131,134,-3
2013,13082,Tomelloso,Ciudad Real,483,607,-124
2013,13087,Valdepeñas,Ciudad Real,421,573,-152
2013,13096,Villarrubia de los Ojos,Ciudad Real,82,129,-47
2013,14002,Aguilar de la Frontera,Córdoba,110,124,-14
2013,14007,Baena,Córdoba,174,318,-144
2013,14013,Cabra,Córdoba,161,187,-26
2013,14017,La Carlota,Córdoba,134,192,-58
2013,14021,Córdoba,Córdoba,3278,4246,-968
2013,14030,Fuente Palmera,Córdoba,114,161,-47
2013,14038,Lucena,Córdoba,487,623,-136
2013,14042,Montilla,Córdoba,143,169,-26
2013,14049,Palma del Río,Córdoba,303,364,-61
2013,14052,Peñarroya-Pueblonuevo,Córdoba,142,187,-45
2013,14054,Pozoblanco,Córdoba,207,238,-31
2013,14055,Priego de Córdoba,Córdoba,197,300,-103
2013,14056,Puente Genil,Córdoba,353,492,-139
2013,14058,Rute,Córdoba,129,187,-58
2013,15002,Ames,A Coruña,497,450,47
2013,15005,Arteixo,A Coruña,305,274,31
2013,15009,Betanzos,A Coruña,106,103,3
2013,15011,Boiro,A Coruña,187,222,-35
2013,15017,Cambre,A Coruña,151,185,-34
2013,15019,Carballo,A Coruña,163,191,-28
2013,15030,A Coruña,A Coruña,3010,2990,20
2013,15031,Culleredo,A Coruña,278,281,-3
2013,15035,Fene,A Coruña,71,99,-28
2013,15036,Ferrol,A Coruña,1097,1086,11
2013,15041,A Laracha,A Coruña,54,46,8
2013,15054,Narón,A Coruña,454,381,73
2013,15057,Noia,A Coruña,136,148,-12
2013,15058,Oleiros,A Coruña,446,433,13
2013,15059,Ordes,A Coruña,79,89,-10
2013,15070,As Pontes de García Rodríguez,A Coruña,63,127,-64
2013,15072,Rianxo,A Coruña,70,99,-29
2013,15073,Ribeira,A Coruña,220,264,-44
2013,15075,Sada (A Coruña),A Coruña,163,184,-21
2013,15078,Santiago de Compostela,A Coruña,1395,1378,17
2013,15082,Teo,A Coruña,251,194,57
2013,16078,Cuenca,Cuenca,767,1039,-272
2013,16203,Tarancón,Cuenca,348,443,-95
2013,17015,Banyoles,Girona,186,162,24
2013,17022,La Bisbal d'Empordà,Girona,120,116,4
2013,17023,Blanes,Girona,1207,1309,-102
2013,17034,Calonge i Sant Antoni,Girona,198,173,25
2013,17047,Castelló d'Empúries,Girona,202,218,-16
2013,17048,Castell-Platja d'Aro,Girona,242,256,-14
2013,17062,L'Escala,Girona,176,203,-27
2013,17066,Figueres,Girona,917,678,239
2013,17079,Girona,Girona,1639,1638,1
2013,17095,Lloret de Mar,Girona,849,1098,-249
2013,17114,Olot,Girona,429,432,-3
2013,17117,Palafrugell,Girona,288,330,-42
2013,17118,Palamós,Girona,356,330,26
2013,17147,Ripoll,Girona,150,189,-39
2013,17152,Roses,Girona,325,386,-61
2013,17155,Salt,Girona,388,507,-119
2013,17160,Sant Feliu de Guíxols,Girona,409,386,23
2013,17180,Santa Coloma de Farners,Girona,173,169,4
2013,17199,Torroella de Montgrí,Girona,172,158,14
2013,18003,Albolote,Granada,207,204,3
2013,18017,Almuñécar,Granada,351,384,-33
2013,18021,Armilla,Granada,426,449,-23
2013,18022,Atarfe,Granada,237,229,8
2013,18023,Baza,Granada,286,417,-131
2013,18062,Churriana de la Vega,Granada,209,200,9
2013,18087,Granada,Granada,4165,4182,-17
2013,18089,Guadix,Granada,323,352,-29
2013,18100,Huétor Tájar,Granada,110,120,-10
2013,18101,Huétor Vega,Granada,86,122,-36
2013,18102,Illora,Granada,81,98,-17
2013,18122,Loja,Granada,187,322,-135
2013,18127,Maracena,Granada,227,292,-65
2013,18140,Motril,Granada,695,712,-17
2013,18145,Ogíjares,Granada,180,167,13
2013,18153,Peligros,Granada,88,112,-24
2013,18158,Pinos Puente,Granada,120,108,12
2013,18173,Salobreña,Granada,131,156,-25
2013,18175,Santa Fe,Granada,160,222,-62
2013,18193,La Zubia,Granada,204,258,-54
2013,18905,Las Gabias,Granada,372,337,35
2013,18911,Vegas del Genil,Granada,92,113,-21
2013,19024,Alovera,Guadalajara,422,421,1
2013,19046,Azuqueca de Henares,Guadalajara,1647,1713,-66
2013,19071,El Casar,Guadalajara,587,598,-11
2013,19130,Guadalajara,Guadalajara,1745,2309,-564
2013,20009,Andoain,Guipúzcoa,109,91,18
2013,20017,Azkoitia,Guipúzcoa,128,81,47
2013,20018,Azpeitia,Guipúzcoa,110,74,36
2013,20019,Beasain,Guipúzcoa,194,104,90
2013,20030,Eibar,Guipúzcoa,582,411,171
2013,20032,Elgoibar,Guipúzcoa,140,116,24
2013,20036,Hondarribia,Guipúzcoa,189,134,55
2013,20040,Hernani,Guipúzcoa,180,150,30
2013,20045,Irun,Guipúzcoa,931,741,190
2013,20055,Arrasate/Mondragón,Guipúzcoa,357,271,86
2013,20059,Oñati,Guipúzcoa,84,50,34
2013,20064,Pasaia,Guipúzcoa,184,119,65
2013,20067,Errenteria,Guipúzcoa,412,246,166
2013,20069,Donostia/San Sebastián,Guipúzcoa,2466,1944,522
2013,20071,Tolosa,Guipúzcoa,149,104,45
2013,20074,Bergara,Guipúzcoa,254,141,113
2013,20079,Zarautz,Guipúzcoa,236,175,61
2013,20080,Zumarraga,Guipúzcoa,90,84,6
2013,20902,Lasarte-Oria,Guipúzcoa,206,144,62
2013,21002,Aljaraque,Huelva,173,189,-16
2013,21005,Almonte,Huelva,400,337,63
2013,21010,Ayamonte,Huelva,233,246,-13
2013,21013,Bollullos Par del Condado,Huelva,142,156,-14
2013,21021,Cartaya,Huelva,229,245,-16
2013,21035,Gibraleón,Huelva,109,106,3
2013,21041,Huelva,Huelva,1366,1623,-257
2013,21042,Isla Cristina,Huelva,250,277,-27
2013,21044,Lepe,Huelva,381,368,13
2013,21050,Moguer,Huelva,361,287,74
2013,21054,La Palma del Condado,Huelva,112,134,-22
2013,21055,Palos de la Frontera,Huelva,163,144,19
2013,21060,Punta Umbría,Huelva,178,215,-37
2013,21072,Valverde del Camino,Huelva,81,92,-11
2013,22048,Barbastro,Huesca,232,233,-1
2013,22112,Fraga,Huesca,394,331,63
2013,22125,Huesca,Huesca,881,990,-109
2013,22130,Jaca,Huesca,436,475,-39
2013,22158,Monzón,Huesca,243,258,-15
2013,22199,Sabiñánigo,Huesca,170,240,-70
2013,23002,Alcalá la Real,Jaén,236,377,-141
2013,23003,Alcaudete,Jaén,77,146,-69
2013,23005,Andújar,Jaén,415,636,-221
2013,23009,Baeza,Jaén,197,268,-71
2013,23010,Bailén,Jaén,137,235,-98
2013,23024,La Carolina,Jaén,201,257,-56
2013,23050,Jaén,Jaén,1042,1596,-554
2013,23053,Jódar,Jaén,57,98,-41
2013,23055,Linares,Jaén,772,1085,-313
2013,23058,Mancha Real,Jaén,104,141,-37
2013,23060,Martos,Jaén,160,226,-66
2013,23086,Torredelcampo,Jaén,104,134,-30
2013,23087,Torredonjimeno,Jaén,99,179,-80
2013,23092,Úbeda,Jaén,338,570,-232
2013,23095,Villacarrillo,Jaén,108,172,-64
2013,24008,Astorga,León,219,187,32
2013,24010,La Bañeza,León,129,181,-52
2013,24089,León,León,1628,2174,-546
2013,24115,Ponferrada,León,795,1099,-304
2013,24142,San Andrés del Rabanedo,León,409,476,-67
2013,24202,Villablino,León,109,181,-72
2013,24222,Villaquilambre,León,230,238,-8
2013,25040,Balaguer,Lleida,259,292,-33
2013,25120,Lleida,Lleida,2547,2726,-179
2013,25137,Mollerussa,Lleida,214,241,-27
2013,25203,La Seu d'Urgell,Lleida,343,300,43
2013,25217,Tàrrega,Lleida,308,361,-53
2013,26018,Arnedo,La Rioja,139,121,18
2013,26036,Calahorra,La Rioja,380,457,-77
2013,26071,Haro,La Rioja,257,307,-50
2013,26089,Logroño,La Rioja,2273,2252,21
2013,27028,Lugo,Lugo,1311,1387,-76
2013,27031,Monforte de Lemos,Lugo,362,333,29
2013,27057,Sarria,Lugo,181,138,43
2013,27065,Vilalba,Lugo,102,138,-36
2013,27066,Viveiro,Lugo,279,233,46
2013,28005,Alcalá de Henares,Madrid,3171,3125,46
2013,28006,Alcobendas,Madrid,1413,1121,292
2013,28007,Alcorcón,Madrid,1805,1660,145
2013,28009,Algete,Madrid,220,233,-13
2013,28010,Alpedrete,Madrid,136,151,-15
2013,28013,Aranjuez,Madrid,1394,1146,248
2013,28014,Arganda del Rey,Madrid,527,578,-51
2013,28015,Arroyomolinos (Madrid),Madrid,335,277,58
2013,28022,Boadilla del Monte,Madrid,461,399,62
2013,28026,Brunete,Madrid,157,142,15
2013,28040,Ciempozuelos,Madrid,303,371,-68
2013,28045,Colmenar Viejo,Madrid,590,524,66
2013,28047,Collado Villalba,Madrid,749,764,-15
2013,28049,Coslada,Madrid,722,768,-46
2013,28054,El Escorial,Madrid,149,193,-44
2013,28058,Fuenlabrada,Madrid,2759,3052,-293
2013,28061,Galapagar,Madrid,350,380,-30
2013,28065,Getafe,Madrid,2484,1978,506
2013,28068,Guadarrama,Madrid,163,161,2
2013,28073,Humanes de Madrid,Madrid,344,345,-1
2013,28074,Leganés,Madrid,2119,1897,222
2013,28079,Madrid,Madrid,52812,39565,13247
2013,28080,Majadahonda,Madrid,835,681,154
2013,28083,Meco,Madrid,261,217,44
2013,28084,Mejorada del Campo,Madrid,228,210,18
2013,28090,Moralzarzal,Madrid,94,85,9
2013,28092,Móstoles,Madrid,2768,2662,106
2013,28096,Navalcarnero,Madrid,397,415,-18
2013,28104,Paracuellos de Jarama,Madrid,330,322,8
2013,28106,Parla,Madrid,2194,2150,44
2013,28113,Pinto,Madrid,649,617,32
2013,28115,Pozuelo de Alarcón,Madrid,823,733,90
2013,28123,Rivas-Vaciamadrid,Madrid,691,651,40
2013,28127,Las Rozas de Madrid,Madrid,1076,915,161
2013,28129,San Agustín del Guadalix,Madrid,136,149,-13
2013,28130,San Fernando de Henares,Madrid,296,344,-48
2013,28131,San Lorenzo de El Escorial,Madrid,221,207,14
2013,28132,San Martín de la Vega,Madrid,223,286,-63
2013,28134,San Sebastián de los Reyes,Madrid,1144,1022,122
2013,28148,Torrejón de Ardoz,Madrid,1711,1572,139
2013,28152,Torrelodones,Madrid,227,254,-27
2013,28160,Valdemorillo,Madrid,110,112,-2
2013,28161,Valdemoro,Madrid,1248,1150,98
2013,28167,Velilla de San Antonio,Madrid,104,110,-6
2013,28172,Villalbilla,Madrid,154,165,-11
2013,28176,Villanueva de la Cañada,Madrid,274,230,44
2013,28177,Villanueva del Pardillo,Madrid,190,187,3
2013,28181,Villaviciosa de Odón,Madrid,255,254,1
2013,28903,Tres Cantos,Madrid,505,415,90
2013,29007,Alhaurín de la Torre,Málaga,412,361,51
2013,29008,Alhaurín el Grande,Málaga,183,178,5
2013,29012,Álora,Málaga,78,97,-19
2013,29015,Antequera,Málaga,318,396,-78
2013,29025,Benalmádena,Málaga,1472,1073,399
2013,29038,Cártama,Málaga,230,148,82
2013,29042,Coín,Málaga,211,190,21
2013,29051,Estepona,Málaga,1283,1086,197
2013,29054,Fuengirola,Málaga,1661,1386,275
2013,29067,Málaga,Málaga,6614,5980,634
2013,29068,Manilva,Málaga,561,374,187
2013,29069,Marbella,Málaga,2578,2134,444
2013,29070,Mijas,Málaga,1309,1082,227
2013,29075,Nerja,Málaga,294,269,25
2013,29082,Rincón de la Victoria,Málaga,616,451,165
2013,29084,Ronda,Málaga,541,555,-14
2013,29091,Torrox,Málaga,227,247,-20
2013,29094,Vélez-Málaga,Málaga,1050,844,206
2013,29901,Torremolinos,Málaga,1242,969,273
2013,30002,Abarán,Murcia,82,82,0
2013,30003,Águilas,Murcia,537,558,-21
2013,30005,Alcantarilla,Murcia,429,423,6
2013,30008,Alhama de Murcia,Murcia,268,189,79
2013,30009,Archena,Murcia,347,280,67
2013,30010,Beniel,Murcia,197,170,27
2013,30012,Bullas,Murcia,100,86,14
2013,30013,Calasparra,Murcia,89,118,-29
2013,30015,Caravaca de la Cruz,Murcia,279,226,53
2013,30016,Cartagena,Murcia,2570,2557,13
2013,30017,Cehegín,Murcia,113,120,-7
2013,30018,Ceutí,Murcia,113,102,11
2013,30019,Cieza (Murcia),Murcia,224,224,0
2013,30021,Fuente Álamo de Murcia,Murcia,217,173,44
2013,30022,Jumilla,Murcia,374,303,71
2013,30024,Lorca,Murcia,1223,1013,210
2013,30026,Mazarrón,Murcia,452,461,-9
2013,30027,Molina de Segura,Murcia,874,734,140
2013,30029,Mula,Murcia,210,162,48
2013,30030,Murcia,Murcia,4701,4325,376
2013,30033,Puerto Lumbreras,Murcia,250,218,32
2013,30035,San Javier,Murcia,763,764,-1
2013,30036,San Pedro del Pinatar,Murcia,727,660,67
2013,30037,Torre-Pacheco,Murcia,487,409,78
2013,30038,Las Torres de Cotillas,Murcia,137,205,-68
2013,30039,Totana,Murcia,408,286,122
2013,30041,La Unión,Murcia,248,193,55
2013,30043,Yecla,Murcia,388,458,-70
2013,30901,Santomera,Murcia,179,177,2
2013,30902,Los Alcázares,Murcia,456,379,77
2013,31016,Ansoáin/Antsoain,Navarra,82,82,0
2013,31060,Burlada/Burlata,Navarra,201,182,19
2013,31086,Valle de Egüés,Navarra,143,147,-4
2013,31097,Estella-Lizarra,Navarra,196,159,37
2013,31201,Pamplona/Iruña,Navarra,2529,2494,35
2013,31227,Tafalla,Navarra,86,78,8
2013,31232,Tudela,Navarra,824,809,15
2013,31258,Villava/Atarrabia,Navarra,53,66,-13
2013,31901,Barañain,Navarra,230,252,-22
2013,31907,Zizur Mayor/Zizur Nagusia,Navarra,98,129,-31
2013,32008,Barbadás,Ourense,151,132,19
2013,32009,O Barco de Valdeorras,Ourense,242,237,5
2013,32019,O Carballiño,Ourense,161,222,-61
2013,32032,Xinzo de Limia,Ourense,162,140,22
2013,32054,Ourense,Ourense,1547,1628,-81
2013,32085,Verín,Ourense,505,307,198
2013,33002,Aller,Asturias,63,62,1
2013,33004,Avilés,Asturias,683,713,-30
2013,33011,Cangas del Narcea,Asturias,82,74,8
2013,33014,Carreño,Asturias,94,91,3
2013,33016,Castrillón,Asturias,177,164,13
2013,33020,Corvera de Asturias,Asturias,100,111,-11
2013,33024,Gijón,Asturias,2767,2775,-8
2013,33025,Gozón,Asturias,67,64,3
2013,33026,Grado,Asturias,54,66,-12
2013,33031,Langreo,Asturias,260,253,7
2013,33032,Laviana,Asturias,65,56,9
2013,33033,Lena,Asturias,77,112,-35
2013,33034,Valdés,Asturias,64,102,-38
2013,33035,Llanera,Asturias,112,131,-19
2013,33036,Llanes,Asturias,187,175,12
2013,33037,Mieres (Asturias),Asturias,241,282,-41
2013,33044,Oviedo,Asturias,2354,2889,-535
2013,33060,San Martín del Rey Aurelio,Asturias,69,87,-18
2013,33066,Siero,Asturias,464,409,55
2013,33073,Tineo,Asturias,53,46,7
2013,33076,Villaviciosa,Asturias,139,133,6
2013,34120,Palencia,Palencia,992,1163,-171
2013,35002,Agüimes,Las Palmas,354,290,64
2013,35003,Antigua,Las Palmas,414,301,113
2013,35004,Arrecife,Las Palmas,1494,1342,152
2013,35006,Arucas,Las Palmas,214,198,16
2013,35009,Gáldar,Las Palmas,110,126,-16
2013,35011,Ingenio,Las Palmas,264,202,62
2013,35012,Mogán,Las Palmas,346,273,73
2013,35014,La Oliva,Las Palmas,870,776,94
2013,35015,Pájara,Las Palmas,784,624,160
2013,35016,Las Palmas de Gran Canaria,Las Palmas,5272,5120,152
2013,35017,Puerto del Rosario,Las Palmas,1124,1057,67
2013,35018,San Bartolomé,Las Palmas,522,472,50
2013,35019,San Bartolomé de Tirajana,Las Palmas,891,719,172
2013,35021,Santa Brígida,Las Palmas,130,163,-33
2013,35022,Santa Lucía de Tirajana,Las Palmas,958,956,2
2013,35023,Santa María de Guía de Gran Canaria,Las Palmas,70,63,7
2013,35024,Teguise,Las Palmas,554,417,137
2013,35026,Telde,Las Palmas,919,868,51
2013,35027,Teror,Las Palmas,52,51,1
2013,35028,Tías,Las Palmas,568,455,113
2013,35030,Tuineje,Las Palmas,329,302,27
2013,35034,Yaiza,Las Palmas,910,683,227
2013,36003,Baiona,Pontevedra,123,94,29
2013,36004,Bueu,Pontevedra,82,62,20
2013,36005,Caldas de Reis,Pontevedra,67,84,-17
2013,36006,Cambados,Pontevedra,46,108,-62
2013,36008,Cangas,Pontevedra,222,248,-26
2013,36017,A Estrada,Pontevedra,199,281,-82
2013,36021,Gondomar,Pontevedra,78,86,-8
2013,36022,O Grove,Pontevedra,89,125,-36
2013,36023,A Guarda,Pontevedra,71,87,-16
2013,36024,Lalín,Pontevedra,348,341,7
2013,36026,Marín,Pontevedra,281,320,-39
2013,36029,Moaña,Pontevedra,102,127,-25
2013,36033,Mos,Pontevedra,60,91,-31
2013,36035,Nigrán,Pontevedra,165,143,22
2013,36038,Pontevedra,Pontevedra,1080,1041,39
2013,36039,O Porriño,Pontevedra,162,158,4
2013,36041,Poio,Pontevedra,185,200,-15
2013,36042,Ponteareas,Pontevedra,184,243,-59
2013,36045,Redondela,Pontevedra,208,194,14
2013,36051,Sanxenxo,Pontevedra,210,151,59
2013,36054,Tomiño,Pontevedra,119,112,7
2013,36055,Tui,Pontevedra,108,117,-9
2013,36057,Vigo,Pontevedra,3267,3086,181
2013,36060,Vilagarcía de Arousa,Pontevedra,508,491,17
2013,36061,Vilanova de Arousa,Pontevedra,88,69,19
2013,37046,Béjar,Salamanca,238,402,-164
2013,37107,Ciudad Rodrigo,Salamanca,194,212,-18
2013,37274,Salamanca,Salamanca,2094,2493,-399
2013,37294,Santa Marta de Tormes,Salamanca,247,280,-33
2013,38001,Adeje,Santa Cruz de Tenerife,1331,965,366
2013,38006,Arona,Santa Cruz de Tenerife,2299,1711,588
2013,38011,Candelaria,Santa Cruz de Tenerife,459,465,-6
2013,38017,Granadilla de Abona,Santa Cruz de Tenerife,1053,933,120
2013,38019,Guía de Isora,Santa Cruz de Tenerife,344,204,140
2013,38020,Güímar,Santa Cruz de Tenerife,149,130,19
2013,38022,Icod de los Vinos,Santa Cruz de Tenerife,88,90,-2
2013,38023,San Cristóbal de La Laguna,Santa Cruz de Tenerife,1603,1535,68
2013,38024,Los Llanos de Aridane,Santa Cruz de Tenerife,193,224,-31
2013,38026,La Orotava,Santa Cruz de Tenerife,211,240,-29
2013,38028,Puerto de la Cruz,Santa Cruz de Tenerife,590,529,61
2013,38031,Los Realejos,Santa Cruz de Tenerife,159,154,5
2013,38032,El Rosario,Santa Cruz de Tenerife,212,192,20
2013,38035,San Miguel de Abona,Santa Cruz de Tenerife,278,187,91
2013,38037,Santa Cruz de la Palma,Santa Cruz de Tenerife,229,288,-59
2013,38038,Santa Cruz de Tenerife,Santa Cruz de Tenerife,2537,2542,-5
2013,38039,Santa Úrsula,Santa Cruz de Tenerife,124,126,-2
2013,38040,Santiago del Teide,Santa Cruz de Tenerife,165,105,60
2013,38043,Tacoronte,Santa Cruz de Tenerife,123,139,-16
2013,38046,Tegueste,Santa Cruz de Tenerife,56,68,-12
2013,39008,El Astillero,Cantabria,257,151,106
2013,39016,Camargo,Cantabria,233,248,-15
2013,39020,Castro-Urdiales,Cantabria,1341,1387,-46
2013,39025,Los Corrales de Buelna,Cantabria,60,78,-18
2013,39035,Laredo,Cantabria,182,192,-10
2013,39052,Piélagos,Cantabria,275,219,56
2013,39073,Santa Cruz de Bezana,Cantabria,113,98,15
2013,39075,Santander,Cantabria,2021,2332,-311
2013,39079,Santoña,Cantabria,163,186,-23
2013,39087,Torrelavega,Cantabria,468,532,-64
2013,40194,Segovia,Segovia,787,1093,-306
2013,41004,Alcalá de Guadaíra,Sevilla,612,601,11
2013,41005,Alcalá del Río,Sevilla,97,85,12
2013,41007,La Algaba,Sevilla,113,133,-20
2013,41011,Arahal,Sevilla,102,101,1
2013,41017,Bormujos,Sevilla,227,237,-10
2013,41018,Brenes,Sevilla,85,124,-39
2013,41020,Las Cabezas de San Juan,Sevilla,133,175,-42
2013,41021,Camas,Sevilla,257,240,17
2013,41023,Cantillana,Sevilla,67,85,-18
2013,41024,Carmona,Sevilla,194,201,-7
2013,41029,Castilleja de la Cuesta,Sevilla,154,162,-8
2013,41034,Coria del Río,Sevilla,272,293,-21
2013,41038,Dos Hermanas,Sevilla,1013,1208,-195
2013,41039,Écija,Sevilla,303,445,-142
2013,41040,Espartinas,Sevilla,187,189,-2
2013,41041,Estepa,Sevilla,121,130,-9
2013,41047,Gines,Sevilla,95,140,-45
2013,41049,Guillena,Sevilla,99,114,-15
2013,41053,Lebrija,Sevilla,210,277,-67
2013,41055,Lora del Río,Sevilla,194,164,30
2013,41058,Mairena del Alcor,Sevilla,152,178,-26
2013,41059,Mairena del Aljarafe,Sevilla,505,505,0
2013,41060,Marchena,Sevilla,95,132,-37
2013,41065,Morón de la Frontera,Sevilla,264,276,-12
2013,41068,Osuna,Sevilla,174,150,24
2013,41069,Los Palacios y Villafranca,Sevilla,215,252,-37
2013,41075,Pilas,Sevilla,136,130,6
2013,41077,La Puebla de Cazalla,Sevilla,155,208,-53
2013,41079,La Puebla del Río,Sevilla,68,116,-48
2013,41081,La Rinconada,Sevilla,254,305,-51
2013,41086,San Juan de Aznalfarache,Sevilla,275,302,-27
2013,41087,Sanlúcar la Mayor,Sevilla,144,163,-19
2013,41091,Sevilla,Sevilla,6906,7661,-755
2013,41093,Tomares,Sevilla,340,350,-10
2013,41095,Utrera,Sevilla,463,498,-35
2013,41102,El Viso del Alcor,Sevilla,80,89,-9
2013,42173,Soria,Soria,567,707,-140
2013,43004,Alcanar,Tarragona,150,214,-64
2013,43014,Amposta,Tarragona,220,419,-199
2013,43037,Calafell,Tarragona,1167,1351,-184
2013,43038,Cambrils,Tarragona,804,726,78
2013,43051,Cunit,Tarragona,641,739,-98
2013,43092,Mont-roig del Camp,Tarragona,267,323,-56
2013,43123,Reus,Tarragona,1085,1330,-245
2013,43136,Sant Carles de la Ràpita,Tarragona,357,317,40
2013,43148,Tarragona,Tarragona,2175,2289,-114
2013,43153,Torredembarra,Tarragona,442,364,78
2013,43155,Tortosa,Tarragona,386,507,-121
2013,43161,Valls,Tarragona,337,347,-10
2013,43163,El Vendrell,Tarragona,1299,1235,64
2013,43171,Vila-seca,Tarragona,442,376,66
2013,43901,Deltebre,Tarragona,143,137,6
2013,43905,Salou,Tarragona,817,751,66
2013,44013,Alcañiz,Teruel,297,298,-1
2013,44216,Teruel,Teruel,532,632,-100
2013,45053,Consuegra,Toledo,78,138,-60
2013,45066,Fuensalida,Toledo,283,395,-112
2013,45081,Illescas,Toledo,1386,1281,105
2013,45087,Madridejos,Toledo,128,146,-18
2013,45106,Mora,Toledo,81,167,-86
2013,45121,Ocaña,Toledo,619,778,-159
2013,45142,Quintanar de la Orden,Toledo,211,298,-87
2013,45161,Seseña,Toledo,2125,1682,443
2013,45163,Sonseca,Toledo,127,204,-77
2013,45165,Talavera de la Reina,Toledo,1340,1874,-534
2013,45168,Toledo,Toledo,1632,1930,-298
2013,45173,Torrijos,Toledo,241,323,-82
2013,45205,Yuncos,Toledo,516,653,-137
2013,46005,Alaquàs,Valencia,237,215,22
2013,46007,Albal,Valencia,109,124,-15
2013,46011,Alberic,Valencia,73,103,-30
2013,46013,Alboraya,Valencia,274,225,49
2013,46017,Alzira,Valencia,409,440,-31
2013,46019,L'Alcúdia,Valencia,69,63,6
2013,46021,Aldaia,Valencia,238,298,-60
2013,46022,Alfafar,Valencia,208,270,-62
2013,46029,Algemesí,Valencia,170,166,4
2013,46031,Alginet,Valencia,104,128,-24
2013,46051,Benaguasil,Valencia,77,97,-20
2013,46054,Benetússer,Valencia,83,87,-4
2013,46060,Benifaió,Valencia,92,79,13
2013,46070,Bétera,Valencia,233,231,2
2013,46078,Burjassot,Valencia,303,344,-41
2013,46081,Canals,Valencia,78,113,-35
2013,46083,Carcaixent,Valencia,178,174,4
2013,46085,Carlet,Valencia,128,107,21
2013,46094,Catarroja,Valencia,204,255,-51
2013,46102,Quart de Poblet,Valencia,181,183,-2
2013,46105,Cullera,Valencia,279,252,27
2013,46110,Xirivella,Valencia,290,321,-31
2013,46111,Chiva,Valencia,133,156,-23
2013,46116,L'Eliana,Valencia,163,237,-74
2013,46131,Gandia,Valencia,1305,1266,39
2013,46135,Godella,Valencia,109,124,-15
2013,46145,Xátiva,Valencia,245,276,-31
2013,46147,Llíria,Valencia,237,225,12
2013,46159,Manises,Valencia,253,333,-80
2013,46164,Massamagrell,Valencia,97,122,-25
2013,46166,Meliana,Valencia,74,65,9
2013,46169,Mislata,Valencia,446,450,-4
2013,46171,Moncada,Valencia,138,132,6
2013,46181,Oliva,Valencia,366,380,-14
2013,46184,Ontinyent,Valencia,241,349,-108
2013,46186,Paiporta,Valencia,219,212,7
2013,46190,Paterna,Valencia,629,737,-108
2013,46193,Picanya,Valencia,91,125,-34
2013,46194,Picassent,Valencia,162,137,25
2013,46202,La Pobla de Vallbona,Valencia,237,232,5
2013,46205,Puçol,Valencia,175,176,-1
2013,46213,Requena,Valencia,205,167,38
2013,46214,Riba-roja de Túria,Valencia,176,174,2
2013,46220,Sagunto/Sagunt,Valencia,872,937,-65
2013,46223,Sedaví,Valencia,99,78,21
2013,46230,Silla,Valencia,156,214,-58
2013,46235,Sueca,Valencia,169,214,-45
2013,46238,Tavernes de la Valldigna,Valencia,154,135,19
2013,46244,Torrent (Valencia),Valencia,791,796,-5
2013,46249,Utiel,Valencia,98,95,3
2013,46250,València,Valencia,10274,10217,57
2013,47010,Arroyo de la Encomienda,Valladolid,387,298,89
2013,47076,Laguna de Duero,Valladolid,235,301,-66
2013,47085,Medina del Campo,Valladolid,213,319,-106
2013,47186,Valladolid,Valladolid,3461,4157,-696
2013,48003,Amorebieta-Etxano,Vizcaya,135,130,5
2013,48011,Arrigorriaga,Vizcaya,94,82,12
2013,48013,Barakaldo,Vizcaya,1002,1012,-10
2013,48015,Basauri,Vizcaya,327,325,2
2013,48017,Bermeo,Vizcaya,151,144,7
2013,48020,Bilbao,Vizcaya,4271,3978,293
2013,48027,Durango,Vizcaya,254,233,21
2013,48029,Etxebarri,Vizcaya,77,77,0
2013,48034,Ermua,Vizcaya,199,284,-85
2013,48036,Galdakao,Vizcaya,238,198,40
2013,48044,Getxo,Vizcaya,778,824,-46
2013,48046,Gernika-Lumo,Vizcaya,97,109,-12
2013,48054,Leioa,Vizcaya,231,249,-18
2013,48069,Mungia,Vizcaya,210,134,76
2013,48078,Portugalete,Vizcaya,372,316,56
2013,48080,Valle de Trápaga-Trapagaran,Vizcaya,106,90,16
2013,48082,Santurtzi,Vizcaya,443,436,7
2013,48084,Sestao,Vizcaya,237,246,-9
2013,48085,Sopela,Vizcaya,118,118,0
2013,48902,Erandio,Vizcaya,177,193,-16
2013,49021,Benavente,Zamora,273,417,-144
2013,49275,Zamora,Zamora,800,1086,-286
2013,50067,Calatayud,Zaragoza,488,479,9
2013,50089,Cuarte de Huerva,Zaragoza,287,224,63
2013,50095,Ejea de los Caballeros,Zaragoza,193,187,6
2013,50251,Tarazona,Zaragoza,142,181,-39
2013,50272,Utebo,Zaragoza,223,209,14
2013,50297,Zaragoza,Zaragoza,8737,8433,304
2013,51001,Ceuta,Ceuta,2994,2498,496
2013,52001,Melilla,Melilla,3725,3094,631
2014,01002,Amurrio,Álava,225,160,65
2014,01036,Laudio/Llodio,Álava,292,337,-45
2014,01059,Vitoria-Gasteiz,Álava,4560,3185,1375
2014,02003,Albacete,Albacete,2264,2861,-597
2014,02009,Almansa,Albacete,332,430,-98
2014,02025,Caudete,Albacete,203,271,-68
2014,02037,Hellín,Albacete,493,596,-103
2014,02069,La Roda,Albacete,234,315,-81
2014,02081,Villarrobledo,Albacete,362,449,-87
2014,03005,Albatera,Alicante,133,96,37
2014,03009,Alcoy/Alcoi,Alicante,551,569,-18
2014,03011,L'Alfàs del Pi,Alicante,277,261,16
2014,03014,Alicante/Alacant,Alicante,5005,5077,-72
2014,03015,Almoradí,Alicante,256,260,-4
2014,03018,Altea,Alicante,389,390,-1
2014,03019,Aspe,Alicante,183,180,3
2014,03031,Benidorm,Alicante,2053,1783,270
2014,03041,Benissa,Alicante,120,116,4
2014,03047,Calp,Alicante,376,447,-71
2014,03049,Callosa de Segura,Alicante,145,168,-23
2014,03050,El Campello,Alicante,431,427,4
2014,03053,Castalla,Alicante,76,98,-22
2014,03056,Cocentaina,Alicante,169,134,35
2014,03059,Crevillent,Alicante,256,232,24
2014,03063,Dénia,Alicante,756,814,-58
2014,03065,Elche/Elx,Alicante,2384,2439,-55
2014,03066,Elda,Alicante,451,460,-9
2014,03076,Guardamar del Segura,Alicante,316,267,49
2014,03079,Ibi,Alicante,163,222,-59
2014,03082,Jávea/Xàbia,Alicante,472,459,13
2014,03089,Monóvar/Monòver,Alicante,63,87,-24
2014,03090,Mutxamel,Alicante,209,213,-4
2014,03093,Novelda,Alicante,187,206,-19
2014,03094,La Nucia,Alicante,276,215,61
2014,03099,Orihuela,Alicante,1167,1305,-138
2014,03102,Pego,Alicante,169,143,26
2014,03104,Petrer,Alicante,170,274,-104
2014,03113,Rojales,Alicante,102,101,1
2014,03119,Sant Joan d'Alacant,Alicante,292,258,34
2014,03121,Santa Pola,Alicante,711,611,100
2014,03122,San Vicente del Raspeig/Sant Vicent del Raspeig,Alicante,643,579,64
2014,03128,Teulada,Alicante,132,146,-14
2014,03133,Torrevieja,Alicante,3140,2961,179
2014,03139,Villajoyosa/La Vila Joiosa,Alicante,592,609,-17
2014,03140,Villena,Alicante,304,428,-124
2014,03902,Pilar de la Horadada,Alicante,705,651,54
2014,04003,Adra,Almería,237,289,-52
2014,04006,Albox,Almería,141,181,-40
2014,04013,Almería,Almería,2461,2283,178
2014,04029,Berja,Almería,135,135,0
2014,04035,Cuevas del Almanzora,Almería,219,212,7
2014,04052,Huércal de Almería,Almería,130,145,-15
2014,04053,Huércal-Overa,Almería,320,297,23
2014,04066,Níjar,Almería,420,422,-2
2014,04079,Roquetas de Mar,Almería,2224,1797,427
2014,04100,Vera,Almería,410,383,27
2014,04102,Vícar,Almería,480,366,114
2014,04902,El Ejido,Almería,1484,1146,338
2014,05019,Ávila,Ávila,946,1239,-293
2014,06011,Almendralejo,Badajoz,406,590,-184
2014,06015,Badajoz,Badajoz,1776,2179,-403
2014,06044,Don Benito,Badajoz,391,546,-155
2014,06083,Mérida,Badajoz,819,926,-107
2014,06088,Montijo,Badajoz,127,173,-46
2014,06095,Olivenza,Badajoz,118,122,-4
2014,06149,Villafranca de los Barros,Badajoz,135,156,-21
2014,06153,Villanueva de la Serena,Badajoz,311,388,-77
2014,06158,Zafra,Badajoz,231,231,0
2014,07003,Alcúdia,Baleares,628,485,143
2014,07005,Andratx,Baleares,151,109,42
2014,07011,Calvià,Baleares,1102,935,167
2014,07014,Capdepera,Baleares,471,349,122
2014,07015,Ciutadella de Menorca,Baleares,914,1043,-129
2014,07022,Felanitx,Baleares,214,190,24
2014,07024,Formentera,Baleares,943,686,257
2014,07026,Eivissa,Baleares,2213,1717,496
2014,07027,Inca,Baleares,415,415,0
2014,07031,Llucmajor,Baleares,731,580,151
2014,07032,Maó-Mahón,Baleares,788,917,-129
2014,07033,Manacor,Baleares,606,638,-32
2014,07036,Marratxí,Baleares,230,250,-20
2014,07040,Palma,Baleares,7479,6421,1058
2014,07042,Pollença,Baleares,251,192,59
2014,07044,Sa Pobla,Baleares,107,99,8
2014,07046,Sant Antoni de Portmany,Baleares,1270,840,430
2014,07048,Sant Josep de sa Talaia,Baleares,1327,1008,319
2014,07054,Santa Eulària des Riu,Baleares,1632,1225,407
2014,07055,Santa Margalida,Baleares,249,215,34
2014,07057,Santanyí,Baleares,237,280,-43
2014,07061,Sóller,Baleares,166,145,21
2014,07062,Son Servera,Baleares,299,227,72
2014,08001,Abrera,Barcelona,96,89,7
2014,08006,Arenys de Mar,Barcelona,106,124,-18
2014,08009,Argentona,Barcelona,81,69,12
2014,08015,Badalona,Barcelona,1851,1927,-76
2014,08019,Barcelona,Barcelona,21571,17540,4031
2014,08022,Berga,Barcelona,137,134,3
2014,08033,Caldes de Montbui,Barcelona,127,121,6
2014,08035,Calella,Barcelona,205,206,-1
2014,08040,Canet de Mar,Barcelona,117,110,7
2014,08041,Canovelles,Barcelona,127,169,-42
2014,08046,Cardedeu,Barcelona,150,103,47
2014,08051,Castellar del Vallès,Barcelona,144,171,-27
2014,08054,Castellbisbal,Barcelona,118,101,17
2014,08056,Castelldefels,Barcelona,1019,828,191
2014,08072,Corbera de Llobregat,Barcelona,85,121,-36
2014,08073,Cornellà de Llobregat,Barcelona,777,775,2
2014,08074,Cubelles,Barcelona,251,277,-26
2014,08076,Esparreguera,Barcelona,164,175,-11
2014,08077,Esplugues de Llobregat,Barcelona,394,347,47
2014,08086,Les Franqueses del Vallès,Barcelona,192,162,30
2014,08088,La Garriga,Barcelona,93,98,-5
2014,08089,Gavà,Barcelona,447,460,-13
2014,08096,Granollers,Barcelona,607,568,39
2014,08101,L'Hospitalet de Llobregat,Barcelona,3099,2761,338
2014,08102,Igualada,Barcelona,300,386,-86
2014,08105,La Llagosta,Barcelona,117,104,13
2014,08107,Lliçà d'Amunt,Barcelona,96,95,1
2014,08110,Malgrat de Mar,Barcelona,275,295,-20
2014,08112,Manlleu,Barcelona,151,177,-26
2014,08113,Manresa,Barcelona,682,686,-4
2014,08114,Martorell,Barcelona,215,322,-107
2014,08118,El Masnou,Barcelona,167,152,15
2014,08121,Mataró,Barcelona,1171,1065,106
2014,08123,Molins de Rei,Barcelona,131,148,-17
2014,08124,Mollet del Vallès,Barcelona,421,461,-40
2014,08125,Montcada i Reixac,Barcelona,319,252,67
2014,08126,Montgat,Barcelona,94,73,21
2014,08136,Montornès del Vallès,Barcelona,128,108,20
2014,08147,Olesa de Montserrat,Barcelona,170,192,-22
2014,08156,Palau-solità i Plegamans,Barcelona,87,99,-12
2014,08157,Pallejà,Barcelona,76,64,12
2014,08159,Parets del Vallès,Barcelona,153,162,-9
2014,08161,Piera,Barcelona,170,113,57
2014,08163,Pineda de Mar,Barcelona,363,326,37
2014,08169,El Prat de Llobregat,Barcelona,645,541,104
2014,08172,Premià de Mar,Barcelona,205,250,-45
2014,08180,Ripollet,Barcelona,341,334,7
2014,08181,La Roca del Vallès,Barcelona,69,59,10
2014,08184,Rubí,Barcelona,685,645,40
2014,08187,Sabadell,Barcelona,2036,1724,312
2014,08194,Sant Adrià de Besòs,Barcelona,405,373,32
2014,08196,Sant Andreu de la Barca,Barcelona,259,267,-8
2014,08197,Sant Andreu de Llavaneres,Barcelona,84,72,12
2014,08200,Sant Boi de Llobregat,Barcelona,710,699,11
2014,08202,Sant Celoni,Barcelona,281,211,70
2014,08205,Sant Cugat del Vallès,Barcelona,902,731,171
2014,08211,Sant Feliu de Llobregat,Barcelona,378,324,54
2014,08217,Sant Joan Despí,Barcelona,270,226,44
2014,08218,Sant Joan de Vilatorrada,Barcelona,53,58,-5
2014,08219,Vilassar de Mar,Barcelona,140,130,10
2014,08221,Sant Just Desvern,Barcelona,140,131,9
2014,08230,Premià de Dalt,Barcelona,81,56,25
2014,08231,Sant Pere de Ribes,Barcelona,379,317,62
2014,08238,Sant Quirze del Vallès,Barcelona,108,149,-41
2014,08240,Sant Sadurní d'Anoia,Barcelona,78,75,3
2014,08245,Santa Coloma de Gramenet,Barcelona,1157,1233,-76
2014,08252,Barberà del Vallès,Barcelona,248,242,6
2014,08260,Santa Perpètua de Mogoda,Barcelona,243,159,84
2014,08263,Sant Vicenç dels Horts,Barcelona,228,244,-16
2014,08266,Cerdanyola del Vallès,Barcelona,449,458,-9
2014,08270,Sitges,Barcelona,402,372,30
2014,08279,Terrassa,Barcelona,1832,1871,-39
2014,08284,Tordera,Barcelona,404,365,39
2014,08285,Torelló,Barcelona,124,116,8
2014,08295,Vallirana,Barcelona,142,146,-4
2014,08298,Vic,Barcelona,592,491,101
2014,08301,Viladecans,Barcelona,652,601,51
2014,08302,Vilanova del Camí,Barcelona,102,119,-17
2014,08305,Vilafranca del Penedès,Barcelona,418,542,-124
2014,08307,Vilanova i la Geltrú,Barcelona,808,735,73
2014,08904,Badia del Vallès,Barcelona,101,117,-16
2014,09018,Aranda de Duero,Burgos,595,590,5
2014,09059,Burgos,Burgos,2197,2615,-418
2014,09219,Miranda de Ebro,Burgos,664,868,-204
2014,10037,Cáceres,Cáceres,1228,1708,-480
2014,10067,Coria,Cáceres,150,176,-26
2014,10121,Miajadas,Cáceres,174,203,-29
2014,10131,Navalmoral de la Mata,Cáceres,329,372,-43
2014,10148,Plasencia,Cáceres,521,723,-202
2014,11004,Algeciras,Cádiz,2021,1806,215
2014,11006,Arcos de la Frontera,Cádiz,271,339,-68
2014,11007,Barbate,Cádiz,283,302,-19
2014,11008,Los Barrios,Cádiz,353,306,47
2014,11012,Cádiz,Cádiz,1057,1423,-366
2014,11014,Conil de la Frontera,Cádiz,234,247,-13
2014,11015,Chiclana de la Frontera,Cádiz,1080,1183,-103
2014,11016,Chipiona,Cádiz,247,265,-18
2014,11020,Jerez de la Frontera,Cádiz,2369,2771,-402
2014,11022,La Línea de la Concepción,Cádiz,660,684,-24
2014,11023,Medina-Sidonia,Cádiz,82,91,-9
2014,11027,El Puerto de Santa María,Cádiz,1255,1509,-254
2014,11028,Puerto Real,Cádiz,397,453,-56
2014,11030,Rota,Cádiz,527,625,-98
2014,11031,San Fernando,Cádiz,985,1362,-377
2014,11032,Sanlúcar de Barrameda,Cádiz,477,567,-90
2014,11033,San Roque,Cádiz,488,495,-7
2014,11035,Tarifa,Cádiz,277,265,12
2014,11038,Ubrique,Cádiz,118,160,-42
2014,11039,Vejer de la Frontera,Cádiz,48,71,-23
2014,11041,Villamartín,Cádiz,102,141,-39
2014,12005,L'Alcora,Castellón,92,109,-17
2014,12009,Almassora,Castellón,306,365,-59
2014,12027,Benicarló,Castellón,512,556,-44
2014,12028,Benicasim/Benicàssim,Castellón,281,268,13
2014,12032,Borriana/Burriana,Castellón,468,530,-62
2014,12040,Castellón de la Plana/Castelló de la Plana,Castellón,2101,2290,-189
2014,12082,Nules,Castellón,174,170,4
2014,12084,Onda,Castellón,191,270,-79
2014,12126,La Vall d'Uixó,Castellón,317,429,-112
2014,12135,Vila-real,Castellón,567,628,-61
2014,12138,Vinaròs,Castellón,733,693,40
2014,13005,Alcázar de San Juan,Ciudad Real,513,655,-142
2014,13023,Bolaños de Calatrava,Ciudad Real,83,89,-6
2014,13028,Campo de Criptana,Ciudad Real,96,204,-108
2014,13034,Ciudad Real,Ciudad Real,935,1339,-404
2014,13039,Daimiel,Ciudad Real,172,215,-43
2014,13053,Manzanares,Ciudad Real,175,283,-108
2014,13056,Miguelturra,Ciudad Real,150,203,-53
2014,13071,Puertollano,Ciudad Real,645,1025,-380
2014,13078,Socuéllamos,Ciudad Real,175,207,-32
2014,13079,La Solana,Ciudad Real,101,129,-28
2014,13082,Tomelloso,Ciudad Real,539,642,-103
2014,13087,Valdepeñas,Ciudad Real,394,529,-135
2014,13096,Villarrubia de los Ojos,Ciudad Real,90,117,-27
2014,14002,Aguilar de la Frontera,Córdoba,57,137,-80
2014,14007,Baena,Córdoba,194,266,-72
2014,14013,Cabra,Córdoba,162,256,-94
2014,14017,La Carlota,Córdoba,170,198,-28
2014,14021,Córdoba,Córdoba,3527,4131,-604
2014,14030,Fuente Palmera,Córdoba,125,172,-47
2014,14038,Lucena,Córdoba,548,714,-166
2014,14042,Montilla,Córdoba,144,169,-25
2014,14049,Palma del Río,Córdoba,323,349,-26
2014,14052,Peñarroya-Pueblonuevo,Córdoba,144,208,-64
2014,14054,Pozoblanco,Córdoba,164,216,-52
2014,14055,Priego de Córdoba,Córdoba,264,342,-78
2014,14056,Puente Genil,Córdoba,372,441,-69
2014,14058,Rute,Córdoba,119,206,-87
2014,15002,Ames,A Coruña,462,449,13
2014,15005,Arteixo,A Coruña,310,326,-16
2014,15009,Betanzos,A Coruña,114,129,-15
2014,15011,Boiro,A Coruña,159,169,-10
2014,15017,Cambre,A Coruña,164,204,-40
2014,15019,Carballo,A Coruña,159,190,-31
2014,15030,A Coruña,A Coruña,2934,3057,-123
2014,15031,Culleredo,A Coruña,284,258,26
2014,15035,Fene,A Coruña,82,115,-33
2014,15036,Ferrol,A Coruña,1086,1179,-93
2014,15041,A Laracha,A Coruña,45,53,-8
2014,15054,Narón,A Coruña,442,488,-46
2014,15057,Noia,A Coruña,126,143,-17
2014,15058,Oleiros,A Coruña,362,417,-55
2014,15059,Ordes,A Coruña,65,63,2
2014,15070,As Pontes de García Rodríguez,A Coruña,82,127,-45
2014,15072,Rianxo,A Coruña,83,100,-17
2014,15073,Ribeira,A Coruña,217,252,-35
2014,15075,Sada (A Coruña),A Coruña,161,170,-9
2014,15078,Santiago de Compostela,A Coruña,1284,1390,-106
2014,15082,Teo,A Coruña,193,194,-1
2014,16078,Cuenca,Cuenca,818,1109,-291
2014,16203,Tarancón,Cuenca,372,428,-56
2014,17015,Banyoles,Girona,187,215,-28
2014,17022,La Bisbal d'Empordà,Girona,119,104,15
2014,17023,Blanes,Girona,1142,1313,-171
2014,17034,Calonge i Sant Antoni,Girona,175,214,-39
2014,17047,Castelló d'Empúries,Girona,163,198,-35
2014,17048,Castell-Platja d'Aro,Girona,247,282,-35
2014,17062,L'Escala,Girona,168,167,1
2014,17066,Figueres,Girona,871,711,160
2014,17079,Girona,Girona,1607,1698,-91
2014,17095,Lloret de Mar,Girona,850,1137,-287
2014,17114,Olot,Girona,445,495,-50
2014,17117,Palafrugell,Girona,292,304,-12
2014,17118,Palamós,Girona,302,285,17
2014,17147,Ripoll,Girona,152,230,-78
2014,17152,Roses,Girona,312,377,-65
2014,17155,Salt,Girona,350,534,-184
2014,17160,Sant Feliu de Guíxols,Girona,367,402,-35
2014,17180,Santa Coloma de Farners,Girona,166,166,0
2014,17199,Torroella de Montgrí,Girona,147,179,-32
2014,18003,Albolote,Granada,214,212,2
2014,18017,Almuñécar,Granada,427,476,-49
2014,18021,Armilla,Granada,544,428,116
2014,18022,Atarfe,Granada,280,286,-6
2014,18023,Baza,Granada,406,403,3
2014,18062,Churriana de la Vega,Granada,219,205,14
2014,18087,Granada,Granada,3987,4448,-461
2014,18089,Guadix,Granada,357,283,74
2014,18100,Huétor Tájar,Granada,159,126,33
2014,18101,Huétor Vega,Granada,108,126,-18
2014,18102,Illora,Granada,55,71,-16
2014,18122,Loja,Granada,185,322,-137
2014,18127,Maracena,Granada,246,287,-41
2014,18140,Motril,Granada,737,832,-95
2014,18145,Ogíjares,Granada,164,215,-51
2014,18153,Peligros,Granada,82,112,-30
2014,18158,Pinos Puente,Granada,87,105,-18
2014,18173,Salobreña,Granada,179,154,25
2014,18175,Santa Fe,Granada,168,167,1
2014,18193,La Zubia,Granada,238,284,-46
2014,18905,Las Gabias,Granada,379,406,-27
2014,18911,Vegas del Genil,Granada,128,86,42
2014,19024,Alovera,Guadalajara,414,455,-41
2014,19046,Azuqueca de Henares,Guadalajara,1352,1492,-140
2014,19071,El Casar,Guadalajara,603,650,-47
2014,19130,Guadalajara,Guadalajara,1616,2045,-429
2014,20009,Andoain,Guipúzcoa,123,87,36
2014,20017,Azkoitia,Guipúzcoa,135,101,34
2014,20018,Azpeitia,Guipúzcoa,221,96,125
2014,20019,Beasain,Guipúzcoa,137,119,18
2014,20030,Eibar,Guipúzcoa,523,398,125
2014,20032,Elgoibar,Guipúzcoa,198,120,78
2014,20036,Hondarribia,Guipúzcoa,183,134,49
2014,20040,Hernani,Guipúzcoa,219,149,70
2014,20045,Irun,Guipúzcoa,1008,794,214
2014,20055,Arrasate/Mondragón,Guipúzcoa,358,342,16
2014,20059,Oñati,Guipúzcoa,51,49,2
2014,20064,Pasaia,Guipúzcoa,133,105,28
2014,20067,Errenteria,Guipúzcoa,424,274,150
2014,20069,Donostia/San Sebastián,Guipúzcoa,2517,2076,441
2014,20071,Tolosa,Guipúzcoa,176,107,69
2014,20074,Bergara,Guipúzcoa,197,156,41
2014,20079,Zarautz,Guipúzcoa,228,216,12
2014,20902,Lasarte-Oria,Guipúzcoa,204,156,48
2014,21002,Aljaraque,Huelva,233,213,20
2014,21005,Almonte,Huelva,431,370,61
2014,21010,Ayamonte,Huelva,309,341,-32
2014,21013,Bollullos Par del Condado,Huelva,129,145,-16
2014,21021,Cartaya,Huelva,391,287,104
2014,21035,Gibraleón,Huelva,101,122,-21
2014,21041,Huelva,Huelva,1243,1603,-360
2014,21042,Isla Cristina,Huelva,226,291,-65
2014,21044,Lepe,Huelva,535,399,136
2014,21050,Moguer,Huelva,319,261,58
2014,21054,La Palma del Condado,Huelva,120,130,-10
2014,21055,Palos de la Frontera,Huelva,125,132,-7
2014,21060,Punta Umbría,Huelva,214,223,-9
2014,21072,Valverde del Camino,Huelva,115,78,37
2014,22048,Barbastro,Huesca,249,238,11
2014,22112,Fraga,Huesca,374,354,20
2014,22125,Huesca,Huesca,877,1025,-148
2014,22130,Jaca,Huesca,467,442,25
2014,22158,Monzón,Huesca,285,286,-1
2014,23002,Alcalá la Real,Jaén,265,384,-119
2014,23003,Alcaudete,Jaén,108,175,-67
2014,23005,Andújar,Jaén,371,609,-238
2014,23009,Baeza,Jaén,195,253,-58
2014,23010,Bailén,Jaén,172,298,-126
2014,23024,La Carolina,Jaén,210,296,-86
2014,23050,Jaén,Jaén,1056,1605,-549
2014,23053,Jódar,Jaén,85,105,-20
2014,23055,Linares,Jaén,726,1140,-414
2014,23058,Mancha Real,Jaén,87,141,-54
2014,23060,Martos,Jaén,148,262,-114
2014,23086,Torredelcampo,Jaén,113,141,-28
2014,23087,Torredonjimeno,Jaén,108,147,-39
2014,23092,Úbeda,Jaén,317,535,-218
2014,23095,Villacarrillo,Jaén,119,172,-53
2014,24008,Astorga,León,161,191,-30
2014,24010,La Bañeza,León,147,172,-25
2014,24089,León,León,1669,2179,-510
2014,24115,Ponferrada,León,829,1164,-335
2014,24142,San Andrés del Rabanedo,León,372,460,-88
2014,24222,Villaquilambre,León,227,286,-59
2014,25040,Balaguer,Lleida,254,265,-11
2014,25120,Lleida,Lleida,2526,2786,-260
2014,25137,Mollerussa,Lleida,242,223,19
2014,25203,La Seu d'Urgell,Lleida,309,337,-28
2014,25217,Tàrrega,Lleida,249,333,-84
2014,26018,Arnedo,La Rioja,160,146,14
2014,26036,Calahorra,La Rioja,374,471,-97
2014,26071,Haro,La Rioja,274,301,-27
2014,26089,Logroño,La Rioja,2438,2380,58
2014,27028,Lugo,Lugo,1240,1338,-98
2014,27031,Monforte de Lemos,Lugo,345,349,-4
2014,27051,Ribadeo,Lugo,195,244,-49
2014,27057,Sarria,Lugo,166,155,11
2014,27065,Vilalba,Lugo,149,115,34
2014,27066,Viveiro,Lugo,211,276,-65
2014,28005,Alcalá de Henares,Madrid,3104,2943,161
2014,28006,Alcobendas,Madrid,1389,1153,236
2014,28007,Alcorcón,Madrid,1672,1761,-89
2014,28009,Algete,Madrid,247,230,17
2014,28010,Alpedrete,Madrid,145,134,11
2014,28013,Aranjuez,Madrid,1385,1218,167
2014,28014,Arganda del Rey,Madrid,563,576,-13
2014,28015,Arroyomolinos (Madrid),Madrid,360,300,60
2014,28022,Boadilla del Monte,Madrid,465,344,121
2014,28026,Brunete,Madrid,146,101,45
2014,28040,Ciempozuelos,Madrid,330,336,-6
2014,28045,Colmenar Viejo,Madrid,643,516,127
2014,28047,Collado Villalba,Madrid,755,767,-12
2014,28049,Coslada,Madrid,739,785,-46
2014,28054,El Escorial,Madrid,140,143,-3
2014,28058,Fuenlabrada,Madrid,2575,2785,-210
2014,28061,Galapagar,Madrid,360,425,-65
2014,28065,Getafe,Madrid,2432,1967,465
2014,28068,Guadarrama,Madrid,187,146,41
2014,28073,Humanes de Madrid,Madrid,381,338,43
2014,28074,Leganés,Madrid,1910,2002,-92
2014,28079,Madrid,Madrid,52389,39093,13296
2014,28080,Majadahonda,Madrid,811,703,108
2014,28083,Meco,Madrid,215,252,-37
2014,28084,Mejorada del Campo,Madrid,238,232,6
2014,28090,Moralzarzal,Madrid,96,104,-8
2014,28092,Móstoles,Madrid,2571,2488,83
2014,28096,Navalcarnero,Madrid,414,403,11
2014,28104,Paracuellos de Jarama,Madrid,361,267,94
2014,28106,Parla,Madrid,1945,1983,-38
2014,28113,Pinto,Madrid,732,689,43
2014,28115,Pozuelo de Alarcón,Madrid,928,686,242
2014,28123,Rivas-Vaciamadrid,Madrid,657,634,23
2014,28127,Las Rozas de Madrid,Madrid,1151,969,182
2014,28129,San Agustín del Guadalix,Madrid,125,175,-50
2014,28130,San Fernando de Henares,Madrid,287,338,-51
2014,28131,San Lorenzo de El Escorial,Madrid,232,237,-5
2014,28132,San Martín de la Vega,Madrid,303,223,80
2014,28134,San Sebastián de los Reyes,Madrid,1183,888,295
2014,28148,Torrejón de Ardoz,Madrid,1701,1656,45
2014,28152,Torrelodones,Madrid,231,252,-21
2014,28160,Valdemorillo,Madrid,108,126,-18
2014,28161,Valdemoro,Madrid,1155,1056,99
2014,28167,Velilla de San Antonio,Madrid,100,99,1
2014,28172,Villalbilla,Madrid,147,161,-14
2014,28176,Villanueva de la Cañada,Madrid,282,257,25
2014,28177,Villanueva del Pardillo,Madrid,204,190,14
2014,28181,Villaviciosa de Odón,Madrid,336,232,104
2014,28903,Tres Cantos,Madrid,557,458,99
2014,29007,Alhaurín de la Torre,Málaga,363,291,72
2014,29008,Alhaurín el Grande,Málaga,227,170,57
2014,29012,Álora,Málaga,93,83,10
2014,29015,Antequera,Málaga,329,412,-83
2014,29025,Benalmádena,Málaga,1304,985,319
2014,29038,Cártama,Málaga,251,204,47
2014,29042,Coín,Málaga,214,225,-11
2014,29051,Estepona,Málaga,1449,1020,429
2014,29054,Fuengirola,Málaga,1716,1271,445
2014,29067,Málaga,Málaga,7342,5908,1434
2014,29068,Manilva,Málaga,573,395,178
2014,29069,Marbella,Málaga,2747,2041,706
2014,29070,Mijas,Málaga,1269,1019,250
2014,29075,Nerja,Málaga,315,250,65
2014,29082,Rincón de la Victoria,Málaga,600,462,138
2014,29084,Ronda,Málaga,529,581,-52
2014,29091,Torrox,Málaga,238,230,8
2014,29094,Vélez-Málaga,Málaga,892,836,56
2014,29901,Torremolinos,Málaga,1295,996,299
2014,30002,Abarán,Murcia,88,97,-9
2014,30003,Águilas,Murcia,665,506,159
2014,30005,Alcantarilla,Murcia,372,438,-66
2014,30008,Alhama de Murcia,Murcia,227,242,-15
2014,30009,Archena,Murcia,315,308,7
2014,30010,Beniel,Murcia,203,192,11
2014,30012,Bullas,Murcia,55,105,-50
2014,30013,Calasparra,Murcia,104,136,-32
2014,30015,Caravaca de la Cruz,Murcia,249,271,-22
2014,30016,Cartagena,Murcia,2501,2889,-388
2014,30017,Cehegín,Murcia,131,146,-15
2014,30018,Ceutí,Murcia,134,126,8
2014,30019,Cieza (Murcia),Murcia,271,220,51
2014,30021,Fuente Álamo de Murcia,Murcia,170,232,-62
2014,30022,Jumilla,Murcia,392,329,63
2014,30024,Lorca,Murcia,1183,1083,100
2014,30026,Mazarrón,Murcia,538,478,60
2014,30027,Molina de Segura,Murcia,812,832,-20
2014,30029,Mula,Murcia,174,145,29
2014,30030,Murcia,Murcia,4326,4492,-166
2014,30033,Puerto Lumbreras,Murcia,224,237,-13
2014,30035,San Javier,Murcia,762,745,17
2014,30036,San Pedro del Pinatar,Murcia,727,685,42
2014,30037,Torre-Pacheco,Murcia,518,517,1
2014,30038,Las Torres de Cotillas,Murcia,120,185,-65
2014,30039,Totana,Murcia,473,319,154
2014,30041,La Unión,Murcia,249,251,-2
2014,30043,Yecla,Murcia,434,444,-10
2014,30901,Santomera,Murcia,230,177,53
2014,30902,Los Alcázares,Murcia,437,370,67
2014,31016,Ansoáin/Antsoain,Navarra,80,78,2
2014,31060,Burlada/Burlata,Navarra,195,179,16
2014,31086,Valle de Egüés,Navarra,134,145,-11
2014,31097,Estella-Lizarra,Navarra,286,131,155
2014,31201,Pamplona/Iruña,Navarra,2547,2316,231
2014,31227,Tafalla,Navarra,72,88,-16
2014,31232,Tudela,Navarra,655,738,-83
2014,31258,Villava/Atarrabia,Navarra,96,56,40
2014,31901,Barañain,Navarra,226,214,12
2014,31907,Zizur Mayor/Zizur Nagusia,Navarra,137,125,12
2014,32008,Barbadás,Ourense,127,138,-11
2014,32009,O Barco de Valdeorras,Ourense,235,281,-46
2014,32019,O Carballiño,Ourense,179,184,-5
2014,32032,Xinzo de Limia,Ourense,129,140,-11
2014,32054,Ourense,Ourense,1538,1778,-240
2014,32085,Verín,Ourense,413,424,-11
2014,33002,Aller,Asturias,46,67,-21
2014,33004,Avilés,Asturias,573,734,-161
2014,33011,Cangas del Narcea,Asturias,64,87,-23
2014,33014,Carreño,Asturias,82,66,16
2014,33016,Castrillón,Asturias,173,220,-47
2014,33020,Corvera de Asturias,Asturias,103,114,-11
2014,33024,Gijón,Asturias,2662,2775,-113
2014,33025,Gozón,Asturias,66,82,-16
2014,33026,Grado,Asturias,45,76,-31
2014,33031,Langreo,Asturias,230,309,-79
2014,33032,Laviana,Asturias,48,69,-21
2014,33033,Lena,Asturias,78,116,-38
2014,33034,Valdés,Asturias,92,114,-22
2014,33035,Llanera,Asturias,88,155,-67
2014,33036,Llanes,Asturias,115,148,-33
2014,33037,Mieres (Asturias),Asturias,255,328,-73
2014,33044,Oviedo,Asturias,2380,2879,-499
2014,33060,San Martín del Rey Aurelio,Asturias,101,133,-32
2014,33066,Siero,Asturias,338,468,-130
2014,33073,Tineo,Asturias,33,49,-16
2014,33076,Villaviciosa,Asturias,130,110,20
2014,34120,Palencia,Palencia,928,1165,-237
2014,35002,Agüimes,Las Palmas,275,312,-37
2014,35003,Antigua,Las Palmas,404,324,80
2014,35004,Arrecife,Las Palmas,1623,1256,367
2014,35006,Arucas,Las Palmas,223,219,4
2014,35009,Gáldar,Las Palmas,134,124,10
2014,35011,Ingenio,Las Palmas,320,265,55
2014,35012,Mogán,Las Palmas,307,284,23
2014,35014,La Oliva,Las Palmas,994,808,186
2014,35015,Pájara,Las Palmas,726,641,85
2014,35016,Las Palmas de Gran Canaria,Las Palmas,4979,5392,-413
2014,35017,Puerto del Rosario,Las Palmas,1120,922,198
2014,35018,San Bartolomé,Las Palmas,428,378,50
2014,35019,San Bartolomé de Tirajana,Las Palmas,823,766,57
2014,35021,Santa Brígida,Las Palmas,104,106,-2
2014,35022,Santa Lucía de Tirajana,Las Palmas,814,847,-33
2014,35023,Santa María de Guía de Gran Canaria,Las Palmas,56,74,-18
2014,35024,Teguise,Las Palmas,514,421,93
2014,35026,Telde,Las Palmas,808,793,15
2014,35027,Teror,Las Palmas,38,38,0
2014,35028,Tías,Las Palmas,599,495,104
2014,35030,Tuineje,Las Palmas,349,265,84
2014,35034,Yaiza,Las Palmas,1047,743,304
2014,36003,Baiona,Pontevedra,91,122,-31
2014,36004,Bueu,Pontevedra,65,83,-18
2014,36006,Cambados,Pontevedra,115,89,26
2014,36008,Cangas,Pontevedra,216,209,7
2014,36017,A Estrada,Pontevedra,195,202,-7
2014,36021,Gondomar,Pontevedra,57,80,-23
2014,36022,O Grove,Pontevedra,122,115,7
2014,36023,A Guarda,Pontevedra,99,115,-16
2014,36024,Lalín,Pontevedra,248,316,-68
2014,36026,Marín,Pontevedra,268,341,-73
2014,36029,Moaña,Pontevedra,146,99,47
2014,36033,Mos,Pontevedra,97,76,21
2014,36035,Nigrán,Pontevedra,138,157,-19
2014,36038,Pontevedra,Pontevedra,1003,1156,-153
2014,36039,O Porriño,Pontevedra,175,199,-24
2014,36041,Poio,Pontevedra,178,168,10
2014,36042,Ponteareas,Pontevedra,172,210,-38
2014,36045,Redondela,Pontevedra,161,206,-45
2014,36051,Sanxenxo,Pontevedra,214,226,-12
2014,36054,Tomiño,Pontevedra,83,85,-2
2014,36055,Tui,Pontevedra,118,141,-23
2014,36057,Vigo,Pontevedra,3130,3315,-185
2014,36060,Vilagarcía de Arousa,Pontevedra,512,518,-6
2014,36061,Vilanova de Arousa,Pontevedra,94,73,21
2014,37046,Béjar,Salamanca,215,258,-43
2014,37107,Ciudad Rodrigo,Salamanca,124,191,-67
2014,37274,Salamanca,Salamanca,2160,2595,-435
2014,37294,Santa Marta de Tormes,Salamanca,214,277,-63
2014,38001,Adeje,Santa Cruz de Tenerife,1205,1017,188
2014,38006,Arona,Santa Cruz de Tenerife,2149,1773,376
2014,38011,Candelaria,Santa Cruz de Tenerife,392,420,-28
2014,38017,Granadilla de Abona,Santa Cruz de Tenerife,1148,950,198
2014,38019,Guía de Isora,Santa Cruz de Tenerife,323,238,85
2014,38020,Güímar,Santa Cruz de Tenerife,158,140,18
2014,38022,Icod de los Vinos,Santa Cruz de Tenerife,84,100,-16
2014,38023,San Cristóbal de La Laguna,Santa Cruz de Tenerife,1529,1470,59
2014,38024,Los Llanos de Aridane,Santa Cruz de Tenerife,202,246,-44
2014,38026,La Orotava,Santa Cruz de Tenerife,283,228,55
2014,38028,Puerto de la Cruz,Santa Cruz de Tenerife,515,514,1
2014,38031,Los Realejos,Santa Cruz de Tenerife,156,172,-16
2014,38032,El Rosario,Santa Cruz de Tenerife,232,188,44
2014,38035,San Miguel de Abona,Santa Cruz de Tenerife,311,256,55
2014,38037,Santa Cruz de la Palma,Santa Cruz de Tenerife,237,247,-10
2014,38038,Santa Cruz de Tenerife,Santa Cruz de Tenerife,2497,2632,-135
2014,38039,Santa Úrsula,Santa Cruz de Tenerife,116,157,-41
2014,38040,Santiago del Teide,Santa Cruz de Tenerife,143,124,19
2014,38043,Tacoronte,Santa Cruz de Tenerife,143,128,15
2014,38046,Tegueste,Santa Cruz de Tenerife,76,74,2
2014,39008,El Astillero,Cantabria,184,197,-13
2014,39016,Camargo,Cantabria,207,236,-29
2014,39020,Castro-Urdiales,Cantabria,1243,1383,-140
2014,39025,Los Corrales de Buelna,Cantabria,59,73,-14
2014,39035,Laredo,Cantabria,188,219,-31
2014,39052,Piélagos,Cantabria,289,265,24
2014,39073,Santa Cruz de Bezana,Cantabria,106,146,-40
2014,39075,Santander,Cantabria,2066,2186,-120
2014,39079,Santoña,Cantabria,185,181,4
2014,39087,Torrelavega,Cantabria,471,546,-75
2014,40194,Segovia,Segovia,893,1098,-205
2014,41004,Alcalá de Guadaíra,Sevilla,650,707,-57
2014,41005,Alcalá del Río,Sevilla,97,92,5
2014,41007,La Algaba,Sevilla,101,109,-8
2014,41011,Arahal,Sevilla,88,147,-59
2014,41016,Bollullos de la Mitación,Sevilla,99,87,12
2014,41017,Bormujos,Sevilla,304,267,37
2014,41018,Brenes,Sevilla,104,140,-36
2014,41020,Las Cabezas de San Juan,Sevilla,124,139,-15
2014,41021,Camas,Sevilla,266,247,19
2014,41023,Cantillana,Sevilla,77,108,-31
2014,41024,Carmona,Sevilla,167,212,-45
2014,41029,Castilleja de la Cuesta,Sevilla,168,191,-23
2014,41034,Coria del Río,Sevilla,289,293,-4
2014,41038,Dos Hermanas,Sevilla,1143,1257,-114
2014,41039,Écija,Sevilla,312,432,-120
2014,41040,Espartinas,Sevilla,178,171,7
2014,41041,Estepa,Sevilla,124,140,-16
2014,41047,Gines,Sevilla,110,152,-42
2014,41049,Guillena,Sevilla,133,118,15
2014,41053,Lebrija,Sevilla,264,258,6
2014,41055,Lora del Río,Sevilla,138,161,-23
2014,41058,Mairena del Alcor,Sevilla,152,167,-15
2014,41059,Mairena del Aljarafe,Sevilla,583,553,30
2014,41060,Marchena,Sevilla,105,169,-64
2014,41065,Morón de la Frontera,Sevilla,254,247,7
2014,41068,Osuna,Sevilla,140,172,-32
2014,41069,Los Palacios y Villafranca,Sevilla,186,239,-53
2014,41075,Pilas,Sevilla,141,169,-28
2014,41077,La Puebla de Cazalla,Sevilla,142,189,-47
2014,41079,La Puebla del Río,Sevilla,89,120,-31
2014,41081,La Rinconada,Sevilla,235,309,-74
2014,41086,San Juan de Aznalfarache,Sevilla,267,326,-59
2014,41087,Sanlúcar la Mayor,Sevilla,126,128,-2
2014,41091,Sevilla,Sevilla,6744,7640,-896
2014,41093,Tomares,Sevilla,293,330,-37
2014,41095,Utrera,Sevilla,457,449,8
2014,41102,El Viso del Alcor,Sevilla,77,141,-64
2014,42173,Soria,Soria,576,740,-164
2014,43014,Amposta,Tarragona,283,365,-82
2014,43037,Calafell,Tarragona,1251,1221,30
2014,43038,Cambrils,Tarragona,776,780,-4
2014,43051,Cunit,Tarragona,659,661,-2
2014,43092,Mont-roig del Camp,Tarragona,325,368,-43
2014,43123,Reus,Tarragona,1050,1281,-231
2014,43136,Sant Carles de la Ràpita,Tarragona,292,336,-44
2014,43148,Tarragona,Tarragona,1968,2338,-370
2014,43153,Torredembarra,Tarragona,430,440,-10
2014,43155,Tortosa,Tarragona,465,491,-26
2014,43161,Valls,Tarragona,258,354,-96
2014,43163,El Vendrell,Tarragona,1142,1196,-54
2014,43171,Vila-seca,Tarragona,416,407,9
2014,43901,Deltebre,Tarragona,141,183,-42
2014,43905,Salou,Tarragona,800,844,-44
2014,44013,Alcañiz,Teruel,220,305,-85
2014,44216,Teruel,Teruel,522,630,-108
2014,45019,Bargas,Toledo,184,220,-36
2014,45053,Consuegra,Toledo,95,132,-37
2014,45066,Fuensalida,Toledo,280,328,-48
2014,45081,Illescas,Toledo,1300,1283,17
2014,45087,Madridejos,Toledo,120,183,-63
2014,45106,Mora,Toledo,81,126,-45
2014,45121,Ocaña,Toledo,467,675,-208
2014,45142,Quintanar de la Orden,Toledo,193,257,-64
2014,45161,Seseña,Toledo,1933,1733,200
2014,45163,Sonseca,Toledo,137,217,-80
2014,45165,Talavera de la Reina,Toledo,1289,1953,-664
2014,45168,Toledo,Toledo,1538,1763,-225
2014,45173,Torrijos,Toledo,245,304,-59
2014,45185,Villacañas,Toledo,115,211,-96
2014,45205,Yuncos,Toledo,450,550,-100
2014,46005,Alaquàs,Valencia,248,284,-36
2014,46007,Albal,Valencia,142,131,11
2014,46011,Alberic,Valencia,97,96,1
2014,46013,Alboraya,Valencia,283,203,80
2014,46017,Alzira,Valencia,434,410,24
2014,46019,L'Alcúdia,Valencia,80,63,17
2014,46021,Aldaia,Valencia,294,280,14
2014,46022,Alfafar,Valencia,202,266,-64
2014,46029,Algemesí,Valencia,233,247,-14
2014,46031,Alginet,Valencia,104,101,3
2014,46051,Benaguasil,Valencia,109,106,3
2014,46054,Benetússer,Valencia,78,100,-22
2014,46060,Benifaió,Valencia,73,77,-4
2014,46070,Bétera,Valencia,285,247,38
2014,46078,Burjassot,Valencia,374,340,34
2014,46081,Canals,Valencia,114,98,16
2014,46083,Carcaixent,Valencia,202,189,13
2014,46085,Carlet,Valencia,121,128,-7
2014,46094,Catarroja,Valencia,241,221,20
2014,46102,Quart de Poblet,Valencia,183,195,-12
2014,46105,Cullera,Valencia,247,261,-14
2014,46110,Xirivella,Valencia,278,307,-29
2014,46111,Chiva,Valencia,135,139,-4
2014,46116,L'Eliana,Valencia,177,165,12
2014,46131,Gandia,Valencia,1198,1262,-64
2014,46135,Godella,Valencia,116,107,9
2014,46145,Xátiva,Valencia,196,327,-131
2014,46147,Llíria,Valencia,239,291,-52
2014,46159,Manises,Valencia,300,272,28
2014,46164,Massamagrell,Valencia,133,129,4
2014,46166,Meliana,Valencia,68,84,-16
2014,46169,Mislata,Valencia,434,543,-109
2014,46171,Moncada,Valencia,157,163,-6
2014,46181,Oliva,Valencia,364,378,-14
2014,46184,Ontinyent,Valencia,304,324,-20
2014,46186,Paiporta,Valencia,206,255,-49
2014,46190,Paterna,Valencia,671,699,-28
2014,46193,Picanya,Valencia,126,102,24
2014,46194,Picassent,Valencia,180,171,9
2014,46202,La Pobla de Vallbona,Valencia,241,213,28
2014,46205,Puçol,Valencia,167,194,-27
2014,46213,Requena,Valencia,158,204,-46
2014,46214,Riba-roja de Túria,Valencia,182,205,-23
2014,46220,Sagunto/Sagunt,Valencia,811,873,-62
2014,46223,Sedaví,Valencia,89,110,-21
2014,46230,Silla,Valencia,171,198,-27
2014,46235,Sueca,Valencia,198,196,2
2014,46238,Tavernes de la Valldigna,Valencia,114,151,-37
2014,46244,Torrent (Valencia),Valencia,768,806,-38
2014,46249,Utiel,Valencia,95,118,-23
2014,46250,València,Valencia,10717,10215,502
2014,47010,Arroyo de la Encomienda,Valladolid,424,305,119
2014,47076,Laguna de Duero,Valladolid,275,287,-12
2014,47085,Medina del Campo,Valladolid,246,334,-88
2014,47186,Valladolid,Valladolid,3880,4317,-437
2014,48003,Amorebieta-Etxano,Vizcaya,169,119,50
2014,48011,Arrigorriaga,Vizcaya,120,96,24
2014,48013,Barakaldo,Vizcaya,1061,918,143
2014,48015,Basauri,Vizcaya,324,355,-31
2014,48017,Bermeo,Vizcaya,108,141,-33
2014,48020,Bilbao,Vizcaya,4372,3952,420
2014,48027,Durango,Vizcaya,289,241,48
2014,48029,Etxebarri,Vizcaya,75,55,20
2014,48034,Ermua,Vizcaya,234,295,-61
2014,48036,Galdakao,Vizcaya,216,213,3
2014,48044,Getxo,Vizcaya,747,775,-28
2014,48046,Gernika-Lumo,Vizcaya,140,125,15
2014,48054,Leioa,Vizcaya,229,281,-52
2014,48069,Mungia,Vizcaya,209,150,59
2014,48078,Portugalete,Vizcaya,380,394,-14
2014,48080,Valle de Trápaga-Trapagaran,Vizcaya,80,77,3
2014,48082,Santurtzi,Vizcaya,394,391,3
2014,48084,Sestao,Vizcaya,239,246,-7
2014,48085,Sopela,Vizcaya,122,118,4
2014,48902,Erandio,Vizcaya,185,207,-22
2014,49021,Benavente,Zamora,247,428,-181
2014,49275,Zamora,Zamora,797,1049,-252
2014,50067,Calatayud,Zaragoza,634,536,98
2014,50089,Cuarte de Huerva,Zaragoza,271,186,85
2014,50095,Ejea de los Caballeros,Zaragoza,166,230,-64
2014,50251,Tarazona,Zaragoza,164,162,2
2014,50272,Utebo,Zaragoza,244,242,2
2014,50297,Zaragoza,Zaragoza,9017,8560,457
2014,51001,Ceuta,Ceuta,2194,2792,-598
2014,52001,Melilla,Melilla,3208,3007,201
2015,01002,Amurrio,Álava,167,158,9
2015,01036,Laudio/Llodio,Álava,286,281,5
2015,01059,Vitoria-Gasteiz,Álava,4256,3351,905
2015,02003,Albacete,Albacete,2317,2839,-522
2015,02009,Almansa,Albacete,382,430,-48
2015,02025,Caudete,Albacete,219,274,-55
2015,02037,Hellín,Albacete,492,626,-134
2015,02069,La Roda,Albacete,195,269,-74
2015,02081,Villarrobledo,Albacete,404,505,-101
2015,03005,Albatera,Alicante,122,121,1
2015,03009,Alcoy/Alcoi,Alicante,535,608,-73
2015,03011,L'Alfàs del Pi,Alicante,259,267,-8
2015,03014,Alicante/Alacant,Alicante,4966,4910,56
2015,03015,Almoradí,Alicante,250,235,15
2015,03018,Altea,Alicante,470,346,124
2015,03019,Aspe,Alicante,165,163,2
2015,03031,Benidorm,Alicante,1977,1692,285
2015,03041,Benissa,Alicante,123,94,29
2015,03047,Calp,Alicante,371,369,2
2015,03049,Callosa de Segura,Alicante,178,132,46
2015,03050,El Campello,Alicante,442,416,26
2015,03056,Cocentaina,Alicante,161,146,15
2015,03059,Crevillent,Alicante,252,194,58
2015,03063,Dénia,Alicante,821,792,29
2015,03065,Elche/Elx,Alicante,2473,2386,87
2015,03066,Elda,Alicante,316,537,-221
2015,03076,Guardamar del Segura,Alicante,269,303,-34
2015,03079,Ibi,Alicante,186,175,11
2015,03082,Jávea/Xàbia,Alicante,465,445,20
2015,03089,Monóvar/Monòver,Alicante,46,76,-30
2015,03090,Mutxamel,Alicante,232,271,-39
2015,03093,Novelda,Alicante,181,207,-26
2015,03094,La Nucia,Alicante,232,222,10
2015,03099,Orihuela,Alicante,1044,1116,-72
2015,03102,Pego,Alicante,123,157,-34
2015,03104,Petrer,Alicante,218,244,-26
2015,03113,Rojales,Alicante,135,125,10
2015,03119,Sant Joan d'Alacant,Alicante,334,332,2
2015,03121,Santa Pola,Alicante,726,607,119
2015,03122,San Vicente del Raspeig/Sant Vicent del Raspeig,Alicante,610,560,50
2015,03128,Teulada,Alicante,151,125,26
2015,03133,Torrevieja,Alicante,2774,2964,-190
2015,03139,Villajoyosa/La Vila Joiosa,Alicante,668,625,43
2015,03140,Villena,Alicante,372,396,-24
2015,03902,Pilar de la Horadada,Alicante,738,645,93
2015,04003,Adra,Almería,332,291,41
2015,04006,Albox,Almería,208,184,24
2015,04013,Almería,Almería,2548,2519,29
2015,04029,Berja,Almería,128,141,-13
2015,04035,Cuevas del Almanzora,Almería,231,218,13
2015,04052,Huércal de Almería,Almería,167,132,35
2015,04053,Huércal-Overa,Almería,286,303,-17
2015,04066,Níjar,Almería,540,355,185
2015,04079,Roquetas de Mar,Almería,2393,1798,595
2015,04100,Vera,Almería,359,343,16
2015,04102,Vícar,Almería,468,352,116
2015,04902,El Ejido,Almería,1540,1352,188
2015,05019,Ávila,Ávila,930,1256,-326
2015,06011,Almendralejo,Badajoz,462,544,-82
2015,06015,Badajoz,Badajoz,1686,2100,-414
2015,06044,Don Benito,Badajoz,419,493,-74
2015,06083,Mérida,Badajoz,844,902,-58
2015,06088,Montijo,Badajoz,132,204,-72
2015,06095,Olivenza,Badajoz,114,121,-7
2015,06149,Villafranca de los Barros,Badajoz,96,129,-33
2015,06153,Villanueva de la Serena,Badajoz,279,356,-77
2015,06158,Zafra,Badajoz,204,276,-72
2015,07003,Alcúdia,Baleares,507,466,41
2015,07005,Andratx,Baleares,176,100,76
2015,07011,Calvià,Baleares,1117,936,181
2015,07014,Capdepera,Baleares,568,368,200
2015,07015,Ciutadella de Menorca,Baleares,828,937,-109
2015,07022,Felanitx,Baleares,202,189,13
2015,07024,Formentera,Baleares,832,817,15
2015,07026,Eivissa,Baleares,1839,1708,131
2015,07027,Inca,Baleares,455,337,118
2015,07031,Llucmajor,Baleares,790,565,225
2015,07032,Maó-Mahón,Baleares,825,749,76
2015,07033,Manacor,Baleares,785,626,159
2015,07036,Marratxí,Baleares,253,275,-22
2015,07040,Palma,Baleares,7586,6433,1153
2015,07042,Pollença,Baleares,266,176,90
2015,07044,Sa Pobla,Baleares,115,106,9
2015,07046,Sant Antoni de Portmany,Baleares,1335,866,469
2015,07048,Sant Josep de sa Talaia,Baleares,1203,1040,163
2015,07054,Santa Eulària des Riu,Baleares,1545,1344,201
2015,07055,Santa Margalida,Baleares,262,251,11
2015,07057,Santanyí,Baleares,220,199,21
2015,07061,Sóller,Baleares,187,123,64
2015,07062,Son Servera,Baleares,253,215,38
2015,08001,Abrera,Barcelona,96,89,7
2015,08006,Arenys de Mar,Barcelona,123,149,-26
2015,08009,Argentona,Barcelona,69,60,9
2015,08015,Badalona,Barcelona,1876,1805,71
2015,08019,Barcelona,Barcelona,21965,17730,4235
2015,08022,Berga,Barcelona,106,108,-2
2015,08033,Caldes de Montbui,Barcelona,104,83,21
2015,08035,Calella,Barcelona,234,213,21
2015,08040,Canet de Mar,Barcelona,88,104,-16
2015,08041,Canovelles,Barcelona,142,133,9
2015,08046,Cardedeu,Barcelona,143,120,23
2015,08051,Castellar del Vallès,Barcelona,124,119,5
2015,08054,Castellbisbal,Barcelona,73,90,-17
2015,08056,Castelldefels,Barcelona,916,791,125
2015,08072,Corbera de Llobregat,Barcelona,73,92,-19
2015,08073,Cornellà de Llobregat,Barcelona,839,753,86
2015,08074,Cubelles,Barcelona,248,254,-6
2015,08076,Esparreguera,Barcelona,184,156,28
2015,08077,Esplugues de Llobregat,Barcelona,358,326,32
2015,08086,Les Franqueses del Vallès,Barcelona,117,165,-48
2015,08088,La Garriga,Barcelona,126,92,34
2015,08089,Gavà,Barcelona,423,408,15
2015,08096,Granollers,Barcelona,633,533,100
2015,08101,L'Hospitalet de Llobregat,Barcelona,3175,2703,472
2015,08102,Igualada,Barcelona,438,398,40
2015,08105,La Llagosta,Barcelona,114,100,14
2015,08107,Lliçà d'Amunt,Barcelona,76,91,-15
2015,08110,Malgrat de Mar,Barcelona,290,266,24
2015,08112,Manlleu,Barcelona,206,188,18
2015,08113,Manresa,Barcelona,723,720,3
2015,08114,Martorell,Barcelona,250,269,-19
2015,08118,El Masnou,Barcelona,182,171,11
2015,08121,Mataró,Barcelona,1085,1071,14
2015,08123,Molins de Rei,Barcelona,176,148,28
2015,08124,Mollet del Vallès,Barcelona,445,364,81
2015,08125,Montcada i Reixac,Barcelona,281,258,23
2015,08126,Montgat,Barcelona,95,95,0
2015,08136,Montornès del Vallès,Barcelona,111,117,-6
2015,08147,Olesa de Montserrat,Barcelona,220,193,27
2015,08156,Palau-solità i Plegamans,Barcelona,84,72,12
2015,08157,Pallejà,Barcelona,83,98,-15
2015,08159,Parets del Vallès,Barcelona,129,140,-11
2015,08161,Piera,Barcelona,120,158,-38
2015,08163,Pineda de Mar,Barcelona,356,278,78
2015,08169,El Prat de Llobregat,Barcelona,624,551,73
2015,08172,Premià de Mar,Barcelona,188,173,15
2015,08180,Ripollet,Barcelona,290,308,-18
2015,08181,La Roca del Vallès,Barcelona,67,75,-8
2015,08184,Rubí,Barcelona,717,674,43
2015,08187,Sabadell,Barcelona,1878,1782,96
2015,08194,Sant Adrià de Besòs,Barcelona,380,343,37
2015,08196,Sant Andreu de la Barca,Barcelona,281,256,25
2015,08197,Sant Andreu de Llavaneres,Barcelona,69,83,-14
2015,08200,Sant Boi de Llobregat,Barcelona,753,663,90
2015,08202,Sant Celoni,Barcelona,293,235,58
2015,08205,Sant Cugat del Vallès,Barcelona,859,686,173
2015,08211,Sant Feliu de Llobregat,Barcelona,314,317,-3
2015,08217,Sant Joan Despí,Barcelona,242,229,13
2015,08218,Sant Joan de Vilatorrada,Barcelona,53,65,-12
2015,08219,Vilassar de Mar,Barcelona,140,118,22
2015,08221,Sant Just Desvern,Barcelona,151,105,46
2015,08230,Premià de Dalt,Barcelona,60,56,4
2015,08231,Sant Pere de Ribes,Barcelona,347,340,7
2015,08238,Sant Quirze del Vallès,Barcelona,131,117,14
2015,08240,Sant Sadurní d'Anoia,Barcelona,93,82,11
2015,08245,Santa Coloma de Gramenet,Barcelona,1218,1146,72
2015,08252,Barberà del Vallès,Barcelona,231,215,16
2015,08260,Santa Perpètua de Mogoda,Barcelona,199,195,4
2015,08263,Sant Vicenç dels Horts,Barcelona,222,197,25
2015,08266,Cerdanyola del Vallès,Barcelona,498,400,98
2015,08270,Sitges,Barcelona,379,358,21
2015,08279,Terrassa,Barcelona,1931,1731,200
2015,08284,Tordera,Barcelona,397,378,19
2015,08285,Torelló,Barcelona,133,103,30
2015,08295,Vallirana,Barcelona,97,134,-37
2015,08298,Vic,Barcelona,789,467,322
2015,08301,Viladecans,Barcelona,567,606,-39
2015,08302,Vilanova del Camí,Barcelona,102,83,19
2015,08305,Vilafranca del Penedès,Barcelona,452,427,25
2015,08307,Vilanova i la Geltrú,Barcelona,893,659,234
2015,08904,Badia del Vallès,Barcelona,129,101,28
2015,09018,Aranda de Duero,Burgos,520,609,-89
2015,09059,Burgos,Burgos,2105,2639,-534
2015,09219,Miranda de Ebro,Burgos,646,840,-194
2015,10037,Cáceres,Cáceres,1283,1434,-151
2015,10067,Coria,Cáceres,150,194,-44
2015,10131,Navalmoral de la Mata,Cáceres,362,384,-22
2015,10148,Plasencia,Cáceres,474,671,-197
2015,11004,Algeciras,Cádiz,2050,1922,128
2015,11006,Arcos de la Frontera,Cádiz,325,391,-66
2015,11007,Barbate,Cádiz,246,274,-28
2015,11008,Los Barrios,Cádiz,342,322,20
2015,11012,Cádiz,Cádiz,1084,1488,-404
2015,11014,Conil de la Frontera,Cádiz,260,212,48
2015,11015,Chiclana de la Frontera,Cádiz,1098,1085,13
2015,11016,Chipiona,Cádiz,241,242,-1
2015,11020,Jerez de la Frontera,Cádiz,2330,2953,-623
2015,11022,La Línea de la Concepción,Cádiz,693,770,-77
2015,11023,Medina-Sidonia,Cádiz,85,84,1
2015,11027,El Puerto de Santa María,Cádiz,1246,1597,-351
2015,11028,Puerto Real,Cádiz,344,489,-145
2015,11030,Rota,Cádiz,594,660,-66
2015,11031,San Fernando,Cádiz,1062,1324,-262
2015,11032,Sanlúcar de Barrameda,Cádiz,519,520,-1
2015,11033,San Roque,Cádiz,587,500,87
2015,11035,Tarifa,Cádiz,283,264,19
2015,11038,Ubrique,Cádiz,110,147,-37
2015,11039,Vejer de la Frontera,Cádiz,88,82,6
2015,11041,Villamartín,Cádiz,140,177,-37
2015,12005,L'Alcora,Castellón,81,95,-14
2015,12009,Almassora,Castellón,289,287,2
2015,12027,Benicarló,Castellón,523,562,-39
2015,12028,Benicasim/Benicàssim,Castellón,288,284,4
2015,12032,Borriana/Burriana,Castellón,402,470,-68
2015,12040,Castellón de la Plana/Castelló de la Plana,Castellón,2114,2269,-155
2015,12082,Nules,Castellón,145,175,-30
2015,12084,Onda,Castellón,228,285,-57
2015,12126,La Vall d'Uixó,Castellón,298,369,-71
2015,12135,Vila-real,Castellón,492,666,-174
2015,12138,Vinaròs,Castellón,745,742,3
2015,13005,Alcázar de San Juan,Ciudad Real,517,629,-112
2015,13023,Bolaños de Calatrava,Ciudad Real,64,107,-43
2015,13028,Campo de Criptana,Ciudad Real,106,176,-70
2015,13034,Ciudad Real,Ciudad Real,940,1388,-448
2015,13039,Daimiel,Ciudad Real,178,254,-76
2015,13053,Manzanares,Ciudad Real,192,283,-91
2015,13056,Miguelturra,Ciudad Real,148,214,-66
2015,13071,Puertollano,Ciudad Real,609,1033,-424
2015,13078,Socuéllamos,Ciudad Real,206,305,-99
2015,13079,La Solana,Ciudad Real,70,155,-85
2015,13082,Tomelloso,Ciudad Real,484,705,-221
2015,13087,Valdepeñas,Ciudad Real,385,539,-154
2015,13096,Villarrubia de los Ojos,Ciudad Real,80,125,-45
2015,14002,Aguilar de la Frontera,Córdoba,116,116,0
2015,14007,Baena,Córdoba,229,278,-49
2015,14013,Cabra,Córdoba,177,263,-86
2015,14017,La Carlota,Córdoba,160,188,-28
2015,14021,Córdoba,Córdoba,3334,4422,-1088
2015,14030,Fuente Palmera,Córdoba,110,127,-17
2015,14038,Lucena,Córdoba,524,700,-176
2015,14042,Montilla,Córdoba,150,225,-75
2015,14049,Palma del Río,Córdoba,252,288,-36
2015,14052,Peñarroya-Pueblonuevo,Córdoba,130,148,-18
2015,14054,Pozoblanco,Córdoba,186,239,-53
2015,14055,Priego de Córdoba,Córdoba,233,307,-74
2015,14056,Puente Genil,Córdoba,356,531,-175
2015,14058,Rute,Córdoba,144,186,-42
2015,15002,Ames,A Coruña,482,441,41
2015,15005,Arteixo,A Coruña,276,298,-22
2015,15009,Betanzos,A Coruña,111,124,-13
2015,15011,Boiro,A Coruña,167,194,-27
2015,15017,Cambre,A Coruña,189,187,2
2015,15019,Carballo,A Coruña,161,153,8
2015,15030,A Coruña,A Coruña,3315,3018,297
2015,15031,Culleredo,A Coruña,280,262,18
2015,15035,Fene,A Coruña,76,99,-23
2015,15036,Ferrol,A Coruña,1085,1358,-273
2015,15041,A Laracha,A Coruña,53,68,-15
2015,15054,Narón,A Coruña,401,497,-96
2015,15057,Noia,A Coruña,105,141,-36
2015,15058,Oleiros,A Coruña,420,397,23
2015,15059,Ordes,A Coruña,56,78,-22
2015,15070,As Pontes de García Rodríguez,A Coruña,104,140,-36
2015,15072,Rianxo,A Coruña,82,84,-2
2015,15073,Ribeira,A Coruña,224,231,-7
2015,15075,Sada (A Coruña),A Coruña,214,201,13
2015,15078,Santiago de Compostela,A Coruña,1516,1394,122
2015,15082,Teo,A Coruña,176,254,-78
2015,16078,Cuenca,Cuenca,904,1185,-281
2015,16203,Tarancón,Cuenca,306,486,-180
2015,17015,Banyoles,Girona,173,204,-31
2015,17022,La Bisbal d'Empordà,Girona,126,129,-3
2015,17023,Blanes,Girona,1206,1179,27
2015,17034,Calonge i Sant Antoni,Girona,238,214,24
2015,17044,Cassà de la Selva,Girona,81,90,-9
2015,17047,Castelló d'Empúries,Girona,160,202,-42
2015,17048,Castell-Platja d'Aro,Girona,265,285,-20
2015,17062,L'Escala,Girona,130,186,-56
2015,17066,Figueres,Girona,799,781,18
2015,17079,Girona,Girona,1649,1634,15
2015,17095,Lloret de Mar,Girona,836,1026,-190
2015,17114,Olot,Girona,484,501,-17
2015,17117,Palafrugell,Girona,310,285,25
2015,17118,Palamós,Girona,327,274,53
2015,17147,Ripoll,Girona,163,221,-58
2015,17152,Roses,Girona,324,393,-69
2015,17155,Salt,Girona,390,556,-166
2015,17160,Sant Feliu de Guíxols,Girona,384,343,41
2015,17180,Santa Coloma de Farners,Girona,143,136,7
2015,17199,Torroella de Montgrí,Girona,191,154,37
2015,18003,Albolote,Granada,238,247,-9
2015,18017,Almuñécar,Granada,421,463,-42
2015,18021,Armilla,Granada,575,484,91
2015,18022,Atarfe,Granada,237,266,-29
2015,18023,Baza,Granada,408,390,18
2015,18062,Churriana de la Vega,Granada,245,283,-38
2015,18087,Granada,Granada,4509,4629,-120
2015,18089,Guadix,Granada,280,325,-45
2015,18100,Huétor Tájar,Granada,165,135,30
2015,18101,Huétor Vega,Granada,135,128,7
2015,18102,Illora,Granada,61,101,-40
2015,18122,Loja,Granada,187,282,-95
2015,18127,Maracena,Granada,291,251,40
2015,18140,Motril,Granada,632,779,-147
2015,18145,Ogíjares,Granada,185,208,-23
2015,18153,Peligros,Granada,109,119,-10
2015,18158,Pinos Puente,Granada,73,80,-7
2015,18173,Salobreña,Granada,184,193,-9
2015,18175,Santa Fe,Granada,178,172,6
2015,18193,La Zubia,Granada,281,237,44
2015,18905,Las Gabias,Granada,367,353,14
2015,18911,Vegas del Genil,Granada,106,128,-22
2015,19024,Alovera,Guadalajara,486,354,132
2015,19046,Azuqueca de Henares,Guadalajara,1322,1358,-36
2015,19071,El Casar,Guadalajara,572,646,-74
2015,19130,Guadalajara,Guadalajara,1675,1824,-149
2015,20009,Andoain,Guipúzcoa,138,99,39
2015,20017,Azkoitia,Guipúzcoa,123,95,28
2015,20018,Azpeitia,Guipúzcoa,146,105,41
2015,20019,Beasain,Guipúzcoa,93,151,-58
2015,20030,Eibar,Guipúzcoa,432,417,15
2015,20032,Elgoibar,Guipúzcoa,149,146,3
2015,20036,Hondarribia,Guipúzcoa,130,128,2
2015,20040,Hernani,Guipúzcoa,200,132,68
2015,20045,Irun,Guipúzcoa,892,743,149
2015,20055,Arrasate/Mondragón,Guipúzcoa,265,301,-36
2015,20059,Oñati,Guipúzcoa,87,60,27
2015,20063,Oiartzun,Guipúzcoa,61,55,6
2015,20064,Pasaia,Guipúzcoa,159,137,22
2015,20067,Errenteria,Guipúzcoa,409,310,99
2015,20069,Donostia/San Sebastián,Guipúzcoa,2340,2157,183
2015,20071,Tolosa,Guipúzcoa,107,112,-5
2015,20074,Bergara,Guipúzcoa,165,177,-12
2015,20079,Zarautz,Guipúzcoa,205,202,3
2015,20902,Lasarte-Oria,Guipúzcoa,199,187,12
2015,21002,Aljaraque,Huelva,216,241,-25
2015,21005,Almonte,Huelva,416,409,7
2015,21010,Ayamonte,Huelva,289,327,-38
2015,21013,Bollullos Par del Condado,Huelva,111,187,-76
2015,21021,Cartaya,Huelva,293,318,-25
2015,21035,Gibraleón,Huelva,92,115,-23
2015,21041,Huelva,Huelva,1293,1631,-338
2015,21042,Isla Cristina,Huelva,253,308,-55
2015,21044,Lepe,Huelva,405,532,-127
2015,21050,Moguer,Huelva,347,317,30
2015,21054,La Palma del Condado,Huelva,104,164,-60
2015,21055,Palos de la Frontera,Huelva,152,137,15
2015,21060,Punta Umbría,Huelva,217,241,-24
2015,21072,Valverde del Camino,Huelva,158,119,39
2015,22048,Barbastro,Huesca,237,309,-72
2015,22112,Fraga,Huesca,375,359,16
2015,22125,Huesca,Huesca,842,935,-93
2015,22130,Jaca,Huesca,380,454,-74
2015,22158,Monzón,Huesca,306,279,27
2015,23002,Alcalá la Real,Jaén,253,376,-123
2015,23003,Alcaudete,Jaén,112,174,-62
2015,23005,Andújar,Jaén,470,697,-227
2015,23009,Baeza,Jaén,187,276,-89
2015,23010,Bailén,Jaén,146,277,-131
2015,23024,La Carolina,Jaén,179,308,-129
2015,23050,Jaén,Jaén,989,1739,-750
2015,23053,Jódar,Jaén,93,113,-20
2015,23055,Linares,Jaén,559,1131,-572
2015,23058,Mancha Real,Jaén,100,143,-43
2015,23060,Martos,Jaén,200,252,-52
2015,23086,Torredelcampo,Jaén,85,153,-68
2015,23087,Torredonjimeno,Jaén,99,157,-58
2015,23092,Úbeda,Jaén,383,554,-171
2015,23095,Villacarrillo,Jaén,130,168,-38
2015,24008,Astorga,León,157,195,-38
2015,24010,La Bañeza,León,147,165,-18
2015,24089,León,León,1747,2171,-424
2015,24115,Ponferrada,León,789,1080,-291
2015,24142,San Andrés del Rabanedo,León,357,497,-140
2015,24222,Villaquilambre,León,165,278,-113
2015,25040,Balaguer,Lleida,261,298,-37
2015,25120,Lleida,Lleida,2613,2745,-132
2015,25137,Mollerussa,Lleida,209,239,-30
2015,25203,La Seu d'Urgell,Lleida,290,302,-12
2015,25217,Tàrrega,Lleida,270,332,-62
2015,26018,Arnedo,La Rioja,143,154,-11
2015,26036,Calahorra,La Rioja,434,477,-43
2015,26071,Haro,La Rioja,276,282,-6
2015,26089,Logroño,La Rioja,2336,2431,-95
2015,27028,Lugo,Lugo,1358,1433,-75
2015,27031,Monforte de Lemos,Lugo,444,405,39
2015,27057,Sarria,Lugo,158,166,-8
2015,27065,Vilalba,Lugo,120,135,-15
2015,27066,Viveiro,Lugo,231,259,-28
2015,28005,Alcalá de Henares,Madrid,3294,3088,206
2015,28006,Alcobendas,Madrid,1379,1161,218
2015,28007,Alcorcón,Madrid,1702,1629,73
2015,28009,Algete,Madrid,234,252,-18
2015,28010,Alpedrete,Madrid,167,137,30
2015,28013,Aranjuez,Madrid,1344,1135,209
2015,28014,Arganda del Rey,Madrid,619,564,55
2015,28015,Arroyomolinos (Madrid),Madrid,343,288,55
2015,28022,Boadilla del Monte,Madrid,482,403,79
2015,28026,Brunete,Madrid,140,126,14
2015,28040,Ciempozuelos,Madrid,363,254,109
2015,28045,Colmenar Viejo,Madrid,580,584,-4
2015,28047,Collado Villalba,Madrid,797,667,130
2015,28049,Coslada,Madrid,662,701,-39
2015,28054,El Escorial,Madrid,197,118,79
2015,28058,Fuenlabrada,Madrid,2625,2511,114
2015,28061,Galapagar,Madrid,353,337,16
2015,28065,Getafe,Madrid,2485,1889,596
2015,28068,Guadarrama,Madrid,214,171,43
2015,28073,Humanes de Madrid,Madrid,348,281,67
2015,28074,Leganés,Madrid,2209,1765,444
2015,28079,Madrid,Madrid,55821,37288,18533
2015,28080,Majadahonda,Madrid,820,651,169
2015,28083,Meco,Madrid,190,233,-43
2015,28084,Mejorada del Campo,Madrid,224,218,6
2015,28090,Moralzarzal,Madrid,114,89,25
2015,28092,Móstoles,Madrid,2704,2274,430
2015,28096,Navalcarnero,Madrid,444,376,68
2015,28104,Paracuellos de Jarama,Madrid,347,298,49
2015,28106,Parla,Madrid,2033,2056,-23
2015,28113,Pinto,Madrid,792,631,161
2015,28115,Pozuelo de Alarcón,Madrid,930,690,240
2015,28123,Rivas-Vaciamadrid,Madrid,746,660,86
2015,28127,Las Rozas de Madrid,Madrid,1197,860,337
2015,28129,San Agustín del Guadalix,Madrid,136,136,0
2015,28130,San Fernando de Henares,Madrid,305,334,-29
2015,28131,San Lorenzo de El Escorial,Madrid,243,212,31
2015,28132,San Martín de la Vega,Madrid,254,240,14
2015,28134,San Sebastián de los Reyes,Madrid,1108,900,208
2015,28148,Torrejón de Ardoz,Madrid,1700,1537,163
2015,28152,Torrelodones,Madrid,210,216,-6
2015,28160,Valdemorillo,Madrid,140,136,4
2015,28161,Valdemoro,Madrid,1186,1020,166
2015,28167,Velilla de San Antonio,Madrid,93,97,-4
2015,28172,Villalbilla,Madrid,145,99,46
2015,28176,Villanueva de la Cañada,Madrid,252,255,-3
2015,28177,Villanueva del Pardillo,Madrid,165,164,1
2015,28181,Villaviciosa de Odón,Madrid,309,259,50
2015,28903,Tres Cantos,Madrid,660,435,225
2015,29007,Alhaurín de la Torre,Málaga,441,322,119
2015,29008,Alhaurín el Grande,Málaga,207,186,21
2015,29012,Álora,Málaga,123,82,41
2015,29015,Antequera,Málaga,426,393,33
2015,29025,Benalmádena,Málaga,1350,1071,279
2015,29038,Cártama,Málaga,262,194,68
2015,29042,Coín,Málaga,238,188,50
2015,29051,Estepona,Málaga,1351,1103,248
2015,29054,Fuengirola,Málaga,1524,1321,203
2015,29067,Málaga,Málaga,7170,6033,1137
2015,29068,Manilva,Málaga,588,405,183
2015,29069,Marbella,Málaga,2711,2305,406
2015,29070,Mijas,Málaga,1310,1051,259
2015,29075,Nerja,Málaga,319,272,47
2015,29082,Rincón de la Victoria,Málaga,746,465,281
2015,29084,Ronda,Málaga,545,635,-90
2015,29091,Torrox,Málaga,256,197,59
2015,29094,Vélez-Málaga,Málaga,1113,904,209
2015,29901,Torremolinos,Málaga,1335,1044,291
2015,30002,Abarán,Murcia,77,92,-15
2015,30003,Águilas,Murcia,561,541,20
2015,30005,Alcantarilla,Murcia,409,471,-62
2015,30008,Alhama de Murcia,Murcia,220,219,1
2015,30009,Archena,Murcia,361,313,48
2015,30010,Beniel,Murcia,221,200,21
2015,30012,Bullas,Murcia,82,64,18
2015,30013,Calasparra,Murcia,117,120,-3
2015,30015,Caravaca de la Cruz,Murcia,261,235,26
2015,30016,Cartagena,Murcia,2524,2785,-261
2015,30017,Cehegín,Murcia,100,144,-44
2015,30018,Ceutí,Murcia,113,116,-3
2015,30019,Cieza (Murcia),Murcia,275,249,26
2015,30021,Fuente Álamo de Murcia,Murcia,215,241,-26
2015,30022,Jumilla,Murcia,391,380,11
2015,30024,Lorca,Murcia,1153,1153,0
2015,30026,Mazarrón,Murcia,475,511,-36
2015,30027,Molina de Segura,Murcia,799,827,-28
2015,30029,Mula,Murcia,169,212,-43
2015,30030,Murcia,Murcia,4582,4694,-112
2015,30033,Puerto Lumbreras,Murcia,266,240,26
2015,30035,San Javier,Murcia,737,726,11
2015,30036,San Pedro del Pinatar,Murcia,687,705,-18
2015,30037,Torre-Pacheco,Murcia,500,539,-39
2015,30038,Las Torres de Cotillas,Murcia,143,181,-38
2015,30039,Totana,Murcia,378,370,8
2015,30041,La Unión,Murcia,195,231,-36
2015,30043,Yecla,Murcia,419,485,-66
2015,30901,Santomera,Murcia,195,193,2
2015,30902,Los Alcázares,Murcia,405,392,13
2015,31016,Ansoáin/Antsoain,Navarra,78,81,-3
2015,31060,Burlada/Burlata,Navarra,185,147,38
2015,31086,Valle de Egüés,Navarra,159,113,46
2015,31097,Estella-Lizarra,Navarra,188,142,46
2015,31201,Pamplona/Iruña,Navarra,2559,2325,234
2015,31227,Tafalla,Navarra,78,103,-25
2015,31232,Tudela,Navarra,788,618,170
2015,31258,Villava/Atarrabia,Navarra,85,64,21
2015,31901,Barañain,Navarra,224,218,6
2015,31907,Zizur Mayor/Zizur Nagusia,Navarra,122,111,11
2015,32008,Barbadás,Ourense,158,156,2
2015,32009,O Barco de Valdeorras,Ourense,245,226,19
2015,32019,O Carballiño,Ourense,161,199,-38
2015,32032,Xinzo de Limia,Ourense,112,102,10
2015,32054,Ourense,Ourense,1495,1785,-290
2015,32085,Verín,Ourense,321,401,-80
2015,33002,Aller,Asturias,41,74,-33
2015,33004,Avilés,Asturias,584,756,-172
2015,33011,Cangas del Narcea,Asturias,66,94,-28
2015,33014,Carreño,Asturias,75,85,-10
2015,33016,Castrillón,Asturias,136,186,-50
2015,33020,Corvera de Asturias,Asturias,103,113,-10
2015,33024,Gijón,Asturias,2692,2788,-96
2015,33025,Gozón,Asturias,91,95,-4
2015,33026,Grado,Asturias,47,57,-10
2015,33031,Langreo,Asturias,256,300,-44
2015,33032,Laviana,Asturias,48,64,-16
2015,33033,Lena,Asturias,115,103,12
2015,33034,Valdés,Asturias,100,73,27
2015,33035,Llanera,Asturias,101,114,-13
2015,33036,Llanes,Asturias,192,180,12
2015,33037,Mieres (Asturias),Asturias,215,292,-77
2015,33044,Oviedo,Asturias,2297,2768,-471
2015,33060,San Martín del Rey Aurelio,Asturias,79,125,-46
2015,33066,Siero,Asturias,388,422,-34
2015,33073,Tineo,Asturias,35,47,-12
2015,33076,Villaviciosa,Asturias,141,130,11
2015,34120,Palencia,Palencia,918,1182,-264
2015,35002,Agüimes,Las Palmas,354,284,70
2015,35003,Antigua,Las Palmas,400,361,39
2015,35004,Arrecife,Las Palmas,1682,1259,423
2015,35006,Arucas,Las Palmas,257,216,41
2015,35009,Gáldar,Las Palmas,130,87,43
2015,35011,Ingenio,Las Palmas,218,269,-51
2015,35012,Mogán,Las Palmas,297,310,-13
2015,35014,La Oliva,Las Palmas,803,827,-24
2015,35015,Pájara,Las Palmas,700,646,54
2015,35016,Las Palmas de Gran Canaria,Las Palmas,4531,5252,-721
2015,35017,Puerto del Rosario,Las Palmas,1053,911,142
2015,35018,San Bartolomé,Las Palmas,483,448,35
2015,35019,San Bartolomé de Tirajana,Las Palmas,731,838,-107
2015,35021,Santa Brígida,Las Palmas,99,147,-48
2015,35022,Santa Lucía de Tirajana,Las Palmas,778,787,-9
2015,35023,Santa María de Guía de Gran Canaria,Las Palmas,56,67,-11
2015,35024,Teguise,Las Palmas,449,431,18
2015,35026,Telde,Las Palmas,915,823,92
2015,35027,Teror,Las Palmas,38,36,2
2015,35028,Tías,Las Palmas,508,506,2
2015,35030,Tuineje,Las Palmas,339,280,59
2015,35034,Yaiza,Las Palmas,911,797,114
2015,36003,Baiona,Pontevedra,113,116,-3
2015,36004,Bueu,Pontevedra,82,91,-9
2015,36006,Cambados,Pontevedra,119,109,10
2015,36008,Cangas,Pontevedra,224,212,12
2015,36017,A Estrada,Pontevedra,201,257,-56
2015,36021,Gondomar,Pontevedra,66,75,-9
2015,36022,O Grove,Pontevedra,93,113,-20
2015,36023,A Guarda,Pontevedra,100,128,-28
2015,36024,Lalín,Pontevedra,330,354,-24
2015,36026,Marín,Pontevedra,276,346,-70
2015,36029,Moaña,Pontevedra,131,140,-9
2015,36033,Mos,Pontevedra,91,104,-13
2015,36035,Nigrán,Pontevedra,139,168,-29
2015,36038,Pontevedra,Pontevedra,1056,1147,-91
2015,36039,O Porriño,Pontevedra,187,179,8
2015,36041,Poio,Pontevedra,188,213,-25
2015,36042,Ponteareas,Pontevedra,212,205,7
2015,36045,Redondela,Pontevedra,186,223,-37
2015,36051,Sanxenxo,Pontevedra,184,180,4
2015,36054,Tomiño,Pontevedra,76,96,-20
2015,36055,Tui,Pontevedra,134,156,-22
2015,36057,Vigo,Pontevedra,3222,3347,-125
2015,36060,Vilagarcía de Arousa,Pontevedra,414,570,-156
2015,36061,Vilanova de Arousa,Pontevedra,97,103,-6
2015,37046,Béjar,Salamanca,168,285,-117
2015,37107,Ciudad Rodrigo,Salamanca,146,189,-43
2015,37274,Salamanca,Salamanca,1982,2654,-672
2015,37294,Santa Marta de Tormes,Salamanca,219,279,-60
2015,38001,Adeje,Santa Cruz de Tenerife,1068,1154,-86
2015,38006,Arona,Santa Cruz de Tenerife,1770,1838,-68
2015,38011,Candelaria,Santa Cruz de Tenerife,399,446,-47
2015,38017,Granadilla de Abona,Santa Cruz de Tenerife,969,940,29
2015,38019,Guía de Isora,Santa Cruz de Tenerife,296,327,-31
2015,38020,Güímar,Santa Cruz de Tenerife,133,137,-4
2015,38022,Icod de los Vinos,Santa Cruz de Tenerife,97,125,-28
2015,38023,San Cristóbal de La Laguna,Santa Cruz de Tenerife,1329,1644,-315
2015,38024,Los Llanos de Aridane,Santa Cruz de Tenerife,208,242,-34
2015,38026,La Orotava,Santa Cruz de Tenerife,266,294,-28
2015,38028,Puerto de la Cruz,Santa Cruz de Tenerife,504,573,-69
2015,38031,Los Realejos,Santa Cruz de Tenerife,183,196,-13
2015,38032,El Rosario,Santa Cruz de Tenerife,179,225,-46
2015,38035,San Miguel de Abona,Santa Cruz de Tenerife,291,286,5
2015,38037,Santa Cruz de la Palma,Santa Cruz de Tenerife,224,275,-51
2015,38038,Santa Cruz de Tenerife,Santa Cruz de Tenerife,2449,2575,-126
2015,38039,Santa Úrsula,Santa Cruz de Tenerife,106,164,-58
2015,38040,Santiago del Teide,Santa Cruz de Tenerife,151,139,12
2015,38043,Tacoronte,Santa Cruz de Tenerife,139,152,-13
2015,38046,Tegueste,Santa Cruz de Tenerife,58,51,7
2015,39008,El Astillero,Cantabria,138,184,-46
2015,39016,Camargo,Cantabria,273,252,21
2015,39020,Castro-Urdiales,Cantabria,1243,1251,-8
2015,39025,Los Corrales de Buelna,Cantabria,52,64,-12
2015,39035,Laredo,Cantabria,189,224,-35
2015,39052,Piélagos,Cantabria,277,310,-33
2015,39073,Santa Cruz de Bezana,Cantabria,130,110,20
2015,39075,Santander,Cantabria,2026,2180,-154
2015,39079,Santoña,Cantabria,164,144,20
2015,39087,Torrelavega,Cantabria,435,509,-74
2015,40194,Segovia,Segovia,820,1006,-186
2015,41004,Alcalá de Guadaíra,Sevilla,620,671,-51
2015,41005,Alcalá del Río,Sevilla,86,94,-8
2015,41007,La Algaba,Sevilla,83,120,-37
2015,41011,Arahal,Sevilla,104,109,-5
2015,41016,Bollullos de la Mitación,Sevilla,112,105,7
2015,41017,Bormujos,Sevilla,251,245,6
2015,41018,Brenes,Sevilla,86,134,-48
2015,41020,Las Cabezas de San Juan,Sevilla,124,167,-43
2015,41021,Camas,Sevilla,323,341,-18
2015,41023,Cantillana,Sevilla,72,67,5
2015,41024,Carmona,Sevilla,187,228,-41
2015,41029,Castilleja de la Cuesta,Sevilla,176,172,4
2015,41034,Coria del Río,Sevilla,277,308,-31
2015,41038,Dos Hermanas,Sevilla,1208,1178,30
2015,41039,Écija,Sevilla,310,427,-117
2015,41040,Espartinas,Sevilla,240,180,60
2015,41041,Estepa,Sevilla,114,138,-24
2015,41047,Gines,Sevilla,110,124,-14
2015,41049,Guillena,Sevilla,119,164,-45
2015,41053,Lebrija,Sevilla,258,294,-36
2015,41055,Lora del Río,Sevilla,119,170,-51
2015,41058,Mairena del Alcor,Sevilla,181,203,-22
2015,41059,Mairena del Aljarafe,Sevilla,592,541,51
2015,41060,Marchena,Sevilla,123,132,-9
2015,41065,Morón de la Frontera,Sevilla,218,299,-81
2015,41068,Osuna,Sevilla,130,169,-39
2015,41069,Los Palacios y Villafranca,Sevilla,183,245,-62
2015,41075,Pilas,Sevilla,163,160,3
2015,41077,La Puebla de Cazalla,Sevilla,111,156,-45
2015,41079,La Puebla del Río,Sevilla,87,110,-23
2015,41081,La Rinconada,Sevilla,241,361,-120
2015,41086,San Juan de Aznalfarache,Sevilla,304,273,31
2015,41087,Sanlúcar la Mayor,Sevilla,148,164,-16
2015,41091,Sevilla,Sevilla,7662,7685,-23
2015,41093,Tomares,Sevilla,324,365,-41
2015,41095,Utrera,Sevilla,451,467,-16
2015,41102,El Viso del Alcor,Sevilla,115,111,4
2015,42173,Soria,Soria,587,720,-133
2015,43014,Amposta,Tarragona,242,354,-112
2015,43037,Calafell,Tarragona,1254,1196,58
2015,43038,Cambrils,Tarragona,666,746,-80
2015,43051,Cunit,Tarragona,777,660,117
2015,43092,Mont-roig del Camp,Tarragona,242,340,-98
2015,43123,Reus,Tarragona,1254,1285,-31
2015,43136,Sant Carles de la Ràpita,Tarragona,275,374,-99
2015,43148,Tarragona,Tarragona,1945,2424,-479
2015,43153,Torredembarra,Tarragona,431,407,24
2015,43155,Tortosa,Tarragona,447,558,-111
2015,43161,Valls,Tarragona,302,350,-48
2015,43163,El Vendrell,Tarragona,1108,1224,-116
2015,43171,Vila-seca,Tarragona,355,421,-66
2015,43901,Deltebre,Tarragona,134,140,-6
2015,43905,Salou,Tarragona,682,850,-168
2015,44013,Alcañiz,Teruel,276,314,-38
2015,44216,Teruel,Teruel,550,592,-42
2015,45019,Bargas,Toledo,152,194,-42
2015,45053,Consuegra,Toledo,102,134,-32
2015,45066,Fuensalida,Toledo,282,337,-55
2015,45081,Illescas,Toledo,1468,1208,260
2015,45087,Madridejos,Toledo,91,195,-104
2015,45106,Mora,Toledo,73,182,-109
2015,45121,Ocaña,Toledo,433,567,-134
2015,45142,Quintanar de la Orden,Toledo,206,254,-48
2015,45161,Seseña,Toledo,1952,1595,357
2015,45163,Sonseca,Toledo,136,184,-48
2015,45165,Talavera de la Reina,Toledo,1327,1840,-513
2015,45168,Toledo,Toledo,1621,2022,-401
2015,45173,Torrijos,Toledo,237,306,-69
2015,45185,Villacañas,Toledo,117,226,-109
2015,45205,Yuncos,Toledo,447,558,-111
2015,46005,Alaquàs,Valencia,268,270,-2
2015,46007,Albal,Valencia,145,105,40
2015,46011,Alberic,Valencia,116,97,19
2015,46013,Alboraya,Valencia,221,243,-22
2015,46017,Alzira,Valencia,386,378,8
2015,46019,L'Alcúdia,Valencia,86,59,27
2015,46021,Aldaia,Valencia,296,240,56
2015,46022,Alfafar,Valencia,180,204,-24
2015,46029,Algemesí,Valencia,192,201,-9
2015,46031,Alginet,Valencia,119,100,19
2015,46051,Benaguasil,Valencia,111,95,16
2015,46054,Benetússer,Valencia,132,95,37
2015,46060,Benifaió,Valencia,91,71,20
2015,46070,Bétera,Valencia,245,237,8
2015,46078,Burjassot,Valencia,341,367,-26
2015,46081,Canals,Valencia,76,97,-21
2015,46083,Carcaixent,Valencia,179,196,-17
2015,46085,Carlet,Valencia,125,101,24
2015,46094,Catarroja,Valencia,237,187,50
2015,46102,Quart de Poblet,Valencia,184,208,-24
2015,46105,Cullera,Valencia,264,266,-2
2015,46110,Xirivella,Valencia,277,306,-29
2015,46111,Chiva,Valencia,124,102,22
2015,46116,L'Eliana,Valencia,165,150,15
2015,46131,Gandia,Valencia,1164,1355,-191
2015,46135,Godella,Valencia,87,91,-4
2015,46145,Xátiva,Valencia,244,277,-33
2015,46147,Llíria,Valencia,253,252,1
2015,46159,Manises,Valencia,310,303,7
2015,46164,Massamagrell,Valencia,136,121,15
2015,46166,Meliana,Valencia,73,90,-17
2015,46169,Mislata,Valencia,462,428,34
2015,46171,Moncada,Valencia,122,146,-24
2015,46181,Oliva,Valencia,396,403,-7
2015,46184,Ontinyent,Valencia,302,320,-18
2015,46186,Paiporta,Valencia,215,180,35
2015,46190,Paterna,Valencia,731,603,128
2015,46193,Picanya,Valencia,88,108,-20
2015,46194,Picassent,Valencia,149,175,-26
2015,46202,La Pobla de Vallbona,Valencia,248,249,-1
2015,46205,Puçol,Valencia,162,184,-22
2015,46213,Requena,Valencia,167,223,-56
2015,46214,Riba-roja de Túria,Valencia,235,188,47
2015,46220,Sagunto/Sagunt,Valencia,921,777,144
2015,46223,Sedaví,Valencia,83,82,1
2015,46230,Silla,Valencia,174,178,-4
2015,46235,Sueca,Valencia,195,225,-30
2015,46238,Tavernes de la Valldigna,Valencia,142,167,-25
2015,46244,Torrent (Valencia),Valencia,726,781,-55
2015,46249,Utiel,Valencia,73,107,-34
2015,46250,València,Valencia,10717,9916,801
2015,47010,Arroyo de la Encomienda,Valladolid,384,330,54
2015,47076,Laguna de Duero,Valladolid,283,273,10
2015,47085,Medina del Campo,Valladolid,223,249,-26
2015,47186,Valladolid,Valladolid,3769,3967,-198
2015,48003,Amorebieta-Etxano,Vizcaya,153,140,13
2015,48011,Arrigorriaga,Vizcaya,103,106,-3
2015,48013,Barakaldo,Vizcaya,1063,1055,8
2015,48015,Basauri,Vizcaya,327,354,-27
2015,48017,Bermeo,Vizcaya,129,95,34
2015,48020,Bilbao,Vizcaya,4637,3913,724
2015,48027,Durango,Vizcaya,266,285,-19
2015,48029,Etxebarri,Vizcaya,89,66,23
2015,48034,Ermua,Vizcaya,258,274,-16
2015,48036,Galdakao,Vizcaya,230,197,33
2015,48044,Getxo,Vizcaya,713,868,-155
2015,48046,Gernika-Lumo,Vizcaya,102,106,-4
2015,48054,Leioa,Vizcaya,293,241,52
2015,48069,Mungia,Vizcaya,169,156,13
2015,48078,Portugalete,Vizcaya,367,371,-4
2015,48080,Valle de Trápaga-Trapagaran,Vizcaya,100,97,3
2015,48082,Santurtzi,Vizcaya,403,426,-23
2015,48084,Sestao,Vizcaya,291,241,50
2015,48085,Sopela,Vizcaya,136,122,14
2015,48902,Erandio,Vizcaya,225,216,9
2015,49021,Benavente,Zamora,268,382,-114
2015,49275,Zamora,Zamora,775,1082,-307
2015,50067,Calatayud,Zaragoza,634,665,-31
2015,50089,Cuarte de Huerva,Zaragoza,318,267,51
2015,50095,Ejea de los Caballeros,Zaragoza,210,182,28
2015,50251,Tarazona,Zaragoza,127,143,-16
2015,50272,Utebo,Zaragoza,209,192,17
2015,50297,Zaragoza,Zaragoza,8292,8772,-480
2015,51001,Ceuta,Ceuta,2066,2749,-683
2015,52001,Melilla,Melilla,2681,3238,-557
2016,01002,Amurrio,Álava,154,140,14
2016,01036,Laudio/Llodio,Álava,293,314,-21
2016,01059,Vitoria-Gasteiz,Álava,4267,3285,982
2016,02003,Albacete,Albacete,2120,2661,-541
2016,02009,Almansa,Albacete,335,432,-97
2016,02025,Caudete,Albacete,206,257,-51
2016,02037,Hellín,Albacete,404,625,-221
2016,02069,La Roda,Albacete,161,198,-37
2016,02081,Villarrobledo,Albacete,310,461,-151
2016,03005,Albatera,Alicante,126,107,19
2016,03009,Alcoy/Alcoi,Alicante,514,593,-79
2016,03011,L'Alfàs del Pi,Alicante,291,219,72
2016,03014,Alicante/Alacant,Alicante,4858,4829,29
2016,03015,Almoradí,Alicante,248,249,-1
2016,03018,Altea,Alicante,360,375,-15
2016,03019,Aspe,Alicante,150,141,9
2016,03031,Benidorm,Alicante,1931,1556,375
2016,03041,Benissa,Alicante,99,101,-2
2016,03047,Calp,Alicante,365,335,30
2016,03049,Callosa de Segura,Alicante,181,163,18
2016,03050,El Campello,Alicante,464,316,148
2016,03056,Cocentaina,Alicante,130,154,-24
2016,03059,Crevillent,Alicante,269,258,11
2016,03063,Dénia,Alicante,872,722,150
2016,03065,Elche/Elx,Alicante,2333,2242,91
2016,03066,Elda,Alicante,426,442,-16
2016,03076,Guardamar del Segura,Alicante,286,256,30
2016,03079,Ibi,Alicante,183,153,30
2016,03082,Jávea/Xàbia,Alicante,481,451,30
2016,03089,Monóvar/Monòver,Alicante,79,60,19
2016,03090,Mutxamel,Alicante,263,195,68
2016,03093,Novelda,Alicante,173,185,-12
2016,03094,La Nucia,Alicante,252,230,22
2016,03099,Orihuela,Alicante,1060,1013,47
2016,03102,Pego,Alicante,133,126,7
2016,03104,Petrer,Alicante,200,244,-44
2016,03113,Rojales,Alicante,138,123,15
2016,03119,Sant Joan d'Alacant,Alicante,359,214,145
2016,03121,Santa Pola,Alicante,668,586,82
2016,03122,San Vicente del Raspeig/Sant Vicent del Raspeig,Alicante,654,540,114
2016,03128,Teulada,Alicante,172,155,17
2016,03133,Torrevieja,Alicante,2403,2807,-404
2016,03139,Villajoyosa/La Vila Joiosa,Alicante,619,518,101
2016,03140,Villena,Alicante,321,411,-90
2016,03902,Pilar de la Horadada,Alicante,607,666,-59
2016,04003,Adra,Almería,272,262,10
2016,04006,Albox,Almería,216,189,27
2016,04013,Almería,Almería,2317,2359,-42
2016,04029,Berja,Almería,93,104,-11
2016,04035,Cuevas del Almanzora,Almería,224,199,25
2016,04052,Huércal de Almería,Almería,116,118,-2
2016,04053,Huércal-Overa,Almería,325,310,15
2016,04066,Níjar,Almería,488,358,130
2016,04079,Roquetas de Mar,Almería,2323,1830,493
2016,04100,Vera,Almería,428,314,114
2016,04102,Vícar,Almería,354,357,-3
2016,04902,El Ejido,Almería,983,1105,-122
2016,05019,Ávila,Ávila,953,1230,-277
2016,06011,Almendralejo,Badajoz,332,582,-250
2016,06015,Badajoz,Badajoz,1684,2090,-406
2016,06044,Don Benito,Badajoz,356,522,-166
2016,06083,Mérida,Badajoz,706,888,-182
2016,06088,Montijo,Badajoz,162,191,-29
2016,06095,Olivenza,Badajoz,106,125,-19
2016,06149,Villafranca de los Barros,Badajoz,116,147,-31
2016,06153,Villanueva de la Serena,Badajoz,234,334,-100
2016,06158,Zafra,Badajoz,176,277,-101
2016,07003,Alcúdia,Baleares,519,427,92
2016,07005,Andratx,Baleares,160,102,58
2016,07011,Calvià,Baleares,1099,794,305
2016,07013,Campos,Baleares,175,114,61
2016,07014,Capdepera,Baleares,515,375,140
2016,07015,Ciutadella de Menorca,Baleares,941,845,96
2016,07022,Felanitx,Baleares,225,173,52
2016,07024,Formentera,Baleares,704,609,95
2016,07026,Eivissa,Baleares,1644,1446,198
2016,07027,Inca,Baleares,483,368,115
2016,07031,Llucmajor,Baleares,788,576,212
2016,07032,Maó-Mahón,Baleares,713,698,15
2016,07033,Manacor,Baleares,880,647,233
2016,07036,Marratxí,Baleares,275,193,82
2016,07040,Palma,Baleares,7511,5815,1696
2016,07042,Pollença,Baleares,219,186,33
2016,07044,Sa Pobla,Baleares,113,103,10
2016,07046,Sant Antoni de Portmany,Baleares,1281,885,396
2016,07048,Sant Josep de sa Talaia,Baleares,1029,871,158
2016,07054,Santa Eulària des Riu,Baleares,1305,1151,154
2016,07055,Santa Margalida,Baleares,333,207,126
2016,07057,Santanyí,Baleares,253,150,103
2016,07061,Sóller,Baleares,161,125,36
2016,07062,Son Servera,Baleares,300,162,138
2016,08001,Abrera,Barcelona,103,89,14
2016,08006,Arenys de Mar,Barcelona,132,120,12
2016,08009,Argentona,Barcelona,55,62,-7
2016,08015,Badalona,Barcelona,1660,1761,-101
2016,08019,Barcelona,Barcelona,18906,16887,2019
2016,08022,Berga,Barcelona,118,121,-3
2016,08033,Caldes de Montbui,Barcelona,88,123,-35
2016,08035,Calella,Barcelona,228,201,27
2016,08040,Canet de Mar,Barcelona,102,118,-16
2016,08041,Canovelles,Barcelona,143,118,25
2016,08046,Cardedeu,Barcelona,84,138,-54
2016,08051,Castellar del Vallès,Barcelona,142,127,15
2016,08054,Castellbisbal,Barcelona,85,88,-3
2016,08056,Castelldefels,Barcelona,782,827,-45
2016,08072,Corbera de Llobregat,Barcelona,65,83,-18
2016,08073,Cornellà de Llobregat,Barcelona,737,678,59
2016,08074,Cubelles,Barcelona,262,305,-43
2016,08076,Esparreguera,Barcelona,214,196,18
2016,08077,Esplugues de Llobregat,Barcelona,372,334,38
2016,08086,Les Franqueses del Vallès,Barcelona,149,126,23
2016,08088,La Garriga,Barcelona,99,100,-1
2016,08089,Gavà,Barcelona,435,408,27
2016,08096,Granollers,Barcelona,591,517,74
2016,08101,L'Hospitalet de Llobregat,Barcelona,2807,2526,281
2016,08102,Igualada,Barcelona,419,355,64
2016,08105,La Llagosta,Barcelona,108,100,8
2016,08107,Lliçà d'Amunt,Barcelona,70,79,-9
2016,08110,Malgrat de Mar,Barcelona,301,268,33
2016,08112,Manlleu,Barcelona,195,188,7
2016,08113,Manresa,Barcelona,710,648,62
2016,08114,Martorell,Barcelona,228,247,-19
2016,08118,El Masnou,Barcelona,188,156,32
2016,08121,Mataró,Barcelona,1103,1032,71
2016,08123,Molins de Rei,Barcelona,129,147,-18
2016,08124,Mollet del Vallès,Barcelona,417,407,10
2016,08125,Montcada i Reixac,Barcelona,255,257,-2
2016,08126,Montgat,Barcelona,67,78,-11
2016,08136,Montornès del Vallès,Barcelona,108,123,-15
2016,08147,Olesa de Montserrat,Barcelona,171,189,-18
2016,08156,Palau-solità i Plegamans,Barcelona,72,73,-1
2016,08157,Pallejà,Barcelona,76,54,22
2016,08159,Parets del Vallès,Barcelona,122,127,-5
2016,08161,Piera,Barcelona,99,102,-3
2016,08163,Pineda de Mar,Barcelona,309,303,6
2016,08169,El Prat de Llobregat,Barcelona,626,504,122
2016,08172,Premià de Mar,Barcelona,165,235,-70
2016,08180,Ripollet,Barcelona,314,272,42
2016,08181,La Roca del Vallès,Barcelona,60,81,-21
2016,08184,Rubí,Barcelona,565,648,-83
2016,08187,Sabadell,Barcelona,1889,1551,338
2016,08194,Sant Adrià de Besòs,Barcelona,350,382,-32
2016,08196,Sant Andreu de la Barca,Barcelona,234,233,1
2016,08197,Sant Andreu de Llavaneres,Barcelona,72,79,-7
2016,08200,Sant Boi de Llobregat,Barcelona,616,637,-21
2016,08202,Sant Celoni,Barcelona,246,259,-13
2016,08205,Sant Cugat del Vallès,Barcelona,695,765,-70
2016,08211,Sant Feliu de Llobregat,Barcelona,320,335,-15
2016,08217,Sant Joan Despí,Barcelona,268,259,9
2016,08218,Sant Joan de Vilatorrada,Barcelona,62,75,-13
2016,08219,Vilassar de Mar,Barcelona,100,152,-52
2016,08221,Sant Just Desvern,Barcelona,170,137,33
2016,08230,Premià de Dalt,Barcelona,78,82,-4
2016,08231,Sant Pere de Ribes,Barcelona,309,353,-44
2016,08238,Sant Quirze del Vallès,Barcelona,129,131,-2
2016,08240,Sant Sadurní d'Anoia,Barcelona,88,75,13
2016,08245,Santa Coloma de Gramenet,Barcelona,963,1072,-109
2016,08252,Barberà del Vallès,Barcelona,226,212,14
2016,08260,Santa Perpètua de Mogoda,Barcelona,192,172,20
2016,08263,Sant Vicenç dels Horts,Barcelona,211,177,34
2016,08266,Cerdanyola del Vallès,Barcelona,419,425,-6
2016,08270,Sitges,Barcelona,352,342,10
2016,08279,Terrassa,Barcelona,1965,1741,224
2016,08284,Tordera,Barcelona,396,310,86
2016,08285,Torelló,Barcelona,125,97,28
2016,08295,Vallirana,Barcelona,113,108,5
2016,08298,Vic,Barcelona,676,467,209
2016,08301,Viladecans,Barcelona,555,588,-33
2016,08302,Vilanova del Camí,Barcelona,119,88,31
2016,08305,Vilafranca del Penedès,Barcelona,416,395,21
2016,08307,Vilanova i la Geltrú,Barcelona,758,830,-72
2016,08904,Badia del Vallès,Barcelona,111,118,-7
2016,09018,Aranda de Duero,Burgos,525,577,-52
2016,09059,Burgos,Burgos,1992,2494,-502
2016,09219,Miranda de Ebro,Burgos,667,747,-80
2016,10037,Cáceres,Cáceres,1183,1601,-418
2016,10067,Coria,Cáceres,111,234,-123
2016,10131,Navalmoral de la Mata,Cáceres,309,408,-99
2016,10148,Plasencia,Cáceres,401,653,-252
2016,11004,Algeciras,Cádiz,1891,1727,164
2016,11006,Arcos de la Frontera,Cádiz,311,471,-160
2016,11007,Barbate,Cádiz,180,228,-48
2016,11008,Los Barrios,Cádiz,271,316,-45
2016,11012,Cádiz,Cádiz,992,1313,-321
2016,11014,Conil de la Frontera,Cádiz,272,219,53
2016,11015,Chiclana de la Frontera,Cádiz,1101,1159,-58
2016,11016,Chipiona,Cádiz,220,239,-19
2016,11020,Jerez de la Frontera,Cádiz,2362,2784,-422
2016,11022,La Línea de la Concepción,Cádiz,648,705,-57
2016,11023,Medina-Sidonia,Cádiz,76,101,-25
2016,11027,El Puerto de Santa María,Cádiz,1231,1473,-242
2016,11028,Puerto Real,Cádiz,374,455,-81
2016,11030,Rota,Cádiz,481,520,-39
2016,11031,San Fernando,Cádiz,918,1205,-287
2016,11032,Sanlúcar de Barrameda,Cádiz,438,529,-91
2016,11033,San Roque,Cádiz,561,500,61
2016,11035,Tarifa,Cádiz,285,242,43
2016,11038,Ubrique,Cádiz,131,191,-60
2016,11039,Vejer de la Frontera,Cádiz,96,107,-11
2016,11041,Villamartín,Cádiz,126,172,-46
2016,12005,L'Alcora,Castellón,73,76,-3
2016,12009,Almassora,Castellón,240,284,-44
2016,12027,Benicarló,Castellón,518,598,-80
2016,12028,Benicasim/Benicàssim,Castellón,269,215,54
2016,12032,Borriana/Burriana,Castellón,508,504,4
2016,12040,Castellón de la Plana/Castelló de la Plana,Castellón,2025,2161,-136
2016,12082,Nules,Castellón,175,179,-4
2016,12084,Onda,Castellón,243,236,7
2016,12126,La Vall d'Uixó,Castellón,231,362,-131
2016,12135,Vila-real,Castellón,532,489,43
2016,12138,Vinaròs,Castellón,739,666,73
2016,13005,Alcázar de San Juan,Ciudad Real,503,604,-101
2016,13023,Bolaños de Calatrava,Ciudad Real,78,112,-34
2016,13028,Campo de Criptana,Ciudad Real,108,147,-39
2016,13034,Ciudad Real,Ciudad Real,1018,1340,-322
2016,13039,Daimiel,Ciudad Real,161,253,-92
2016,13053,Manzanares,Ciudad Real,174,282,-108
2016,13056,Miguelturra,Ciudad Real,149,195,-46
2016,13071,Puertollano,Ciudad Real,574,946,-372
2016,13078,Socuéllamos,Ciudad Real,175,271,-96
2016,13079,La Solana,Ciudad Real,72,148,-76
2016,13082,Tomelloso,Ciudad Real,444,546,-102
2016,13087,Valdepeñas,Ciudad Real,386,525,-139
2016,13096,Villarrubia de los Ojos,Ciudad Real,84,179,-95
2016,14002,Aguilar de la Frontera,Córdoba,92,101,-9
2016,14007,Baena,Córdoba,145,320,-175
2016,14013,Cabra,Córdoba,166,248,-82
2016,14017,La Carlota,Córdoba,167,172,-5
2016,14021,Córdoba,Córdoba,3082,4235,-1153
2016,14030,Fuente Palmera,Córdoba,103,156,-53
2016,14038,Lucena,Córdoba,496,618,-122
2016,14042,Montilla,Córdoba,140,210,-70
2016,14049,Palma del Río,Córdoba,230,323,-93
2016,14052,Peñarroya-Pueblonuevo,Córdoba,123,192,-69
2016,14054,Pozoblanco,Córdoba,190,216,-26
2016,14055,Priego de Córdoba,Córdoba,270,352,-82
2016,14056,Puente Genil,Córdoba,398,530,-132
2016,14058,Rute,Córdoba,103,157,-54
2016,15002,Ames,A Coruña,427,462,-35
2016,15005,Arteixo,A Coruña,319,257,62
2016,15009,Betanzos,A Coruña,106,97,9
2016,15011,Boiro,A Coruña,170,179,-9
2016,15017,Cambre,A Coruña,186,188,-2
2016,15019,Carballo,A Coruña,149,176,-27
2016,15030,A Coruña,A Coruña,3063,2940,123
2016,15031,Culleredo,A Coruña,267,231,36
2016,15035,Fene,A Coruña,74,112,-38
2016,15036,Ferrol,A Coruña,959,1135,-176
2016,15041,A Laracha,A Coruña,59,51,8
2016,15054,Narón,A Coruña,390,472,-82
2016,15057,Noia,A Coruña,116,115,1
2016,15058,Oleiros,A Coruña,406,374,32
2016,15059,Ordes,A Coruña,63,73,-10
2016,15070,As Pontes de García Rodríguez,A Coruña,70,88,-18
2016,15072,Rianxo,A Coruña,78,115,-37
2016,15073,Ribeira,A Coruña,196,235,-39
2016,15075,Sada (A Coruña),A Coruña,147,209,-62
2016,15078,Santiago de Compostela,A Coruña,1475,1295,180
2016,15082,Teo,A Coruña,198,244,-46
2016,16078,Cuenca,Cuenca,866,1169,-303
2016,16203,Tarancón,Cuenca,383,377,6
2016,17015,Banyoles,Girona,226,170,56
2016,17022,La Bisbal d'Empordà,Girona,126,111,15
2016,17023,Blanes,Girona,1093,1123,-30
2016,17034,Calonge i Sant Antoni,Girona,205,169,36
2016,17044,Cassà de la Selva,Girona,127,78,49
2016,17047,Castelló d'Empúries,Girona,165,170,-5
2016,17048,Castell-Platja d'Aro,Girona,238,243,-5
2016,17062,L'Escala,Girona,151,151,0
2016,17066,Figueres,Girona,724,745,-21
2016,17079,Girona,Girona,1547,1449,98
2016,17095,Lloret de Mar,Girona,833,888,-55
2016,17114,Olot,Girona,476,429,47
2016,17117,Palafrugell,Girona,278,278,0
2016,17118,Palamós,Girona,263,276,-13
2016,17147,Ripoll,Girona,160,169,-9
2016,17152,Roses,Girona,283,324,-41
2016,17155,Salt,Girona,403,393,10
2016,17160,Sant Feliu de Guíxols,Girona,311,355,-44
2016,17180,Santa Coloma de Farners,Girona,155,127,28
2016,17199,Torroella de Montgrí,Girona,178,184,-6
2016,18003,Albolote,Granada,209,224,-15
2016,18017,Almuñécar,Granada,371,461,-90
2016,18021,Armilla,Granada,570,491,79
2016,18022,Atarfe,Granada,208,235,-27
2016,18023,Baza,Granada,379,442,-63
2016,18062,Churriana de la Vega,Granada,287,253,34
2016,18087,Granada,Granada,3897,4246,-349
2016,18089,Guadix,Granada,261,332,-71
2016,18100,Huétor Tájar,Granada,138,128,10
2016,18101,Huétor Vega,Granada,120,156,-36
2016,18102,Illora,Granada,69,76,-7
2016,18122,Loja,Granada,184,276,-92
2016,18127,Maracena,Granada,235,313,-78
2016,18140,Motril,Granada,676,733,-57
2016,18145,Ogíjares,Granada,165,155,10
2016,18153,Peligros,Granada,100,111,-11
2016,18158,Pinos Puente,Granada,71,108,-37
2016,18173,Salobreña,Granada,147,187,-40
2016,18175,Santa Fe,Granada,168,174,-6
2016,18193,La Zubia,Granada,241,229,12
2016,18905,Las Gabias,Granada,324,389,-65
2016,18911,Vegas del Genil,Granada,90,92,-2
2016,19024,Alovera,Guadalajara,417,360,57
2016,19046,Azuqueca de Henares,Guadalajara,1350,1203,147
2016,19071,El Casar,Guadalajara,699,568,131
2016,19130,Guadalajara,Guadalajara,1706,1717,-11
2016,20009,Andoain,Guipúzcoa,115,81,34
2016,20017,Azkoitia,Guipúzcoa,95,114,-19
2016,20018,Azpeitia,Guipúzcoa,126,113,13
2016,20019,Beasain,Guipúzcoa,122,139,-17
2016,20030,Eibar,Guipúzcoa,412,394,18
2016,20032,Elgoibar,Guipúzcoa,113,152,-39
2016,20036,Hondarribia,Guipúzcoa,132,134,-2
2016,20040,Hernani,Guipúzcoa,185,146,39
2016,20045,Irun,Guipúzcoa,813,710,103
2016,20055,Arrasate/Mondragón,Guipúzcoa,282,318,-36
2016,20059,Oñati,Guipúzcoa,85,72,13
2016,20063,Oiartzun,Guipúzcoa,83,50,33
2016,20064,Pasaia,Guipúzcoa,128,144,-16
2016,20067,Errenteria,Guipúzcoa,258,264,-6
2016,20069,Donostia/San Sebastián,Guipúzcoa,2333,2043,290
2016,20071,Tolosa,Guipúzcoa,173,144,29
2016,20074,Bergara,Guipúzcoa,157,142,15
2016,20079,Zarautz,Guipúzcoa,202,186,16
2016,20902,Lasarte-Oria,Guipúzcoa,191,181,10
2016,21002,Aljaraque,Huelva,209,302,-93
2016,21005,Almonte,Huelva,332,325,7
2016,21010,Ayamonte,Huelva,310,311,-1
2016,21013,Bollullos Par del Condado,Huelva,106,106,0
2016,21021,Cartaya,Huelva,291,314,-23
2016,21035,Gibraleón,Huelva,118,113,5
2016,21041,Huelva,Huelva,1285,1582,-297
2016,21042,Isla Cristina,Huelva,290,279,11
2016,21044,Lepe,Huelva,382,414,-32
2016,21050,Moguer,Huelva,327,307,20
2016,21054,La Palma del Condado,Huelva,120,136,-16
2016,21055,Palos de la Frontera,Huelva,137,112,25
2016,21060,Punta Umbría,Huelva,204,204,0
2016,21072,Valverde del Camino,Huelva,93,104,-11
2016,22048,Barbastro,Huesca,211,236,-25
2016,22112,Fraga,Huesca,374,290,84
2016,22125,Huesca,Huesca,780,944,-164
2016,22130,Jaca,Huesca,426,462,-36
2016,22158,Monzón,Huesca,281,313,-32
2016,23002,Alcalá la Real,Jaén,263,324,-61
2016,23003,Alcaudete,Jaén,91,152,-61
2016,23005,Andújar,Jaén,400,687,-287
2016,23009,Baeza,Jaén,173,248,-75
2016,23010,Bailén,Jaén,161,281,-120
2016,23024,La Carolina,Jaén,210,261,-51
2016,23050,Jaén,Jaén,932,1674,-742
2016,23053,Jódar,Jaén,82,133,-51
2016,23055,Linares,Jaén,617,975,-358
2016,23058,Mancha Real,Jaén,70,93,-23
2016,23060,Martos,Jaén,201,236,-35
2016,23086,Torredelcampo,Jaén,95,146,-51
2016,23087,Torredonjimeno,Jaén,97,168,-71
2016,23092,Úbeda,Jaén,366,520,-154
2016,23095,Villacarrillo,Jaén,80,162,-82
2016,24008,Astorga,León,142,157,-15
2016,24010,La Bañeza,León,131,169,-38
2016,24089,León,León,1674,2128,-454
2016,24115,Ponferrada,León,759,1153,-394
2016,24142,San Andrés del Rabanedo,León,349,459,-110
2016,24222,Villaquilambre,León,200,235,-35
2016,25040,Balaguer,Lleida,261,248,13
2016,25120,Lleida,Lleida,2221,2520,-299
2016,25137,Mollerussa,Lleida,224,229,-5
2016,25203,La Seu d'Urgell,Lleida,319,321,-2
2016,25217,Tàrrega,Lleida,271,245,26
2016,26018,Arnedo,La Rioja,152,137,15
2016,26036,Calahorra,La Rioja,391,446,-55
2016,26071,Haro,La Rioja,270,234,36
2016,26089,Logroño,La Rioja,2153,2255,-102
2016,27028,Lugo,Lugo,1190,1505,-315
2016,27031,Monforte de Lemos,Lugo,426,364,62
2016,27057,Sarria,Lugo,161,158,3
2016,27065,Vilalba,Lugo,120,147,-27
2016,27066,Viveiro,Lugo,242,256,-14
2016,28005,Alcalá de Henares,Madrid,2786,2870,-84
2016,28006,Alcobendas,Madrid,1328,1146,182
2016,28007,Alcorcón,Madrid,1631,1526,105
2016,28009,Algete,Madrid,228,242,-14
2016,28010,Alpedrete,Madrid,165,170,-5
2016,28013,Aranjuez,Madrid,1232,1098,134
2016,28014,Arganda del Rey,Madrid,536,492,44
2016,28015,Arroyomolinos (Madrid),Madrid,309,240,69
2016,28022,Boadilla del Monte,Madrid,468,346,122
2016,28026,Brunete,Madrid,135,120,15
2016,28040,Ciempozuelos,Madrid,348,360,-12
2016,28045,Colmenar Viejo,Madrid,667,498,169
2016,28047,Collado Villalba,Madrid,741,739,2
2016,28049,Coslada,Madrid,580,699,-119
2016,28054,El Escorial,Madrid,185,151,34
2016,28058,Fuenlabrada,Madrid,2277,2449,-172
2016,28061,Galapagar,Madrid,395,359,36
2016,28065,Getafe,Madrid,2195,1860,335
2016,28068,Guadarrama,Madrid,193,137,56
2016,28073,Humanes de Madrid,Madrid,270,311,-41
2016,28074,Leganés,Madrid,1833,1882,-49
2016,28079,Madrid,Madrid,51573,37317,14256
2016,28080,Majadahonda,Madrid,778,735,43
2016,28083,Meco,Madrid,208,245,-37
2016,28084,Mejorada del Campo,Madrid,207,236,-29
2016,28090,Moralzarzal,Madrid,99,75,24
2016,28092,Móstoles,Madrid,2423,2326,97
2016,28096,Navalcarnero,Madrid,445,384,61
2016,28104,Paracuellos de Jarama,Madrid,414,280,134
2016,28106,Parla,Madrid,1871,1761,110
2016,28113,Pinto,Madrid,630,581,49
2016,28115,Pozuelo de Alarcón,Madrid,879,615,264
2016,28123,Rivas-Vaciamadrid,Madrid,585,615,-30
2016,28127,Las Rozas de Madrid,Madrid,1085,901,184
2016,28129,San Agustín del Guadalix,Madrid,130,125,5
2016,28130,San Fernando de Henares,Madrid,281,322,-41
2016,28131,San Lorenzo de El Escorial,Madrid,209,195,14
2016,28132,San Martín de la Vega,Madrid,243,213,30
2016,28134,San Sebastián de los Reyes,Madrid,1028,922,106
2016,28148,Torrejón de Ardoz,Madrid,1482,1448,34
2016,28152,Torrelodones,Madrid,191,186,5
2016,28160,Valdemorillo,Madrid,129,99,30
2016,28161,Valdemoro,Madrid,1124,1005,119
2016,28167,Velilla de San Antonio,Madrid,94,98,-4
2016,28172,Villalbilla,Madrid,157,114,43
2016,28176,Villanueva de la Cañada,Madrid,281,216,65
2016,28177,Villanueva del Pardillo,Madrid,196,163,33
2016,28181,Villaviciosa de Odón,Madrid,270,229,41
2016,28903,Tres Cantos,Madrid,636,452,184
2016,29007,Alhaurín de la Torre,Málaga,346,316,30
2016,29008,Alhaurín el Grande,Málaga,179,198,-19
2016,29012,Álora,Málaga,130,115,15
2016,29015,Antequera,Málaga,384,401,-17
2016,29025,Benalmádena,Málaga,1261,1044,217
2016,29038,Cártama,Málaga,262,196,66
2016,29042,Coín,Málaga,181,214,-33
2016,29051,Estepona,Málaga,1196,1089,107
2016,29054,Fuengirola,Málaga,1325,1196,129
2016,29067,Málaga,Málaga,6245,5825,420
2016,29068,Manilva,Málaga,554,381,173
2016,29069,Marbella,Málaga,2295,2221,74
2016,29070,Mijas,Málaga,1251,1032,219
2016,29075,Nerja,Málaga,266,258,8
2016,29082,Rincón de la Victoria,Málaga,685,423,262
2016,29084,Ronda,Málaga,504,509,-5
2016,29091,Torrox,Málaga,293,235,58
2016,29094,Vélez-Málaga,Málaga,1169,857,312
2016,29901,Torremolinos,Málaga,1351,1029,322
2016,30002,Abarán,Murcia,76,102,-26
2016,30003,Águilas,Murcia,596,442,154
2016,30005,Alcantarilla,Murcia,418,338,80
2016,30008,Alhama de Murcia,Murcia,213,190,23
2016,30009,Archena,Murcia,290,304,-14
2016,30010,Beniel,Murcia,258,230,28
2016,30012,Bullas,Murcia,70,72,-2
2016,30013,Calasparra,Murcia,144,113,31
2016,30015,Caravaca de la Cruz,Murcia,311,304,7
2016,30016,Cartagena,Murcia,2347,2567,-220
2016,30017,Cehegín,Murcia,119,149,-30
2016,30018,Ceutí,Murcia,110,104,6
2016,30019,Cieza (Murcia),Murcia,206,251,-45
2016,30021,Fuente Álamo de Murcia,Murcia,177,210,-33
2016,30022,Jumilla,Murcia,373,352,21
2016,30024,Lorca,Murcia,1289,1090,199
2016,30026,Mazarrón,Murcia,492,420,72
2016,30027,Molina de Segura,Murcia,831,784,47
2016,30029,Mula,Murcia,133,202,-69
2016,30030,Murcia,Murcia,4734,4396,338
2016,30033,Puerto Lumbreras,Murcia,249,214,35
2016,30035,San Javier,Murcia,719,669,50
2016,30036,San Pedro del Pinatar,Murcia,733,584,149
2016,30037,Torre-Pacheco,Murcia,535,506,29
2016,30038,Las Torres de Cotillas,Murcia,134,123,11
2016,30039,Totana,Murcia,417,320,97
2016,30041,La Unión,Murcia,235,207,28
2016,30043,Yecla,Murcia,400,420,-20
2016,30901,Santomera,Murcia,217,206,11
2016,30902,Los Alcázares,Murcia,432,389,43
2016,31016,Ansoáin/Antsoain,Navarra,90,83,7
2016,31060,Burlada/Burlata,Navarra,195,124,71
2016,31086,Valle de Egüés,Navarra,158,159,-1
2016,31097,Estella-Lizarra,Navarra,189,132,57
2016,31201,Pamplona/Iruña,Navarra,2505,2303,202
2016,31227,Tafalla,Navarra,116,96,20
2016,31232,Tudela,Navarra,703,531,172
2016,31258,Villava/Atarrabia,Navarra,80,74,6
2016,31901,Barañain,Navarra,195,184,11
2016,31907,Zizur Mayor/Zizur Nagusia,Navarra,105,104,1
2016,32008,Barbadás,Ourense,121,118,3
2016,32009,O Barco de Valdeorras,Ourense,192,229,-37
2016,32019,O Carballiño,Ourense,173,202,-29
2016,32032,Xinzo de Limia,Ourense,117,154,-37
2016,32054,Ourense,Ourense,1541,1758,-217
2016,32085,Verín,Ourense,304,374,-70
2016,33002,Aller,Asturias,59,68,-9
2016,33004,Avilés,Asturias,510,633,-123
2016,33011,Cangas del Narcea,Asturias,53,101,-48
2016,33014,Carreño,Asturias,84,84,0
2016,33016,Castrillón,Asturias,161,155,6
2016,33020,Corvera de Asturias,Asturias,100,112,-12
2016,33024,Gijón,Asturias,2586,2613,-27
2016,33025,Gozón,Asturias,88,105,-17
2016,33026,Grado,Asturias,42,57,-15
2016,33031,Langreo,Asturias,217,298,-81
2016,33032,Laviana,Asturias,40,78,-38
2016,33033,Lena,Asturias,90,101,-11
2016,33034,Valdés,Asturias,62,87,-25
2016,33035,Llanera,Asturias,89,120,-31
2016,33036,Llanes,Asturias,180,171,9
2016,33037,Mieres (Asturias),Asturias,217,240,-23
2016,33044,Oviedo,Asturias,2262,2632,-370
2016,33060,San Martín del Rey Aurelio,Asturias,96,105,-9
2016,33066,Siero,Asturias,343,458,-115
2016,33076,Villaviciosa,Asturias,109,108,1
2016,34120,Palencia,Palencia,1013,1204,-191
2016,35002,Agüimes,Las Palmas,316,312,4
2016,35003,Antigua,Las Palmas,336,315,21
2016,35004,Arrecife,Las Palmas,1779,1196,583
2016,35006,Arucas,Las Palmas,176,232,-56
2016,35009,Gáldar,Las Palmas,123,134,-11
2016,35011,Ingenio,Las Palmas,229,233,-4
2016,35012,Mogán,Las Palmas,233,231,2
2016,35014,La Oliva,Las Palmas,789,716,73
2016,35015,Pájara,Las Palmas,712,591,121
2016,35016,Las Palmas de Gran Canaria,Las Palmas,4112,4621,-509
2016,35017,Puerto del Rosario,Las Palmas,1059,901,158
2016,35018,San Bartolomé,Las Palmas,418,416,2
2016,35019,San Bartolomé de Tirajana,Las Palmas,637,671,-34
2016,35021,Santa Brígida,Las Palmas,81,126,-45
2016,35022,Santa Lucía de Tirajana,Las Palmas,832,829,3
2016,35023,Santa María de Guía de Gran Canaria,Las Palmas,57,59,-2
2016,35024,Teguise,Las Palmas,441,453,-12
2016,35026,Telde,Las Palmas,843,782,61
2016,35027,Teror,Las Palmas,48,46,2
2016,35028,Tías,Las Palmas,438,430,8
2016,35030,Tuineje,Las Palmas,419,252,167
2016,35034,Yaiza,Las Palmas,910,712,198
2016,36003,Baiona,Pontevedra,116,94,22
2016,36004,Bueu,Pontevedra,66,84,-18
2016,36006,Cambados,Pontevedra,96,123,-27
2016,36008,Cangas,Pontevedra,180,213,-33
2016,36017,A Estrada,Pontevedra,192,225,-33
2016,36021,Gondomar,Pontevedra,89,89,0
2016,36022,O Grove,Pontevedra,95,75,20
2016,36023,A Guarda,Pontevedra,89,102,-13
2016,36024,Lalín,Pontevedra,300,324,-24
2016,36026,Marín,Pontevedra,234,318,-84
2016,36029,Moaña,Pontevedra,135,113,22
2016,36033,Mos,Pontevedra,92,82,10
2016,36035,Nigrán,Pontevedra,164,134,30
2016,36038,Pontevedra,Pontevedra,1020,1127,-107
2016,36039,O Porriño,Pontevedra,152,245,-93
2016,36041,Poio,Pontevedra,178,191,-13
2016,36042,Ponteareas,Pontevedra,188,210,-22
2016,36045,Redondela,Pontevedra,162,167,-5
2016,36051,Sanxenxo,Pontevedra,180,209,-29
2016,36054,Tomiño,Pontevedra,91,83,8
2016,36055,Tui,Pontevedra,135,173,-38
2016,36057,Vigo,Pontevedra,3174,3117,57
2016,36060,Vilagarcía de Arousa,Pontevedra,481,450,31
2016,36061,Vilanova de Arousa,Pontevedra,89,79,10
2016,37046,Béjar,Salamanca,147,210,-63
2016,37107,Ciudad Rodrigo,Salamanca,119,153,-34
2016,37274,Salamanca,Salamanca,2098,2473,-375
2016,37294,Santa Marta de Tormes,Salamanca,170,260,-90
2016,38001,Adeje,Santa Cruz de Tenerife,953,988,-35
2016,38006,Arona,Santa Cruz de Tenerife,1679,1593,86
2016,38011,Candelaria,Santa Cruz de Tenerife,383,355,28
2016,38017,Granadilla de Abona,Santa Cruz de Tenerife,993,893,100
2016,38019,Guía de Isora,Santa Cruz de Tenerife,337,230,107
2016,38020,Güímar,Santa Cruz de Tenerife,195,116,79
2016,38022,Icod de los Vinos,Santa Cruz de Tenerife,119,127,-8
2016,38023,San Cristóbal de La Laguna,Santa Cruz de Tenerife,1581,1390,191
2016,38024,Los Llanos de Aridane,Santa Cruz de Tenerife,218,186,32
2016,38026,La Orotava,Santa Cruz de Tenerife,219,229,-10
2016,38028,Puerto de la Cruz,Santa Cruz de Tenerife,471,490,-19
2016,38031,Los Realejos,Santa Cruz de Tenerife,171,168,3
2016,38032,El Rosario,Santa Cruz de Tenerife,224,158,66
2016,38035,San Miguel de Abona,Santa Cruz de Tenerife,312,211,101
2016,38037,Santa Cruz de la Palma,Santa Cruz de Tenerife,215,262,-47
2016,38038,Santa Cruz de Tenerife,Santa Cruz de Tenerife,2220,2490,-270
2016,38039,Santa Úrsula,Santa Cruz de Tenerife,127,123,4
2016,38040,Santiago del Teide,Santa Cruz de Tenerife,148,159,-11
2016,38043,Tacoronte,Santa Cruz de Tenerife,168,125,43
2016,38046,Tegueste,Santa Cruz de Tenerife,52,72,-20
2016,39008,El Astillero,Cantabria,142,172,-30
2016,39016,Camargo,Cantabria,255,252,3
2016,39020,Castro-Urdiales,Cantabria,1298,1385,-87
2016,39025,Los Corrales de Buelna,Cantabria,76,69,7
2016,39035,Laredo,Cantabria,200,187,13
2016,39052,Piélagos,Cantabria,293,258,35
2016,39073,Santa Cruz de Bezana,Cantabria,110,117,-7
2016,39075,Santander,Cantabria,2121,2094,27
2016,39079,Santoña,Cantabria,148,156,-8
2016,39087,Torrelavega,Cantabria,449,509,-60
2016,40194,Segovia,Segovia,798,1115,-317
2016,41004,Alcalá de Guadaíra,Sevilla,567,648,-81
2016,41005,Alcalá del Río,Sevilla,84,83,1
2016,41007,La Algaba,Sevilla,95,113,-18
2016,41011,Arahal,Sevilla,73,128,-55
2016,41016,Bollullos de la Mitación,Sevilla,103,74,29
2016,41017,Bormujos,Sevilla,244,252,-8
2016,41018,Brenes,Sevilla,98,117,-19
2016,41020,Las Cabezas de San Juan,Sevilla,112,172,-60
2016,41021,Camas,Sevilla,268,339,-71
2016,41023,Cantillana,Sevilla,66,84,-18
2016,41024,Carmona,Sevilla,184,240,-56
2016,41029,Castilleja de la Cuesta,Sevilla,153,147,6
2016,41034,Coria del Río,Sevilla,259,287,-28
2016,41038,Dos Hermanas,Sevilla,1084,1213,-129
2016,41039,Écija,Sevilla,273,437,-164
2016,41040,Espartinas,Sevilla,199,217,-18
2016,41041,Estepa,Sevilla,77,134,-57
2016,41047,Gines,Sevilla,117,113,4
2016,41049,Guillena,Sevilla,120,116,4
2016,41053,Lebrija,Sevilla,223,279,-56
2016,41055,Lora del Río,Sevilla,122,152,-30
2016,41058,Mairena del Alcor,Sevilla,154,198,-44
2016,41059,Mairena del Aljarafe,Sevilla,548,523,25
2016,41060,Marchena,Sevilla,84,165,-81
2016,41065,Morón de la Frontera,Sevilla,212,305,-93
2016,41068,Osuna,Sevilla,143,164,-21
2016,41069,Los Palacios y Villafranca,Sevilla,156,236,-80
2016,41075,Pilas,Sevilla,136,145,-9
2016,41077,La Puebla de Cazalla,Sevilla,103,157,-54
2016,41079,La Puebla del Río,Sevilla,75,107,-32
2016,41081,La Rinconada,Sevilla,282,303,-21
2016,41086,San Juan de Aznalfarache,Sevilla,269,347,-78
2016,41087,Sanlúcar la Mayor,Sevilla,155,193,-38
2016,41091,Sevilla,Sevilla,6724,7431,-707
2016,41093,Tomares,Sevilla,336,360,-24
2016,41095,Utrera,Sevilla,387,481,-94
2016,41102,El Viso del Alcor,Sevilla,96,105,-9
2016,42173,Soria,Soria,587,669,-82
2016,43014,Amposta,Tarragona,309,308,1
2016,43037,Calafell,Tarragona,1395,1033,362
2016,43038,Cambrils,Tarragona,729,647,82
2016,43051,Cunit,Tarragona,828,579,249
2016,43092,Mont-roig del Camp,Tarragona,258,257,1
2016,43123,Reus,Tarragona,1167,1261,-94
2016,43136,Sant Carles de la Ràpita,Tarragona,329,282,47
2016,43148,Tarragona,Tarragona,1951,2201,-250
2016,43153,Torredembarra,Tarragona,451,367,84
2016,43155,Tortosa,Tarragona,446,471,-25
2016,43161,Valls,Tarragona,253,328,-75
2016,43163,El Vendrell,Tarragona,1100,1135,-35
2016,43171,Vila-seca,Tarragona,331,361,-30
2016,43901,Deltebre,Tarragona,125,157,-32
2016,43905,Salou,Tarragona,701,651,50
2016,44013,Alcañiz,Teruel,274,288,-14
2016,44216,Teruel,Teruel,454,600,-146
2016,45019,Bargas,Toledo,213,193,20
2016,45053,Consuegra,Toledo,87,151,-64
2016,45066,Fuensalida,Toledo,274,305,-31
2016,45081,Illescas,Toledo,1376,1069,307
2016,45087,Madridejos,Toledo,89,149,-60
2016,45121,Ocaña,Toledo,572,511,61
2016,45142,Quintanar de la Orden,Toledo,186,243,-57
2016,45161,Seseña,Toledo,2242,1529,713
2016,45163,Sonseca,Toledo,115,194,-79
2016,45165,Talavera de la Reina,Toledo,1301,1680,-379
2016,45168,Toledo,Toledo,1638,1844,-206
2016,45173,Torrijos,Toledo,224,301,-77
2016,45205,Yuncos,Toledo,462,425,37
2016,46005,Alaquàs,Valencia,208,223,-15
2016,46007,Albal,Valencia,109,97,12
2016,46011,Alberic,Valencia,85,126,-41
2016,46013,Alboraya,Valencia,228,206,22
2016,46017,Alzira,Valencia,404,388,16
2016,46019,L'Alcúdia,Valencia,82,71,11
2016,46021,Aldaia,Valencia,264,219,45
2016,46022,Alfafar,Valencia,173,169,4
2016,46029,Algemesí,Valencia,222,202,20
2016,46031,Alginet,Valencia,77,66,11
2016,46051,Benaguasil,Valencia,84,87,-3
2016,46054,Benetússer,Valencia,106,104,2
2016,46060,Benifaió,Valencia,85,70,15
2016,46070,Bétera,Valencia,278,246,32
2016,46078,Burjassot,Valencia,319,318,1
2016,46081,Canals,Valencia,81,103,-22
2016,46083,Carcaixent,Valencia,123,129,-6
2016,46085,Carlet,Valencia,77,91,-14
2016,46094,Catarroja,Valencia,189,240,-51
2016,46102,Quart de Poblet,Valencia,184,139,45
2016,46105,Cullera,Valencia,242,239,3
2016,46110,Xirivella,Valencia,286,233,53
2016,46111,Chiva,Valencia,107,108,-1
2016,46116,L'Eliana,Valencia,152,167,-15
2016,46131,Gandia,Valencia,1138,1262,-124
2016,46135,Godella,Valencia,108,122,-14
2016,46145,Xátiva,Valencia,286,301,-15
2016,46147,Llíria,Valencia,237,243,-6
2016,46159,Manises,Valencia,278,273,5
2016,46164,Massamagrell,Valencia,103,112,-9
2016,46166,Meliana,Valencia,72,70,2
2016,46169,Mislata,Valencia,373,374,-1
2016,46171,Moncada,Valencia,113,111,2
2016,46181,Oliva,Valencia,302,319,-17
2016,46184,Ontinyent,Valencia,310,328,-18
2016,46186,Paiporta,Valencia,185,209,-24
2016,46190,Paterna,Valencia,698,665,33
2016,46193,Picanya,Valencia,94,78,16
2016,46194,Picassent,Valencia,174,163,11
2016,46202,La Pobla de Vallbona,Valencia,199,209,-10
2016,46205,Puçol,Valencia,191,151,40
2016,46213,Requena,Valencia,169,201,-32
2016,46214,Riba-roja de Túria,Valencia,195,203,-8
2016,46220,Sagunto/Sagunt,Valencia,882,762,120
2016,46223,Sedaví,Valencia,84,76,8
2016,46230,Silla,Valencia,171,167,4
2016,46235,Sueca,Valencia,193,205,-12
2016,46238,Tavernes de la Valldigna,Valencia,128,145,-17
2016,46244,Torrent (Valencia),Valencia,747,731,16
2016,46249,Utiel,Valencia,91,99,-8
2016,46250,València,Valencia,9719,9192,527
2016,47010,Arroyo de la Encomienda,Valladolid,279,308,-29
2016,47076,Laguna de Duero,Valladolid,231,289,-58
2016,47085,Medina del Campo,Valladolid,217,252,-35
2016,47186,Valladolid,Valladolid,3683,3957,-274
2016,48003,Amorebieta-Etxano,Vizcaya,162,121,41
2016,48011,Arrigorriaga,Vizcaya,92,102,-10
2016,48013,Barakaldo,Vizcaya,1051,977,74
2016,48015,Basauri,Vizcaya,398,324,74
2016,48017,Bermeo,Vizcaya,149,132,17
2016,48020,Bilbao,Vizcaya,4561,3927,634
2016,48027,Durango,Vizcaya,335,236,99
2016,48029,Etxebarri,Vizcaya,62,58,4
2016,48034,Ermua,Vizcaya,230,293,-63
2016,48036,Galdakao,Vizcaya,207,225,-18
2016,48044,Getxo,Vizcaya,692,779,-87
2016,48046,Gernika-Lumo,Vizcaya,108,80,28
2016,48054,Leioa,Vizcaya,270,224,46
2016,48069,Mungia,Vizcaya,196,146,50
2016,48078,Portugalete,Vizcaya,346,342,4
2016,48080,Valle de Trápaga-Trapagaran,Vizcaya,96,85,11
2016,48082,Santurtzi,Vizcaya,374,420,-46
2016,48084,Sestao,Vizcaya,291,244,47
2016,48085,Sopela,Vizcaya,99,98,1
2016,48902,Erandio,Vizcaya,189,190,-1
2016,49021,Benavente,Zamora,297,370,-73
2016,49275,Zamora,Zamora,773,1108,-335
2016,50067,Calatayud,Zaragoza,630,660,-30
2016,50089,Cuarte de Huerva,Zaragoza,224,225,-1
2016,50095,Ejea de los Caballeros,Zaragoza,212,185,27
2016,50251,Tarazona,Zaragoza,116,182,-66
2016,50272,Utebo,Zaragoza,237,161,76
2016,50297,Zaragoza,Zaragoza,8381,8154,227
2016,51001,Ceuta,Ceuta,2175,2485,-310
2016,52001,Melilla,Melilla,2596,3035,-439
2017,01002,Amurrio,Álava,106,155,-49
2017,01036,Laudio/Llodio,Álava,333,306,27
2017,01059,Vitoria-Gasteiz,Álava,4089,3197,892
2017,02003,Albacete,Albacete,1923,2657,-734
2017,02009,Almansa,Albacete,357,399,-42
2017,02025,Caudete,Albacete,198,287,-89
2017,02037,Hellín,Albacete,437,550,-113
2017,02069,La Roda,Albacete,193,266,-73
2017,02081,Villarrobledo,Albacete,339,424,-85
2017,03005,Albatera,Alicante,100,109,-9
2017,03009,Alcoy/Alcoi,Alicante,490,666,-176
2017,03011,L'Alfàs del Pi,Alicante,217,245,-28
2017,03014,Alicante/Alacant,Alicante,4618,4670,-52
2017,03015,Almoradí,Alicante,241,255,-14
2017,03018,Altea,Alicante,381,330,51
2017,03019,Aspe,Alicante,140,150,-10
2017,03031,Benidorm,Alicante,1790,1550,240
2017,03041,Benissa,Alicante,114,127,-13
2017,03047,Calp,Alicante,411,378,33
2017,03049,Callosa de Segura,Alicante,155,211,-56
2017,03050,El Campello,Alicante,496,423,73
2017,03056,Cocentaina,Alicante,107,157,-50
2017,03059,Crevillent,Alicante,254,281,-27
2017,03063,Dénia,Alicante,816,794,22
2017,03065,Elche/Elx,Alicante,2546,2329,217
2017,03066,Elda,Alicante,437,468,-31
2017,03076,Guardamar del Segura,Alicante,288,265,23
2017,03079,Ibi,Alicante,153,185,-32
2017,03082,Jávea/Xàbia,Alicante,467,443,24
2017,03089,Monóvar/Monòver,Alicante,74,66,8
2017,03090,Mutxamel,Alicante,210,231,-21
2017,03093,Novelda,Alicante,178,197,-19
2017,03094,La Nucia,Alicante,244,207,37
2017,03099,Orihuela,Alicante,1117,1078,39
2017,03104,Petrer,Alicante,219,219,0
2017,03113,Rojales,Alicante,132,123,9
2017,03119,Sant Joan d'Alacant,Alicante,340,277,63
2017,03121,Santa Pola,Alicante,690,603,87
2017,03122,San Vicente del Raspeig/Sant Vicent del Raspeig,Alicante,601,610,-9
2017,03128,Teulada,Alicante,153,159,-6
2017,03133,Torrevieja,Alicante,2193,2435,-242
2017,03139,Villajoyosa/La Vila Joiosa,Alicante,702,552,150
2017,03140,Villena,Alicante,347,361,-14
2017,03902,Pilar de la Horadada,Alicante,617,708,-91
2017,04003,Adra,Almería,279,304,-25
2017,04006,Albox,Almería,184,208,-24
2017,04013,Almería,Almería,2311,2408,-97
2017,04029,Berja,Almería,103,81,22
2017,04035,Cuevas del Almanzora,Almería,185,228,-43
2017,04052,Huércal de Almería,Almería,139,166,-27
2017,04053,Huércal-Overa,Almería,296,368,-72
2017,04066,Níjar,Almería,444,387,57
2017,04079,Roquetas de Mar,Almería,2140,1880,260
2017,04100,Vera,Almería,425,389,36
2017,04102,Vícar,Almería,345,344,1
2017,04902,El Ejido,Almería,793,1154,-361
2017,05019,Ávila,Ávila,1028,1295,-267
2017,06011,Almendralejo,Badajoz,382,546,-164
2017,06015,Badajoz,Badajoz,1556,2114,-558
2017,06044,Don Benito,Badajoz,399,514,-115
2017,06083,Mérida,Badajoz,760,900,-140
2017,06088,Montijo,Badajoz,162,174,-12
2017,06095,Olivenza,Badajoz,97,133,-36
2017,06149,Villafranca de los Barros,Badajoz,85,116,-31
2017,06153,Villanueva de la Serena,Badajoz,254,333,-79
2017,06158,Zafra,Badajoz,180,282,-102
2017,07003,Alcúdia,Baleares,539,385,154
2017,07005,Andratx,Baleares,163,118,45
2017,07011,Calvià,Baleares,1091,782,309
2017,07013,Campos,Baleares,139,114,25
2017,07014,Capdepera,Baleares,594,367,227
2017,07015,Ciutadella de Menorca,Baleares,979,793,186
2017,07022,Felanitx,Baleares,264,138,126
2017,07024,Formentera,Baleares,709,622,87
2017,07026,Eivissa,Baleares,1576,1540,36
2017,07027,Inca,Baleares,551,405,146
2017,07031,Llucmajor,Baleares,730,569,161
2017,07032,Maó-Mahón,Baleares,808,717,91
2017,07033,Manacor,Baleares,1028,537,491
2017,07036,Marratxí,Baleares,284,225,59
2017,07040,Palma,Baleares,7867,6056,1811
2017,07042,Pollença,Baleares,197,174,23
2017,07044,Sa Pobla,Baleares,150,109,41
2017,07046,Sant Antoni de Portmany,Baleares,1114,950,164
2017,07048,Sant Josep de sa Talaia,Baleares,1029,971,58
2017,07054,Santa Eulària des Riu,Baleares,1281,1180,101
2017,07055,Santa Margalida,Baleares,397,277,120
2017,07057,Santanyí,Baleares,285,236,49
2017,07061,Sóller,Baleares,164,143,21
2017,07062,Son Servera,Baleares,279,180,99
2017,08001,Abrera,Barcelona,106,64,42
2017,08006,Arenys de Mar,Barcelona,111,130,-19
2017,08009,Argentona,Barcelona,58,73,-15
2017,08015,Badalona,Barcelona,1680,1700,-20
2017,08019,Barcelona,Barcelona,20237,18103,2134
2017,08022,Berga,Barcelona,120,129,-9
2017,08033,Caldes de Montbui,Barcelona,92,129,-37
2017,08035,Calella,Barcelona,240,226,14
2017,08040,Canet de Mar,Barcelona,129,102,27
2017,08041,Canovelles,Barcelona,127,112,15
2017,08046,Cardedeu,Barcelona,129,99,30
2017,08051,Castellar del Vallès,Barcelona,117,169,-52
2017,08054,Castellbisbal,Barcelona,66,89,-23
2017,08056,Castelldefels,Barcelona,746,855,-109
2017,08072,Corbera de Llobregat,Barcelona,80,101,-21
2017,08073,Cornellà de Llobregat,Barcelona,691,677,14
2017,08074,Cubelles,Barcelona,268,306,-38
2017,08076,Esparreguera,Barcelona,220,206,14
2017,08077,Esplugues de Llobregat,Barcelona,357,377,-20
2017,08086,Les Franqueses del Vallès,Barcelona,142,121,21
2017,08088,La Garriga,Barcelona,98,101,-3
2017,08089,Gavà,Barcelona,370,465,-95
2017,08096,Granollers,Barcelona,593,525,68
2017,08101,L'Hospitalet de Llobregat,Barcelona,2824,2793,31
2017,08102,Igualada,Barcelona,481,444,37
2017,08105,La Llagosta,Barcelona,83,115,-32
2017,08107,Lliçà d'Amunt,Barcelona,80,76,4
2017,08110,Malgrat de Mar,Barcelona,241,243,-2
2017,08112,Manlleu,Barcelona,247,172,75
2017,08113,Manresa,Barcelona,693,648,45
2017,08114,Martorell,Barcelona,255,253,2
2017,08118,El Masnou,Barcelona,159,144,15
2017,08121,Mataró,Barcelona,992,1052,-60
2017,08123,Molins de Rei,Barcelona,154,157,-3
2017,08124,Mollet del Vallès,Barcelona,352,435,-83
2017,08125,Montcada i Reixac,Barcelona,217,234,-17
2017,08126,Montgat,Barcelona,68,94,-26
2017,08136,Montornès del Vallès,Barcelona,128,93,35
2017,08147,Olesa de Montserrat,Barcelona,177,191,-14
2017,08156,Palau-solità i Plegamans,Barcelona,66,70,-4
2017,08157,Pallejà,Barcelona,44,78,-34
2017,08159,Parets del Vallès,Barcelona,107,130,-23
2017,08161,Piera,Barcelona,102,136,-34
2017,08163,Pineda de Mar,Barcelona,349,345,4
2017,08169,El Prat de Llobregat,Barcelona,601,528,73
2017,08172,Premià de Mar,Barcelona,162,225,-63
2017,08180,Ripollet,Barcelona,325,288,37
2017,08181,La Roca del Vallès,Barcelona,52,56,-4
2017,08184,Rubí,Barcelona,632,609,23
2017,08187,Sabadell,Barcelona,1903,1699,204
2017,08194,Sant Adrià de Besòs,Barcelona,347,392,-45
2017,08196,Sant Andreu de la Barca,Barcelona,232,233,-1
2017,08197,Sant Andreu de Llavaneres,Barcelona,75,119,-44
2017,08200,Sant Boi de Llobregat,Barcelona,659,713,-54
2017,08202,Sant Celoni,Barcelona,247,246,1
2017,08205,Sant Cugat del Vallès,Barcelona,781,778,3
2017,08211,Sant Feliu de Llobregat,Barcelona,283,365,-82
2017,08217,Sant Joan Despí,Barcelona,245,303,-58
2017,08218,Sant Joan de Vilatorrada,Barcelona,53,51,2
2017,08219,Vilassar de Mar,Barcelona,135,155,-20
2017,08221,Sant Just Desvern,Barcelona,127,154,-27
2017,08230,Premià de Dalt,Barcelona,34,66,-32
2017,08231,Sant Pere de Ribes,Barcelona,291,321,-30
2017,08238,Sant Quirze del Vallès,Barcelona,111,131,-20
2017,08240,Sant Sadurní d'Anoia,Barcelona,89,85,4
2017,08245,Santa Coloma de Gramenet,Barcelona,932,1003,-71
2017,08252,Barberà del Vallès,Barcelona,231,223,8
2017,08260,Santa Perpètua de Mogoda,Barcelona,177,197,-20
2017,08263,Sant Vicenç dels Horts,Barcelona,155,246,-91
2017,08266,Cerdanyola del Vallès,Barcelona,419,474,-55
2017,08270,Sitges,Barcelona,302,359,-57
2017,08279,Terrassa,Barcelona,1815,1867,-52
2017,08284,Tordera,Barcelona,385,329,56
2017,08285,Torelló,Barcelona,121,89,32
2017,08295,Vallirana,Barcelona,100,130,-30
2017,08298,Vic,Barcelona,801,476,325
2017,08301,Viladecans,Barcelona,615,592,23
2017,08302,Vilanova del Camí,Barcelona,107,108,-1
2017,08305,Vilafranca del Penedès,Barcelona,406,348,58
2017,08307,Vilanova i la Geltrú,Barcelona,742,819,-77
2017,08904,Badia del Vallès,Barcelona,101,108,-7
2017,09018,Aranda de Duero,Burgos,508,603,-95
2017,09059,Burgos,Burgos,2256,2306,-50
2017,09219,Miranda de Ebro,Burgos,648,739,-91
2017,10037,Cáceres,Cáceres,1135,1646,-511
2017,10067,Coria,Cáceres,125,242,-117
2017,10131,Navalmoral de la Mata,Cáceres,276,538,-262
2017,10148,Plasencia,Cáceres,424,661,-237
2017,11004,Algeciras,Cádiz,1728,1889,-161
2017,11006,Arcos de la Frontera,Cádiz,353,514,-161
2017,11007,Barbate,Cádiz,253,262,-9
2017,11008,Los Barrios,Cádiz,286,296,-10
2017,11012,Cádiz,Cádiz,940,1347,-407
2017,11014,Conil de la Frontera,Cádiz,191,214,-23
2017,11015,Chiclana de la Frontera,Cádiz,1026,1173,-147
2017,11016,Chipiona,Cádiz,234,237,-3
2017,11020,Jerez de la Frontera,Cádiz,2235,3103,-868
2017,11022,La Línea de la Concepción,Cádiz,602,698,-96
2017,11023,Medina-Sidonia,Cádiz,58,89,-31
2017,11027,El Puerto de Santa María,Cádiz,1295,1553,-258
2017,11028,Puerto Real,Cádiz,395,418,-23
2017,11030,Rota,Cádiz,514,517,-3
2017,11031,San Fernando,Cádiz,945,1289,-344
2017,11032,Sanlúcar de Barrameda,Cádiz,469,597,-128
2017,11033,San Roque,Cádiz,566,482,84
2017,11035,Tarifa,Cádiz,281,256,25
2017,11038,Ubrique,Cádiz,85,130,-45
2017,11039,Vejer de la Frontera,Cádiz,51,89,-38
2017,11041,Villamartín,Cádiz,106,189,-83
2017,12005,L'Alcora,Castellón,71,74,-3
2017,12009,Almassora,Castellón,292,278,14
2017,12027,Benicarló,Castellón,562,472,90
2017,12028,Benicasim/Benicàssim,Castellón,271,257,14
2017,12032,Borriana/Burriana,Castellón,521,485,36
2017,12040,Castellón de la Plana/Castelló de la Plana,Castellón,2079,2031,48
2017,12082,Nules,Castellón,172,158,14
2017,12084,Onda,Castellón,219,196,23
2017,12126,La Vall d'Uixó,Castellón,269,357,-88
2017,12135,Vila-real,Castellón,602,562,40
2017,12138,Vinaròs,Castellón,748,649,99
2017,13005,Alcázar de San Juan,Ciudad Real,471,654,-183
2017,13023,Bolaños de Calatrava,Ciudad Real,64,118,-54
2017,13028,Campo de Criptana,Ciudad Real,117,165,-48
2017,13034,Ciudad Real,Ciudad Real,1042,1466,-424
2017,13039,Daimiel,Ciudad Real,161,227,-66
2017,13053,Manzanares,Ciudad Real,185,346,-161
2017,13056,Miguelturra,Ciudad Real,149,208,-59
2017,13071,Puertollano,Ciudad Real,636,1006,-370
2017,13078,Socuéllamos,Ciudad Real,161,194,-33
2017,13079,La Solana,Ciudad Real,78,136,-58
2017,13082,Tomelloso,Ciudad Real,430,538,-108
2017,13087,Valdepeñas,Ciudad Real,430,581,-151
2017,13096,Villarrubia de los Ojos,Ciudad Real,82,112,-30
2017,14002,Aguilar de la Frontera,Córdoba,107,126,-19
2017,14007,Baena,Córdoba,158,299,-141
2017,14013,Cabra,Córdoba,171,268,-97
2017,14017,La Carlota,Córdoba,145,160,-15
2017,14021,Córdoba,Córdoba,3061,4232,-1171
2017,14030,Fuente Palmera,Córdoba,120,126,-6
2017,14038,Lucena,Córdoba,500,614,-114
2017,14042,Montilla,Córdoba,152,228,-76
2017,14049,Palma del Río,Córdoba,265,383,-118
2017,14052,Peñarroya-Pueblonuevo,Córdoba,105,201,-96
2017,14054,Pozoblanco,Córdoba,155,212,-57
2017,14055,Priego de Córdoba,Córdoba,286,375,-89
2017,14056,Puente Genil,Córdoba,405,538,-133
2017,15002,Ames,A Coruña,441,427,14
2017,15005,Arteixo,A Coruña,326,277,49
2017,15009,Betanzos,A Coruña,95,86,9
2017,15011,Boiro,A Coruña,159,162,-3
2017,15017,Cambre,A Coruña,212,170,42
2017,15019,Carballo,A Coruña,189,181,8
2017,15030,A Coruña,A Coruña,3210,2940,270
2017,15031,Culleredo,A Coruña,246,284,-38
2017,15035,Fene,A Coruña,81,70,11
2017,15036,Ferrol,A Coruña,1065,1125,-60
2017,15041,A Laracha,A Coruña,54,46,8
2017,15054,Narón,A Coruña,316,440,-124
2017,15057,Noia,A Coruña,112,109,3
2017,15058,Oleiros,A Coruña,433,397,36
2017,15059,Ordes,A Coruña,66,72,-6
2017,15070,As Pontes de García Rodríguez,A Coruña,85,112,-27
2017,15072,Rianxo,A Coruña,80,90,-10
2017,15073,Ribeira,A Coruña,226,220,6
2017,15075,Sada (A Coruña),A Coruña,193,224,-31
2017,15078,Santiago de Compostela,A Coruña,1560,1286,274
2017,15082,Teo,A Coruña,192,192,0
2017,16078,Cuenca,Cuenca,865,1136,-271
2017,16203,Tarancón,Cuenca,386,347,39
2017,17015,Banyoles,Girona,185,175,10
2017,17022,La Bisbal d'Empordà,Girona,113,112,1
2017,17023,Blanes,Girona,1169,1080,89
2017,17034,Calonge i Sant Antoni,Girona,201,210,-9
2017,17044,Cassà de la Selva,Girona,122,95,27
2017,17047,Castelló d'Empúries,Girona,181,199,-18
2017,17048,Castell-Platja d'Aro,Girona,258,245,13
2017,17062,L'Escala,Girona,141,156,-15
2017,17066,Figueres,Girona,689,675,14
2017,17079,Girona,Girona,1558,1458,100
2017,17095,Lloret de Mar,Girona,880,864,16
2017,17114,Olot,Girona,517,448,69
2017,17117,Palafrugell,Girona,278,274,4
2017,17118,Palamós,Girona,324,298,26
2017,17147,Ripoll,Girona,209,187,22
2017,17152,Roses,Girona,304,335,-31
2017,17155,Salt,Girona,408,404,4
2017,17160,Sant Feliu de Guíxols,Girona,357,298,59
2017,17180,Santa Coloma de Farners,Girona,164,157,7
2017,17199,Torroella de Montgrí,Girona,185,175,10
2017,18003,Albolote,Granada,204,243,-39
2017,18017,Almuñécar,Granada,369,438,-69
2017,18021,Armilla,Granada,488,513,-25
2017,18022,Atarfe,Granada,224,264,-40
2017,18023,Baza,Granada,284,397,-113
2017,18062,Churriana de la Vega,Granada,241,256,-15
2017,18087,Granada,Granada,4014,4351,-337
2017,18089,Guadix,Granada,258,327,-69
2017,18100,Huétor Tájar,Granada,131,139,-8
2017,18101,Huétor Vega,Granada,128,139,-11
2017,18102,Illora,Granada,96,97,-1
2017,18122,Loja,Granada,233,269,-36
2017,18127,Maracena,Granada,224,246,-22
2017,18140,Motril,Granada,698,753,-55
2017,18145,Ogíjares,Granada,171,163,8
2017,18153,Peligros,Granada,99,108,-9
2017,18158,Pinos Puente,Granada,73,92,-19
2017,18173,Salobreña,Granada,151,169,-18
2017,18175,Santa Fe,Granada,145,153,-8
2017,18193,La Zubia,Granada,260,271,-11
2017,18905,Las Gabias,Granada,340,414,-74
2017,18911,Vegas del Genil,Granada,99,152,-53
2017,19024,Alovera,Guadalajara,409,346,63
2017,19046,Azuqueca de Henares,Guadalajara,1204,1262,-58
2017,19071,El Casar,Guadalajara,621,586,35
2017,19130,Guadalajara,Guadalajara,1725,1734,-9
2017,20009,Andoain,Guipúzcoa,115,95,20
2017,20017,Azkoitia,Guipúzcoa,111,95,16
2017,20018,Azpeitia,Guipúzcoa,105,90,15
2017,20019,Beasain,Guipúzcoa,127,106,21
2017,20030,Eibar,Guipúzcoa,459,438,21
2017,20032,Elgoibar,Guipúzcoa,148,129,19
2017,20036,Hondarribia,Guipúzcoa,147,141,6
2017,20040,Hernani,Guipúzcoa,175,161,14
2017,20045,Irun,Guipúzcoa,833,808,25
2017,20055,Arrasate/Mondragón,Guipúzcoa,231,269,-38
2017,20059,Oñati,Guipúzcoa,74,70,4
2017,20063,Oiartzun,Guipúzcoa,80,55,25
2017,20064,Pasaia,Guipúzcoa,153,150,3
2017,20067,Errenteria,Guipúzcoa,317,288,29
2017,20069,Donostia/San Sebastián,Guipúzcoa,2261,2092,169
2017,20071,Tolosa,Guipúzcoa,99,130,-31
2017,20074,Bergara,Guipúzcoa,122,160,-38
2017,20079,Zarautz,Guipúzcoa,174,178,-4
2017,20902,Lasarte-Oria,Guipúzcoa,202,211,-9
2017,21002,Aljaraque,Huelva,267,338,-71
2017,21005,Almonte,Huelva,360,362,-2
2017,21010,Ayamonte,Huelva,296,300,-4
2017,21013,Bollullos Par del Condado,Huelva,114,139,-25
2017,21021,Cartaya,Huelva,286,318,-32
2017,21035,Gibraleón,Huelva,100,107,-7
2017,21041,Huelva,Huelva,1122,1489,-367
2017,21042,Isla Cristina,Huelva,248,306,-58
2017,21044,Lepe,Huelva,326,417,-91
2017,21050,Moguer,Huelva,305,305,0
2017,21054,La Palma del Condado,Huelva,105,112,-7
2017,21055,Palos de la Frontera,Huelva,120,127,-7
2017,21060,Punta Umbría,Huelva,240,228,12
2017,21072,Valverde del Camino,Huelva,82,130,-48
2017,22048,Barbastro,Huesca,238,286,-48
2017,22112,Fraga,Huesca,322,374,-52
2017,22125,Huesca,Huesca,920,1041,-121
2017,22130,Jaca,Huesca,400,448,-48
2017,22158,Monzón,Huesca,262,271,-9
2017,23002,Alcalá la Real,Jaén,259,313,-54
2017,23003,Alcaudete,Jaén,99,130,-31
2017,23005,Andújar,Jaén,275,672,-397
2017,23009,Baeza,Jaén,148,237,-89
2017,23010,Bailén,Jaén,154,258,-104
2017,23024,La Carolina,Jaén,174,284,-110
2017,23050,Jaén,Jaén,968,1790,-822
2017,23053,Jódar,Jaén,84,157,-73
2017,23055,Linares,Jaén,529,1171,-642
2017,23058,Mancha Real,Jaén,102,148,-46
2017,23060,Martos,Jaén,174,250,-76
2017,23086,Torredelcampo,Jaén,93,110,-17
2017,23087,Torredonjimeno,Jaén,135,156,-21
2017,23092,Úbeda,Jaén,360,580,-220
2017,23095,Villacarrillo,Jaén,105,152,-47
2017,24008,Astorga,León,143,150,-7
2017,24010,La Bañeza,León,158,195,-37
2017,24089,León,León,1634,2154,-520
2017,24115,Ponferrada,León,696,1026,-330
2017,24142,San Andrés del Rabanedo,León,359,445,-86
2017,24222,Villaquilambre,León,181,244,-63
2017,25040,Balaguer,Lleida,276,257,19
2017,25120,Lleida,Lleida,2123,2387,-264
2017,25137,Mollerussa,Lleida,241,248,-7
2017,25203,La Seu d'Urgell,Lleida,295,281,14
2017,25217,Tàrrega,Lleida,321,283,38
2017,26018,Arnedo,La Rioja,124,159,-35
2017,26036,Calahorra,La Rioja,374,409,-35
2017,26071,Haro,La Rioja,267,211,56
2017,26089,Logroño,La Rioja,2160,2085,75
2017,27028,Lugo,Lugo,1295,1484,-189
2017,27031,Monforte de Lemos,Lugo,374,400,-26
2017,27057,Sarria,Lugo,123,143,-20
2017,27065,Vilalba,Lugo,123,157,-34
2017,27066,Viveiro,Lugo,233,202,31
2017,28005,Alcalá de Henares,Madrid,2657,2784,-127
2017,28006,Alcobendas,Madrid,1280,1159,121
2017,28007,Alcorcón,Madrid,1571,1502,69
2017,28009,Algete,Madrid,215,252,-37
2017,28010,Alpedrete,Madrid,184,116,68
2017,28013,Aranjuez,Madrid,1240,1095,145
2017,28014,Arganda del Rey,Madrid,514,532,-18
2017,28015,Arroyomolinos (Madrid),Madrid,306,310,-4
2017,28022,Boadilla del Monte,Madrid,424,363,61
2017,28026,Brunete,Madrid,153,103,50
2017,28040,Ciempozuelos,Madrid,341,374,-33
2017,28045,Colmenar Viejo,Madrid,583,499,84
2017,28047,Collado Villalba,Madrid,741,704,37
2017,28049,Coslada,Madrid,628,708,-80
2017,28053,Daganzo de Arriba,Madrid,101,122,-21
2017,28054,El Escorial,Madrid,153,140,13
2017,28058,Fuenlabrada,Madrid,2195,2436,-241
2017,28061,Galapagar,Madrid,355,369,-14
2017,28065,Getafe,Madrid,2099,2049,50
2017,28066,Griñón,Madrid,133,152,-19
2017,28068,Guadarrama,Madrid,172,124,48
2017,28073,Humanes de Madrid,Madrid,297,340,-43
2017,28074,Leganés,Madrid,1818,1729,89
2017,28079,Madrid,Madrid,54658,39666,14992
2017,28080,Majadahonda,Madrid,733,683,50
2017,28083,Meco,Madrid,218,205,13
2017,28084,Mejorada del Campo,Madrid,216,221,-5
2017,28090,Moralzarzal,Madrid,104,135,-31
2017,28092,Móstoles,Madrid,2433,2391,42
2017,28096,Navalcarnero,Madrid,450,394,56
2017,28104,Paracuellos de Jarama,Madrid,366,311,55
2017,28106,Parla,Madrid,1913,1932,-19
2017,28113,Pinto,Madrid,784,621,163
2017,28115,Pozuelo de Alarcón,Madrid,814,676,138
2017,28123,Rivas-Vaciamadrid,Madrid,699,611,88
2017,28127,Las Rozas de Madrid,Madrid,1029,919,110
2017,28129,San Agustín del Guadalix,Madrid,137,157,-20
2017,28130,San Fernando de Henares,Madrid,288,323,-35
2017,28131,San Lorenzo de El Escorial,Madrid,236,222,14
2017,28132,San Martín de la Vega,Madrid,252,240,12
2017,28134,San Sebastián de los Reyes,Madrid,952,954,-2
2017,28148,Torrejón de Ardoz,Madrid,1548,1511,37
2017,28152,Torrelodones,Madrid,221,186,35
2017,28160,Valdemorillo,Madrid,129,138,-9
2017,28161,Valdemoro,Madrid,1200,1145,55
2017,28167,Velilla de San Antonio,Madrid,113,100,13
2017,28172,Villalbilla,Madrid,138,161,-23
2017,28176,Villanueva de la Cañada,Madrid,303,243,60
2017,28177,Villanueva del Pardillo,Madrid,157,165,-8
2017,28181,Villaviciosa de Odón,Madrid,314,228,86
2017,28903,Tres Cantos,Madrid,534,424,110
2017,29007,Alhaurín de la Torre,Málaga,399,275,124
2017,29008,Alhaurín el Grande,Málaga,182,165,17
2017,29012,Álora,Málaga,103,94,9
2017,29015,Antequera,Málaga,386,420,-34
2017,29025,Benalmádena,Málaga,1232,1048,184
2017,29038,Cártama,Málaga,246,153,93
2017,29042,Coín,Málaga,197,224,-27
2017,29051,Estepona,Málaga,1129,1018,111
2017,29054,Fuengirola,Málaga,1314,1169,145
2017,29067,Málaga,Málaga,6815,5917,898
2017,29068,Manilva,Málaga,553,379,174
2017,29069,Marbella,Málaga,2107,2263,-156
2017,29070,Mijas,Málaga,1213,1033,180
2017,29075,Nerja,Málaga,234,230,4
2017,29082,Rincón de la Victoria,Málaga,664,501,163
2017,29084,Ronda,Málaga,448,544,-96
2017,29091,Torrox,Málaga,333,250,83
2017,29094,Vélez-Málaga,Málaga,1026,873,153
2017,29901,Torremolinos,Málaga,1338,1136,202
2017,30002,Abarán,Murcia,93,109,-16
2017,30003,Águilas,Murcia,572,432,140
2017,30005,Alcantarilla,Murcia,433,393,40
2017,30008,Alhama de Murcia,Murcia,243,210,33
2017,30009,Archena,Murcia,356,272,84
2017,30010,Beniel,Murcia,166,212,-46
2017,30012,Bullas,Murcia,70,77,-7
2017,30013,Calasparra,Murcia,143,127,16
2017,30015,Caravaca de la Cruz,Murcia,232,258,-26
2017,30016,Cartagena,Murcia,2396,2732,-336
2017,30017,Cehegín,Murcia,60,111,-51
2017,30018,Ceutí,Murcia,96,116,-20
2017,30019,Cieza (Murcia),Murcia,189,260,-71
2017,30020,Fortuna,Murcia,96,117,-21
2017,30021,Fuente Álamo de Murcia,Murcia,219,215,4
2017,30022,Jumilla,Murcia,339,375,-36
2017,30024,Lorca,Murcia,1113,1133,-20
2017,30026,Mazarrón,Murcia,407,444,-37
2017,30027,Molina de Segura,Murcia,825,830,-5
2017,30029,Mula,Murcia,149,172,-23
2017,30030,Murcia,Murcia,4740,4498,242
2017,30033,Puerto Lumbreras,Murcia,225,236,-11
2017,30035,San Javier,Murcia,683,701,-18
2017,30036,San Pedro del Pinatar,Murcia,660,547,113
2017,30037,Torre-Pacheco,Murcia,417,492,-75
2017,30038,Las Torres de Cotillas,Murcia,123,137,-14
2017,30039,Totana,Murcia,292,295,-3
2017,30041,La Unión,Murcia,174,232,-58
2017,30043,Yecla,Murcia,409,408,1
2017,30901,Santomera,Murcia,183,157,26
2017,30902,Los Alcázares,Murcia,473,419,54
2017,31016,Ansoáin/Antsoain,Navarra,70,64,6
2017,31023,Aranguren,Navarra,72,88,-16
2017,31060,Burlada/Burlata,Navarra,189,176,13
2017,31086,Valle de Egüés,Navarra,148,123,25
2017,31097,Estella-Lizarra,Navarra,152,188,-36
2017,31201,Pamplona/Iruña,Navarra,2517,2317,200
2017,31227,Tafalla,Navarra,115,104,11
2017,31232,Tudela,Navarra,748,601,147
2017,31258,Villava/Atarrabia,Navarra,83,74,9
2017,31901,Barañain,Navarra,241,190,51
2017,31907,Zizur Mayor/Zizur Nagusia,Navarra,128,95,33
2017,32008,Barbadás,Ourense,137,163,-26
2017,32009,O Barco de Valdeorras,Ourense,184,289,-105
2017,32019,O Carballiño,Ourense,170,165,5
2017,32054,Ourense,Ourense,1457,1717,-260
2017,32085,Verín,Ourense,251,308,-57
2017,33002,Aller,Asturias,62,81,-19
2017,33004,Avilés,Asturias,575,699,-124
2017,33011,Cangas del Narcea,Asturias,66,103,-37
2017,33014,Carreño,Asturias,98,75,23
2017,33016,Castrillón,Asturias,138,156,-18
2017,33020,Corvera de Asturias,Asturias,62,121,-59
2017,33024,Gijón,Asturias,2544,2694,-150
2017,33025,Gozón,Asturias,93,91,2
2017,33031,Langreo,Asturias,198,259,-61
2017,33032,Laviana,Asturias,59,84,-25
2017,33033,Lena,Asturias,67,96,-29
2017,33034,Valdés,Asturias,95,90,5
2017,33035,Llanera,Asturias,78,119,-41
2017,33036,Llanes,Asturias,191,199,-8
2017,33037,Mieres (Asturias),Asturias,236,269,-33
2017,33044,Oviedo,Asturias,2235,2694,-459
2017,33060,San Martín del Rey Aurelio,Asturias,88,114,-26
2017,33066,Siero,Asturias,372,401,-29
2017,33076,Villaviciosa,Asturias,120,113,7
2017,34120,Palencia,Palencia,971,1224,-253
2017,35002,Agüimes,Las Palmas,280,303,-23
2017,35003,Antigua,Las Palmas,360,292,68
2017,35004,Arrecife,Las Palmas,1643,1384,259
2017,35006,Arucas,Las Palmas,240,207,33
2017,35009,Gáldar,Las Palmas,123,103,20
2017,35011,Ingenio,Las Palmas,238,205,33
2017,35012,Mogán,Las Palmas,239,221,18
2017,35014,La Oliva,Las Palmas,711,697,14
2017,35015,Pájara,Las Palmas,764,575,189
2017,35016,Las Palmas de Gran Canaria,Las Palmas,4460,4527,-67
2017,35017,Puerto del Rosario,Las Palmas,984,906,78
2017,35018,San Bartolomé,Las Palmas,398,403,-5
2017,35019,San Bartolomé de Tirajana,Las Palmas,647,715,-68
2017,35021,Santa Brígida,Las Palmas,94,74,20
2017,35022,Santa Lucía de Tirajana,Las Palmas,858,750,108
2017,35023,Santa María de Guía de Gran Canaria,Las Palmas,57,43,14
2017,35024,Teguise,Las Palmas,411,457,-46
2017,35026,Telde,Las Palmas,821,800,21
2017,35027,Teror,Las Palmas,55,55,0
2017,35028,Tías,Las Palmas,399,416,-17
2017,35030,Tuineje,Las Palmas,442,278,164
2017,35034,Yaiza,Las Palmas,753,692,61
2017,36003,Baiona,Pontevedra,100,82,18
2017,36004,Bueu,Pontevedra,90,58,32
2017,36006,Cambados,Pontevedra,103,99,4
2017,36008,Cangas,Pontevedra,214,213,1
2017,36017,A Estrada,Pontevedra,231,251,-20
2017,36021,Gondomar,Pontevedra,57,63,-6
2017,36022,O Grove,Pontevedra,86,109,-23
2017,36023,A Guarda,Pontevedra,76,90,-14
2017,36024,Lalín,Pontevedra,279,281,-2
2017,36026,Marín,Pontevedra,240,275,-35
2017,36029,Moaña,Pontevedra,124,130,-6
2017,36033,Mos,Pontevedra,90,82,8
2017,36035,Nigrán,Pontevedra,151,131,20
2017,36038,Pontevedra,Pontevedra,957,1080,-123
2017,36039,O Porriño,Pontevedra,168,172,-4
2017,36041,Poio,Pontevedra,196,169,27
2017,36042,Ponteareas,Pontevedra,210,226,-16
2017,36045,Redondela,Pontevedra,166,197,-31
2017,36051,Sanxenxo,Pontevedra,153,166,-13
2017,36054,Tomiño,Pontevedra,45,102,-57
2017,36055,Tui,Pontevedra,197,142,55
2017,36057,Vigo,Pontevedra,3264,3100,164
2017,36060,Vilagarcía de Arousa,Pontevedra,484,530,-46
2017,36061,Vilanova de Arousa,Pontevedra,93,113,-20
2017,37046,Béjar,Salamanca,172,228,-56
2017,37107,Ciudad Rodrigo,Salamanca,131,153,-22
2017,37274,Salamanca,Salamanca,2066,2528,-462
2017,37294,Santa Marta de Tormes,Salamanca,198,234,-36
2017,38001,Adeje,Santa Cruz de Tenerife,918,989,-71
2017,38006,Arona,Santa Cruz de Tenerife,1321,1646,-325
2017,38011,Candelaria,Santa Cruz de Tenerife,376,361,15
2017,38017,Granadilla de Abona,Santa Cruz de Tenerife,898,913,-15
2017,38019,Guía de Isora,Santa Cruz de Tenerife,349,328,21
2017,38020,Güímar,Santa Cruz de Tenerife,213,175,38
2017,38022,Icod de los Vinos,Santa Cruz de Tenerife,138,122,16
2017,38023,San Cristóbal de La Laguna,Santa Cruz de Tenerife,1754,1467,287
2017,38024,Los Llanos de Aridane,Santa Cruz de Tenerife,227,240,-13
2017,38026,La Orotava,Santa Cruz de Tenerife,236,264,-28
2017,38028,Puerto de la Cruz,Santa Cruz de Tenerife,555,414,141
2017,38031,Los Realejos,Santa Cruz de Tenerife,168,152,16
2017,38032,El Rosario,Santa Cruz de Tenerife,175,181,-6
2017,38035,San Miguel de Abona,Santa Cruz de Tenerife,282,299,-17
2017,38037,Santa Cruz de la Palma,Santa Cruz de Tenerife,260,228,32
2017,38038,Santa Cruz de Tenerife,Santa Cruz de Tenerife,2457,2408,49
2017,38039,Santa Úrsula,Santa Cruz de Tenerife,110,112,-2
2017,38040,Santiago del Teide,Santa Cruz de Tenerife,144,159,-15
2017,38043,Tacoronte,Santa Cruz de Tenerife,175,140,35
2017,38046,Tegueste,Santa Cruz de Tenerife,59,45,14
2017,39008,El Astillero,Cantabria,172,181,-9
2017,39016,Camargo,Cantabria,252,245,7
2017,39020,Castro-Urdiales,Cantabria,1323,1257,66
2017,39025,Los Corrales de Buelna,Cantabria,76,73,3
2017,39035,Laredo,Cantabria,165,210,-45
2017,39052,Piélagos,Cantabria,327,282,45
2017,39073,Santa Cruz de Bezana,Cantabria,136,118,18
2017,39075,Santander,Cantabria,2386,2109,277
2017,39079,Santoña,Cantabria,187,158,29
2017,39087,Torrelavega,Cantabria,381,475,-94
2017,40194,Segovia,Segovia,844,1045,-201
2017,41004,Alcalá de Guadaíra,Sevilla,615,650,-35
2017,41005,Alcalá del Río,Sevilla,74,112,-38
2017,41007,La Algaba,Sevilla,100,133,-33
2017,41011,Arahal,Sevilla,86,108,-22
2017,41016,Bollullos de la Mitación,Sevilla,123,98,25
2017,41017,Bormujos,Sevilla,266,298,-32
2017,41018,Brenes,Sevilla,98,100,-2
2017,41020,Las Cabezas de San Juan,Sevilla,120,149,-29
2017,41021,Camas,Sevilla,291,297,-6
2017,41023,Cantillana,Sevilla,67,77,-10
2017,41024,Carmona,Sevilla,207,201,6
2017,41029,Castilleja de la Cuesta,Sevilla,135,138,-3
2017,41034,Coria del Río,Sevilla,265,321,-56
2017,41038,Dos Hermanas,Sevilla,1012,1316,-304
2017,41039,Écija,Sevilla,261,409,-148
2017,41040,Espartinas,Sevilla,198,189,9
2017,41041,Estepa,Sevilla,108,139,-31
2017,41044,Gelves,Sevilla,90,128,-38
2017,41047,Gines,Sevilla,112,95,17
2017,41049,Guillena,Sevilla,102,125,-23
2017,41053,Lebrija,Sevilla,263,296,-33
2017,41055,Lora del Río,Sevilla,119,155,-36
2017,41058,Mairena del Alcor,Sevilla,175,163,12
2017,41059,Mairena del Aljarafe,Sevilla,564,613,-49
2017,41060,Marchena,Sevilla,100,168,-68
2017,41065,Morón de la Frontera,Sevilla,260,320,-60
2017,41068,Osuna,Sevilla,113,166,-53
2017,41069,Los Palacios y Villafranca,Sevilla,225,280,-55
2017,41075,Pilas,Sevilla,94,146,-52
2017,41077,La Puebla de Cazalla,Sevilla,80,108,-28
2017,41079,La Puebla del Río,Sevilla,92,122,-30
2017,41081,La Rinconada,Sevilla,226,283,-57
2017,41086,San Juan de Aznalfarache,Sevilla,229,280,-51
2017,41087,Sanlúcar la Mayor,Sevilla,122,139,-17
2017,41091,Sevilla,Sevilla,6835,7775,-940
2017,41093,Tomares,Sevilla,292,327,-35
2017,41095,Utrera,Sevilla,403,484,-81
2017,41102,El Viso del Alcor,Sevilla,79,118,-39
2017,42173,Soria,Soria,649,637,12
2017,43014,Amposta,Tarragona,240,275,-35
2017,43037,Calafell,Tarragona,1462,994,468
2017,43038,Cambrils,Tarragona,770,611,159
2017,43051,Cunit,Tarragona,892,590,302
2017,43092,Mont-roig del Camp,Tarragona,283,254,29
2017,43123,Reus,Tarragona,1189,1195,-6
2017,43136,Sant Carles de la Ràpita,Tarragona,319,313,6
2017,43148,Tarragona,Tarragona,2190,2185,5
2017,43153,Torredembarra,Tarragona,515,354,161
2017,43155,Tortosa,Tarragona,400,429,-29
2017,43161,Valls,Tarragona,266,261,5
2017,43163,El Vendrell,Tarragona,1331,970,361
2017,43171,Vila-seca,Tarragona,372,387,-15
2017,43901,Deltebre,Tarragona,127,116,11
2017,43905,Salou,Tarragona,669,694,-25
2017,44013,Alcañiz,Teruel,277,343,-66
2017,44216,Teruel,Teruel,619,576,43
2017,45019,Bargas,Toledo,169,203,-34
2017,45053,Consuegra,Toledo,70,110,-40
2017,45066,Fuensalida,Toledo,313,300,13
2017,45081,Illescas,Toledo,1432,1071,361
2017,45087,Madridejos,Toledo,112,141,-29
2017,45121,Ocaña,Toledo,763,572,191
2017,45142,Quintanar de la Orden,Toledo,144,179,-35
2017,45161,Seseña,Toledo,2454,1688,766
2017,45163,Sonseca,Toledo,104,187,-83
2017,45165,Talavera de la Reina,Toledo,1414,1734,-320
2017,45168,Toledo,Toledo,1609,1869,-260
2017,45173,Torrijos,Toledo,259,282,-23
2017,45205,Yuncos,Toledo,491,397,94
2017,46005,Alaquàs,Valencia,240,202,38
2017,46007,Albal,Valencia,118,121,-3
2017,46011,Alberic,Valencia,82,82,0
2017,46013,Alboraya,Valencia,224,237,-13
2017,46017,Alzira,Valencia,422,363,59
2017,46019,L'Alcúdia,Valencia,89,69,20
2017,46021,Aldaia,Valencia,294,241,53
2017,46022,Alfafar,Valencia,227,211,16
2017,46029,Algemesí,Valencia,198,215,-17
2017,46031,Alginet,Valencia,79,68,11
2017,46051,Benaguasil,Valencia,105,103,2
2017,46054,Benetússer,Valencia,129,79,50
2017,46060,Benifaió,Valencia,78,85,-7
2017,46070,Bétera,Valencia,300,237,63
2017,46078,Burjassot,Valencia,357,333,24
2017,46081,Canals,Valencia,67,88,-21
2017,46083,Carcaixent,Valencia,166,164,2
2017,46085,Carlet,Valencia,88,106,-18
2017,46094,Catarroja,Valencia,282,245,37
2017,46102,Quart de Poblet,Valencia,204,138,66
2017,46105,Cullera,Valencia,285,274,11
2017,46110,Xirivella,Valencia,237,241,-4
2017,46111,Chiva,Valencia,136,129,7
2017,46116,L'Eliana,Valencia,183,164,19
2017,46131,Gandia,Valencia,1144,1167,-23
2017,46135,Godella,Valencia,111,127,-16
2017,46145,Xátiva,Valencia,243,234,9
2017,46147,Llíria,Valencia,208,237,-29
2017,46159,Manises,Valencia,266,250,16
2017,46164,Massamagrell,Valencia,167,108,59
2017,46166,Meliana,Valencia,81,81,0
2017,46169,Mislata,Valencia,408,393,15
2017,46171,Moncada,Valencia,131,143,-12
2017,46181,Oliva,Valencia,300,315,-15
2017,46184,Ontinyent,Valencia,386,385,1
2017,46186,Paiporta,Valencia,167,160,7
2017,46190,Paterna,Valencia,690,665,25
2017,46193,Picanya,Valencia,74,73,1
2017,46194,Picassent,Valencia,135,129,6
2017,46202,La Pobla de Vallbona,Valencia,226,182,44
2017,46205,Puçol,Valencia,192,189,3
2017,46213,Requena,Valencia,165,174,-9
2017,46214,Riba-roja de Túria,Valencia,214,207,7
2017,46220,Sagunto/Sagunt,Valencia,920,865,55
2017,46223,Sedaví,Valencia,73,70,3
2017,46230,Silla,Valencia,148,164,-16
2017,46235,Sueca,Valencia,180,199,-19
2017,46238,Tavernes de la Valldigna,Valencia,156,154,2
2017,46244,Torrent (Valencia),Valencia,814,704,110
2017,46249,Utiel,Valencia,66,73,-7
2017,46250,València,Valencia,10002,9193,809
2017,47010,Arroyo de la Encomienda,Valladolid,240,295,-55
2017,47076,Laguna de Duero,Valladolid,209,226,-17
2017,47085,Medina del Campo,Valladolid,243,259,-16
2017,47186,Valladolid,Valladolid,3943,4038,-95
2017,48003,Amorebieta-Etxano,Vizcaya,158,128,30
2017,48011,Arrigorriaga,Vizcaya,80,95,-15
2017,48013,Barakaldo,Vizcaya,1025,1036,-11
2017,48015,Basauri,Vizcaya,314,319,-5
2017,48017,Bermeo,Vizcaya,138,127,11
2017,48020,Bilbao,Vizcaya,4519,3966,553
2017,48027,Durango,Vizcaya,303,251,52
2017,48029,Etxebarri,Vizcaya,85,82,3
2017,48034,Ermua,Vizcaya,208,253,-45
2017,48036,Galdakao,Vizcaya,187,186,1
2017,48044,Getxo,Vizcaya,710,810,-100
2017,48046,Gernika-Lumo,Vizcaya,114,96,18
2017,48054,Leioa,Vizcaya,273,251,22
2017,48069,Mungia,Vizcaya,143,139,4
2017,48078,Portugalete,Vizcaya,331,321,10
2017,48080,Valle de Trápaga-Trapagaran,Vizcaya,74,76,-2
2017,48082,Santurtzi,Vizcaya,408,377,31
2017,48084,Sestao,Vizcaya,194,221,-27
2017,48085,Sopela,Vizcaya,102,115,-13
2017,48902,Erandio,Vizcaya,200,199,1
2017,49021,Benavente,Zamora,267,365,-98
2017,49275,Zamora,Zamora,741,1057,-316
2017,50067,Calatayud,Zaragoza,671,624,47
2017,50089,Cuarte de Huerva,Zaragoza,261,208,53
2017,50095,Ejea de los Caballeros,Zaragoza,185,202,-17
2017,50251,Tarazona,Zaragoza,175,175,0
2017,50272,Utebo,Zaragoza,194,177,17
2017,50297,Zaragoza,Zaragoza,8378,7702,676
2017,51001,Ceuta,Ceuta,1966,2312,-346
2017,52001,Melilla,Melilla,2318,3185,-867
2018,01002,Amurrio,Álava,173,146,27
2018,01036,Laudio/Llodio,Álava,270,309,-39
2018,01059,Vitoria-Gasteiz,Álava,4155,3414,741
2018,02003,Albacete,Albacete,2202,2742,-540
2018,02009,Almansa,Albacete,383,489,-106
2018,02025,Caudete,Albacete,212,297,-85
2018,02037,Hellín,Albacete,436,552,-116
2018,02069,La Roda,Albacete,230,272,-42
2018,02081,Villarrobledo,Albacete,350,497,-147
2018,03005,Albatera,Alicante,156,90,66
2018,03009,Alcoy/Alcoi,Alicante,546,613,-67
2018,03011,L'Alfàs del Pi,Alicante,263,224,39
2018,03014,Alicante/Alacant,Alicante,4719,4776,-57
2018,03015,Almoradí,Alicante,199,240,-41
2018,03018,Altea,Alicante,395,344,51
2018,03019,Aspe,Alicante,137,157,-20
2018,03031,Benidorm,Alicante,1755,1571,184
2018,03041,Benissa,Alicante,123,131,-8
2018,03047,Calp,Alicante,388,371,17
2018,03049,Callosa de Segura,Alicante,147,205,-58
2018,03050,El Campello,Alicante,489,416,73
2018,03056,Cocentaina,Alicante,124,169,-45
2018,03059,Crevillent,Alicante,222,252,-30
2018,03063,Dénia,Alicante,821,751,70
2018,03065,Elche/Elx,Alicante,2499,2346,153
2018,03066,Elda,Alicante,415,534,-119
2018,03076,Guardamar del Segura,Alicante,296,256,40
2018,03079,Ibi,Alicante,183,163,20
2018,03082,Jávea/Xàbia,Alicante,428,450,-22
2018,03089,Monóvar/Monòver,Alicante,82,97,-15
2018,03090,Mutxamel,Alicante,250,273,-23
2018,03093,Novelda,Alicante,166,201,-35
2018,03094,La Nucia,Alicante,219,245,-26
2018,03099,Orihuela,Alicante,1117,1052,65
2018,03102,Pego,Alicante,163,123,40
2018,03104,Petrer,Alicante,205,272,-67
2018,03113,Rojales,Alicante,147,106,41
2018,03119,Sant Joan d'Alacant,Alicante,394,326,68
2018,03121,Santa Pola,Alicante,771,659,112
2018,03122,San Vicente del Raspeig/Sant Vicent del Raspeig,Alicante,655,600,55
2018,03128,Teulada,Alicante,206,192,14
2018,03133,Torrevieja,Alicante,2041,2239,-198
2018,03139,Villajoyosa/La Vila Joiosa,Alicante,683,505,178
2018,03140,Villena,Alicante,316,461,-145
2018,03902,Pilar de la Horadada,Alicante,579,702,-123
2018,04003,Adra,Almería,300,304,-4
2018,04006,Albox,Almería,199,238,-39
2018,04013,Almería,Almería,2537,2590,-53
2018,04029,Berja,Almería,92,95,-3
2018,04035,Cuevas del Almanzora,Almería,174,214,-40
2018,04052,Huércal de Almería,Almería,153,177,-24
2018,04053,Huércal-Overa,Almería,287,325,-38
2018,04066,Níjar,Almería,395,414,-19
2018,04079,Roquetas de Mar,Almería,2066,1985,81
2018,04100,Vera,Almería,419,365,54
2018,04102,Vícar,Almería,397,440,-43
2018,04902,El Ejido,Almería,723,1064,-341
2018,05019,Ávila,Ávila,1178,1507,-329
2018,06011,Almendralejo,Badajoz,373,444,-71
2018,06015,Badajoz,Badajoz,1771,2258,-487
2018,06044,Don Benito,Badajoz,448,515,-67
2018,06083,Mérida,Badajoz,759,970,-211
2018,06088,Montijo,Badajoz,120,207,-87
2018,06095,Olivenza,Badajoz,115,141,-26
2018,06149,Villafranca de los Barros,Badajoz,109,108,1
2018,06153,Villanueva de la Serena,Badajoz,245,325,-80
2018,06158,Zafra,Badajoz,183,266,-83
2018,07003,Alcúdia,Baleares,661,444,217
2018,07005,Andratx,Baleares,206,130,76
2018,07011,Calvià,Baleares,1157,827,330
2018,07013,Campos,Baleares,153,163,-10
2018,07014,Capdepera,Baleares,510,368,142
2018,07015,Ciutadella de Menorca,Baleares,1087,746,341
2018,07022,Felanitx,Baleares,225,189,36
2018,07024,Formentera,Baleares,648,649,-1
2018,07026,Eivissa,Baleares,1589,1531,58
2018,07027,Inca,Baleares,593,382,211
2018,07031,Llucmajor,Baleares,752,593,159
2018,07032,Maó-Mahón,Baleares,846,689,157
2018,07033,Manacor,Baleares,1006,668,338
2018,07036,Marratxí,Baleares,246,249,-3
2018,07040,Palma,Baleares,7924,6042,1882
2018,07042,Pollença,Baleares,299,183,116
2018,07044,Sa Pobla,Baleares,184,103,81
2018,07046,Sant Antoni de Portmany,Baleares,1048,870,178
2018,07048,Sant Josep de sa Talaia,Baleares,1233,997,236
2018,07054,Santa Eulària des Riu,Baleares,1236,1191,45
2018,07055,Santa Margalida,Baleares,476,274,202
2018,07057,Santanyí,Baleares,305,187,118
2018,07061,Sóller,Baleares,171,131,40
2018,07062,Son Servera,Baleares,298,187,111
2018,08001,Abrera,Barcelona,91,112,-21
2018,08006,Arenys de Mar,Barcelona,104,127,-23
2018,08009,Argentona,Barcelona,54,92,-38
2018,08015,Badalona,Barcelona,1597,1816,-219
2018,08019,Barcelona,Barcelona,19269,20907,-1638
2018,08022,Berga,Barcelona,155,136,19
2018,08033,Caldes de Montbui,Barcelona,101,128,-27
2018,08035,Calella,Barcelona,208,264,-56
2018,08040,Canet de Mar,Barcelona,113,96,17
2018,08041,Canovelles,Barcelona,125,120,5
2018,08046,Cardedeu,Barcelona,117,114,3
2018,08051,Castellar del Vallès,Barcelona,90,184,-94
2018,08054,Castellbisbal,Barcelona,59,123,-64
2018,08056,Castelldefels,Barcelona,800,956,-156
2018,08072,Corbera de Llobregat,Barcelona,64,135,-71
2018,08073,Cornellà de Llobregat,Barcelona,689,792,-103
2018,08074,Cubelles,Barcelona,239,344,-105
2018,08076,Esparreguera,Barcelona,177,168,9
2018,08077,Esplugues de Llobregat,Barcelona,373,451,-78
2018,08086,Les Franqueses del Vallès,Barcelona,134,160,-26
2018,08088,La Garriga,Barcelona,91,97,-6
2018,08089,Gavà,Barcelona,377,560,-183
2018,08096,Granollers,Barcelona,538,596,-58
2018,08101,L'Hospitalet de Llobregat,Barcelona,2753,3057,-304
2018,08102,Igualada,Barcelona,428,462,-34
2018,08105,La Llagosta,Barcelona,107,87,20
2018,08107,Lliçà d'Amunt,Barcelona,73,87,-14
2018,08110,Malgrat de Mar,Barcelona,292,295,-3
2018,08112,Manlleu,Barcelona,279,192,87
2018,08113,Manresa,Barcelona,731,668,63
2018,08114,Martorell,Barcelona,270,275,-5
2018,08118,El Masnou,Barcelona,141,188,-47
2018,08121,Mataró,Barcelona,953,1090,-137
2018,08123,Molins de Rei,Barcelona,127,188,-61
2018,08124,Mollet del Vallès,Barcelona,390,440,-50
2018,08125,Montcada i Reixac,Barcelona,275,285,-10
2018,08126,Montgat,Barcelona,75,95,-20
2018,08136,Montornès del Vallès,Barcelona,92,118,-26
2018,08147,Olesa de Montserrat,Barcelona,185,175,10
2018,08156,Palau-solità i Plegamans,Barcelona,68,93,-25
2018,08157,Pallejà,Barcelona,81,84,-3
2018,08159,Parets del Vallès,Barcelona,100,136,-36
2018,08161,Piera,Barcelona,133,147,-14
2018,08163,Pineda de Mar,Barcelona,324,305,19
2018,08169,El Prat de Llobregat,Barcelona,559,557,2
2018,08172,Premià de Mar,Barcelona,165,238,-73
2018,08180,Ripollet,Barcelona,262,310,-48
2018,08181,La Roca del Vallès,Barcelona,38,77,-39
2018,08184,Rubí,Barcelona,580,742,-162
2018,08187,Sabadell,Barcelona,1687,1859,-172
2018,08194,Sant Adrià de Besòs,Barcelona,280,398,-118
2018,08196,Sant Andreu de la Barca,Barcelona,224,273,-49
2018,08197,Sant Andreu de Llavaneres,Barcelona,72,133,-61
2018,08200,Sant Boi de Llobregat,Barcelona,637,714,-77
2018,08202,Sant Celoni,Barcelona,243,226,17
2018,08205,Sant Cugat del Vallès,Barcelona,705,925,-220
2018,08211,Sant Feliu de Llobregat,Barcelona,286,373,-87
2018,08217,Sant Joan Despí,Barcelona,208,278,-70
2018,08218,Sant Joan de Vilatorrada,Barcelona,53,69,-16
2018,08219,Vilassar de Mar,Barcelona,113,190,-77
2018,08221,Sant Just Desvern,Barcelona,105,152,-47
2018,08230,Premià de Dalt,Barcelona,60,80,-20
2018,08231,Sant Pere de Ribes,Barcelona,351,452,-101
2018,08238,Sant Quirze del Vallès,Barcelona,93,145,-52
2018,08240,Sant Sadurní d'Anoia,Barcelona,95,98,-3
2018,08245,Santa Coloma de Gramenet,Barcelona,986,1195,-209
2018,08252,Barberà del Vallès,Barcelona,202,285,-83
2018,08260,Santa Perpètua de Mogoda,Barcelona,146,212,-66
2018,08263,Sant Vicenç dels Horts,Barcelona,197,282,-85
2018,08266,Cerdanyola del Vallès,Barcelona,430,523,-93
2018,08270,Sitges,Barcelona,344,365,-21
2018,08279,Terrassa,Barcelona,1820,1861,-41
2018,08284,Tordera,Barcelona,400,428,-28
2018,08285,Torelló,Barcelona,97,115,-18
2018,08295,Vallirana,Barcelona,110,125,-15
2018,08298,Vic,Barcelona,756,540,216
2018,08301,Viladecans,Barcelona,519,665,-146
2018,08302,Vilanova del Camí,Barcelona,84,75,9
2018,08305,Vilafranca del Penedès,Barcelona,346,473,-127
2018,08307,Vilanova i la Geltrú,Barcelona,834,942,-108
2018,08904,Badia del Vallès,Barcelona,99,129,-30
2018,09018,Aranda de Duero,Burgos,594,724,-130
2018,09059,Burgos,Burgos,2190,2485,-295
2018,09219,Miranda de Ebro,Burgos,828,802,26
2018,10037,Cáceres,Cáceres,1194,1627,-433
2018,10067,Coria,Cáceres,140,226,-86
2018,10131,Navalmoral de la Mata,Cáceres,342,483,-141
2018,10148,Plasencia,Cáceres,437,702,-265
2018,11004,Algeciras,Cádiz,1868,1975,-107
2018,11006,Arcos de la Frontera,Cádiz,409,488,-79
2018,11007,Barbate,Cádiz,225,246,-21
2018,11008,Los Barrios,Cádiz,311,354,-43
2018,11012,Cádiz,Cádiz,1198,1366,-168
2018,11014,Conil de la Frontera,Cádiz,239,232,7
2018,11015,Chiclana de la Frontera,Cádiz,1138,1081,57
2018,11016,Chipiona,Cádiz,285,265,20
2018,11020,Jerez de la Frontera,Cádiz,2376,3184,-808
2018,11022,La Línea de la Concepción,Cádiz,614,734,-120
2018,11023,Medina-Sidonia,Cádiz,76,79,-3
2018,11027,El Puerto de Santa María,Cádiz,1292,1536,-244
2018,11028,Puerto Real,Cádiz,386,461,-75
2018,11030,Rota,Cádiz,556,548,8
2018,11031,San Fernando,Cádiz,1074,1255,-181
2018,11032,Sanlúcar de Barrameda,Cádiz,623,599,24
2018,11033,San Roque,Cádiz,643,497,146
2018,11035,Tarifa,Cádiz,298,241,57
2018,11038,Ubrique,Cádiz,132,166,-34
2018,11039,Vejer de la Frontera,Cádiz,54,76,-22
2018,11041,Villamartín,Cádiz,136,196,-60
2018,12005,L'Alcora,Castellón,96,81,15
2018,12009,Almassora,Castellón,382,258,124
2018,12027,Benicarló,Castellón,484,481,3
2018,12028,Benicasim/Benicàssim,Castellón,300,231,69
2018,12032,Borriana/Burriana,Castellón,535,442,93
2018,12040,Castellón de la Plana/Castelló de la Plana,Castellón,2389,2049,340
2018,12082,Nules,Castellón,158,137,21
2018,12084,Onda,Castellón,239,237,2
2018,12126,La Vall d'Uixó,Castellón,293,338,-45
2018,12135,Vila-real,Castellón,598,459,139
2018,12138,Vinaròs,Castellón,736,597,139
2018,13005,Alcázar de San Juan,Ciudad Real,527,656,-129
2018,13023,Bolaños de Calatrava,Ciudad Real,96,130,-34
2018,13028,Campo de Criptana,Ciudad Real,113,178,-65
2018,13034,Ciudad Real,Ciudad Real,1131,1577,-446
2018,13039,Daimiel,Ciudad Real,152,220,-68
2018,13053,Manzanares,Ciudad Real,219,275,-56
2018,13056,Miguelturra,Ciudad Real,150,212,-62
2018,13071,Puertollano,Ciudad Real,571,1060,-489
2018,13078,Socuéllamos,Ciudad Real,202,239,-37
2018,13079,La Solana,Ciudad Real,115,164,-49
2018,13082,Tomelloso,Ciudad Real,434,608,-174
2018,13087,Valdepeñas,Ciudad Real,416,589,-173
2018,14002,Aguilar de la Frontera,Córdoba,86,130,-44
2018,14007,Baena,Córdoba,195,287,-92
2018,14013,Cabra,Córdoba,201,238,-37
2018,14017,La Carlota,Córdoba,147,192,-45
2018,14021,Córdoba,Córdoba,3361,4384,-1023
2018,14030,Fuente Palmera,Córdoba,148,98,50
2018,14038,Lucena,Córdoba,494,593,-99
2018,14042,Montilla,Córdoba,170,260,-90
2018,14049,Palma del Río,Córdoba,294,374,-80
2018,14052,Peñarroya-Pueblonuevo,Córdoba,177,228,-51
2018,14054,Pozoblanco,Córdoba,184,195,-11
2018,14055,Priego de Córdoba,Córdoba,267,346,-79
2018,14056,Puente Genil,Córdoba,343,557,-214
2018,15002,Ames,A Coruña,470,442,28
2018,15005,Arteixo,A Coruña,363,338,25
2018,15009,Betanzos,A Coruña,117,105,12
2018,15011,Boiro,A Coruña,199,198,1
2018,15017,Cambre,A Coruña,178,229,-51
2018,15019,Carballo,A Coruña,217,172,45
2018,15030,A Coruña,A Coruña,3465,3115,350
2018,15031,Culleredo,A Coruña,285,291,-6
2018,15035,Fene,A Coruña,69,72,-3
2018,15036,Ferrol,A Coruña,1097,1131,-34
2018,15041,A Laracha,A Coruña,52,63,-11
2018,15054,Narón,A Coruña,354,444,-90
2018,15057,Noia,A Coruña,119,135,-16
2018,15058,Oleiros,A Coruña,435,425,10
2018,15059,Ordes,A Coruña,82,87,-5
2018,15070,As Pontes de García Rodríguez,A Coruña,78,96,-18
2018,15072,Rianxo,A Coruña,75,111,-36
2018,15073,Ribeira,A Coruña,211,282,-71
2018,15075,Sada (A Coruña),A Coruña,190,177,13
2018,15078,Santiago de Compostela,A Coruña,1612,1366,246
2018,15082,Teo,A Coruña,224,218,6
2018,16078,Cuenca,Cuenca,884,1236,-352
2018,16203,Tarancón,Cuenca,446,416,30
2018,17015,Banyoles,Girona,214,195,19
2018,17022,La Bisbal d'Empordà,Girona,123,129,-6
2018,17023,Blanes,Girona,1197,1133,64
2018,17034,Calonge i Sant Antoni,Girona,210,181,29
2018,17044,Cassà de la Selva,Girona,113,116,-3
2018,17047,Castelló d'Empúries,Girona,171,149,22
2018,17048,Castell-Platja d'Aro,Girona,299,266,33
2018,17062,L'Escala,Girona,149,179,-30
2018,17066,Figueres,Girona,683,779,-96
2018,17079,Girona,Girona,1775,1718,57
2018,17095,Lloret de Mar,Girona,870,908,-38
2018,17114,Olot,Girona,663,417,246
2018,17117,Palafrugell,Girona,273,283,-10
2018,17118,Palamós,Girona,317,308,9
2018,17147,Ripoll,Girona,196,198,-2
2018,17152,Roses,Girona,287,324,-37
2018,17155,Salt,Girona,401,400,1
2018,17160,Sant Feliu de Guíxols,Girona,352,338,14
2018,17180,Santa Coloma de Farners,Girona,180,141,39
2018,17199,Torroella de Montgrí,Girona,183,186,-3
2018,18003,Albolote,Granada,206,257,-51
2018,18017,Almuñécar,Granada,427,434,-7
2018,18021,Armilla,Granada,542,460,82
2018,18022,Atarfe,Granada,224,259,-35
2018,18023,Baza,Granada,290,428,-138
2018,18062,Churriana de la Vega,Granada,278,262,16
2018,18087,Granada,Granada,4716,4475,241
2018,18089,Guadix,Granada,228,370,-142
2018,18100,Huétor Tájar,Granada,126,143,-17
2018,18101,Huétor Vega,Granada,127,124,3
2018,18102,Illora,Granada,62,110,-48
2018,18122,Loja,Granada,233,281,-48
2018,18127,Maracena,Granada,244,305,-61
2018,18140,Motril,Granada,754,786,-32
2018,18145,Ogíjares,Granada,158,201,-43
2018,18153,Peligros,Granada,118,99,19
2018,18158,Pinos Puente,Granada,58,98,-40
2018,18173,Salobreña,Granada,192,205,-13
2018,18175,Santa Fe,Granada,232,171,61
2018,18193,La Zubia,Granada,260,238,22
2018,18905,Las Gabias,Granada,342,373,-31
2018,18911,Vegas del Genil,Granada,115,117,-2
2018,19024,Alovera,Guadalajara,472,360,112
2018,19046,Azuqueca de Henares,Guadalajara,1319,1137,182
2018,19058,Cabanillas del Campo,Guadalajara,327,246,81
2018,19071,El Casar,Guadalajara,682,525,157
2018,19130,Guadalajara,Guadalajara,1880,1866,14
2018,20009,Andoain,Guipúzcoa,112,100,12
2018,20017,Azkoitia,Guipúzcoa,92,103,-11
2018,20018,Azpeitia,Guipúzcoa,124,99,25
2018,20019,Beasain,Guipúzcoa,118,139,-21
2018,20030,Eibar,Guipúzcoa,428,469,-41
2018,20032,Elgoibar,Guipúzcoa,124,144,-20
2018,20036,Hondarribia,Guipúzcoa,113,148,-35
2018,20040,Hernani,Guipúzcoa,163,144,19
2018,20045,Irun,Guipúzcoa,812,803,9
2018,20055,Arrasate/Mondragón,Guipúzcoa,219,266,-47
2018,20059,Oñati,Guipúzcoa,62,82,-20
2018,20063,Oiartzun,Guipúzcoa,64,73,-9
2018,20064,Pasaia,Guipúzcoa,159,166,-7
2018,20067,Errenteria,Guipúzcoa,319,350,-31
2018,20069,Donostia/San Sebastián,Guipúzcoa,2426,2342,84
2018,20071,Tolosa,Guipúzcoa,161,146,15
2018,20074,Bergara,Guipúzcoa,140,148,-8
2018,20076,Ordizia,Guipúzcoa,177,92,85
2018,20079,Zarautz,Guipúzcoa,186,201,-15
2018,20081,Zumaia,Guipúzcoa,74,86,-12
2018,20902,Lasarte-Oria,Guipúzcoa,177,195,-18
2018,21002,Aljaraque,Huelva,264,244,20
2018,21005,Almonte,Huelva,383,417,-34
2018,21010,Ayamonte,Huelva,312,324,-12
2018,21013,Bollullos Par del Condado,Huelva,166,148,18
2018,21021,Cartaya,Huelva,272,257,15
2018,21035,Gibraleón,Huelva,77,113,-36
2018,21041,Huelva,Huelva,1094,1611,-517
2018,21042,Isla Cristina,Huelva,306,254,52
2018,21044,Lepe,Huelva,367,363,4
2018,21050,Moguer,Huelva,301,334,-33
2018,21054,La Palma del Condado,Huelva,143,167,-24
2018,21055,Palos de la Frontera,Huelva,151,112,39
2018,21060,Punta Umbría,Huelva,231,234,-3
2018,21072,Valverde del Camino,Huelva,138,112,26
2018,22048,Barbastro,Huesca,222,259,-37
2018,22112,Fraga,Huesca,309,371,-62
2018,22125,Huesca,Huesca,1014,938,76
2018,22130,Jaca,Huesca,467,419,48
2018,22158,Monzón,Huesca,343,310,33
2018,23002,Alcalá la Real,Jaén,248,351,-103
2018,23003,Alcaudete,Jaén,107,125,-18
2018,23005,Andújar,Jaén,353,612,-259
2018,23009,Baeza,Jaén,158,224,-66
2018,23010,Bailén,Jaén,136,272,-136
2018,23024,La Carolina,Jaén,212,239,-27
2018,23050,Jaén,Jaén,1106,1672,-566
2018,23053,Jódar,Jaén,86,153,-67
2018,23055,Linares,Jaén,644,1050,-406
2018,23058,Mancha Real,Jaén,79,143,-64
2018,23060,Martos,Jaén,190,186,4
2018,23086,Torredelcampo,Jaén,84,125,-41
2018,23087,Torredonjimeno,Jaén,126,149,-23
2018,23092,Úbeda,Jaén,356,589,-233
2018,23095,Villacarrillo,Jaén,99,161,-62
2018,24008,Astorga,León,133,178,-45
2018,24010,La Bañeza,León,191,164,27
2018,24089,León,León,1882,2158,-276
2018,24115,Ponferrada,León,816,1142,-326
2018,24142,San Andrés del Rabanedo,León,336,487,-151
2018,24222,Villaquilambre,León,225,243,-18
2018,25040,Balaguer,Lleida,291,253,38
2018,25120,Lleida,Lleida,2286,2332,-46
2018,25137,Mollerussa,Lleida,206,272,-66
2018,25203,La Seu d'Urgell,Lleida,355,357,-2
2018,25217,Tàrrega,Lleida,290,255,35
2018,26018,Arnedo,La Rioja,130,150,-20
2018,26036,Calahorra,La Rioja,435,452,-17
2018,26071,Haro,La Rioja,284,246,38
2018,26084,Lardero,La Rioja,192,184,8
2018,26089,Logroño,La Rioja,2173,2109,64
2018,27019,Foz,Lugo,162,192,-30
2018,27028,Lugo,Lugo,1356,1522,-166
2018,27031,Monforte de Lemos,Lugo,363,463,-100
2018,27057,Sarria,Lugo,154,192,-38
2018,27065,Vilalba,Lugo,120,199,-79
2018,27066,Viveiro,Lugo,262,293,-31
2018,28005,Alcalá de Henares,Madrid,2904,3088,-184
2018,28006,Alcobendas,Madrid,1309,1270,39
2018,28007,Alcorcón,Madrid,1488,1737,-249
2018,28009,Algete,Madrid,226,339,-113
2018,28010,Alpedrete,Madrid,167,148,19
2018,28013,Aranjuez,Madrid,1209,1399,-190
2018,28014,Arganda del Rey,Madrid,545,589,-44
2018,28015,Arroyomolinos (Madrid),Madrid,323,335,-12
2018,28022,Boadilla del Monte,Madrid,469,403,66
2018,28026,Brunete,Madrid,124,115,9
2018,28040,Ciempozuelos,Madrid,358,331,27
2018,28045,Colmenar Viejo,Madrid,673,598,75
2018,28047,Collado Villalba,Madrid,667,743,-76
2018,28049,Coslada,Madrid,682,789,-107
2018,28053,Daganzo de Arriba,Madrid,86,103,-17
2018,28054,El Escorial,Madrid,172,180,-8
2018,28058,Fuenlabrada,Madrid,2028,2787,-759
2018,28061,Galapagar,Madrid,348,469,-121
2018,28065,Getafe,Madrid,1923,2236,-313
2018,28066,Griñón,Madrid,150,227,-77
2018,28068,Guadarrama,Madrid,181,166,15
2018,28073,Humanes de Madrid,Madrid,275,372,-97
2018,28074,Leganés,Madrid,1935,2175,-240
2018,28079,Madrid,Madrid,52638,46019,6619
2018,28080,Majadahonda,Madrid,732,736,-4
2018,28083,Meco,Madrid,227,265,-38
2018,28084,Mejorada del Campo,Madrid,257,269,-12
2018,28090,Moralzarzal,Madrid,102,95,7
2018,28092,Móstoles,Madrid,2410,2637,-227
2018,28096,Navalcarnero,Madrid,488,390,98
2018,28104,Paracuellos de Jarama,Madrid,342,360,-18
2018,28106,Parla,Madrid,1786,2226,-440
2018,28113,Pinto,Madrid,647,817,-170
2018,28115,Pozuelo de Alarcón,Madrid,882,788,94
2018,28123,Rivas-Vaciamadrid,Madrid,671,690,-19
2018,28127,Las Rozas de Madrid,Madrid,978,1023,-45
2018,28129,San Agustín del Guadalix,Madrid,132,148,-16
2018,28130,San Fernando de Henares,Madrid,275,381,-106
2018,28131,San Lorenzo de El Escorial,Madrid,244,254,-10
2018,28132,San Martín de la Vega,Madrid,276,277,-1
2018,28134,San Sebastián de los Reyes,Madrid,1038,1152,-114
2018,28148,Torrejón de Ardoz,Madrid,1643,1675,-32
2018,28152,Torrelodones,Madrid,225,229,-4
2018,28160,Valdemorillo,Madrid,115,145,-30
2018,28161,Valdemoro,Madrid,1202,1284,-82
2018,28167,Velilla de San Antonio,Madrid,88,129,-41
2018,28172,Villalbilla,Madrid,122,124,-2
2018,28176,Villanueva de la Cañada,Madrid,273,233,40
2018,28177,Villanueva del Pardillo,Madrid,177,178,-1
2018,28181,Villaviciosa de Odón,Madrid,255,289,-34
2018,28903,Tres Cantos,Madrid,585,509,76
2018,29007,Alhaurín de la Torre,Málaga,352,257,95
2018,29008,Alhaurín el Grande,Málaga,210,197,13
2018,29012,Álora,Málaga,111,107,4
2018,29015,Antequera,Málaga,427,377,50
2018,29025,Benalmádena,Málaga,1278,1092,186
2018,29038,Cártama,Málaga,259,200,59
2018,29042,Coín,Málaga,212,195,17
2018,29051,Estepona,Málaga,1341,1038,303
2018,29054,Fuengirola,Málaga,1277,1187,90
2018,29067,Málaga,Málaga,7312,5993,1319
2018,29068,Manilva,Málaga,557,405,152
2018,29069,Marbella,Málaga,2235,2154,81
2018,29070,Mijas,Málaga,1250,1058,192
2018,29075,Nerja,Málaga,221,203,18
2018,29082,Rincón de la Victoria,Málaga,729,501,228
2018,29084,Ronda,Málaga,451,512,-61
2018,29091,Torrox,Málaga,360,291,69
2018,29094,Vélez-Málaga,Málaga,1119,857,262
2018,29901,Torremolinos,Málaga,1386,1110,276
2018,30002,Abarán,Murcia,87,110,-23
2018,30003,Águilas,Murcia,547,486,61
2018,30005,Alcantarilla,Murcia,411,414,-3
2018,30008,Alhama de Murcia,Murcia,229,216,13
2018,30009,Archena,Murcia,308,305,3
2018,30010,Beniel,Murcia,172,216,-44
2018,30012,Bullas,Murcia,68,78,-10
2018,30013,Calasparra,Murcia,120,116,4
2018,30015,Caravaca de la Cruz,Murcia,251,239,12
2018,30016,Cartagena,Murcia,2449,2571,-122
2018,30017,Cehegín,Murcia,130,104,26
2018,30018,Ceutí,Murcia,133,102,31
2018,30019,Cieza (Murcia),Murcia,231,262,-31
2018,30020,Fortuna,Murcia,142,161,-19
2018,30021,Fuente Álamo de Murcia,Murcia,205,183,22
2018,30022,Jumilla,Murcia,328,355,-27
2018,30024,Lorca,Murcia,1055,1204,-149
2018,30026,Mazarrón,Murcia,405,456,-51
2018,30027,Molina de Segura,Murcia,846,932,-86
2018,30029,Mula,Murcia,156,177,-21
2018,30030,Murcia,Murcia,4862,4783,79
2018,30033,Puerto Lumbreras,Murcia,219,223,-4
2018,30035,San Javier,Murcia,812,718,94
2018,30036,San Pedro del Pinatar,Murcia,580,576,4
2018,30037,Torre-Pacheco,Murcia,438,564,-126
2018,30038,Las Torres de Cotillas,Murcia,119,157,-38
2018,30039,Totana,Murcia,353,344,9
2018,30041,La Unión,Murcia,180,205,-25
2018,30043,Yecla,Murcia,457,418,39
2018,30901,Santomera,Murcia,173,182,-9
2018,30902,Los Alcázares,Murcia,427,396,31
2018,31016,Ansoáin/Antsoain,Navarra,90,73,17
2018,31023,Aranguren,Navarra,112,92,20
2018,31060,Burlada/Burlata,Navarra,168,160,8
2018,31086,Valle de Egüés,Navarra,146,148,-2
2018,31097,Estella-Lizarra,Navarra,154,166,-12
2018,31201,Pamplona/Iruña,Navarra,2743,2559,184
2018,31227,Tafalla,Navarra,98,76,22
2018,31232,Tudela,Navarra,803,672,131
2018,31258,Villava/Atarrabia,Navarra,72,70,2
2018,31901,Barañain,Navarra,237,223,14
2018,31903,Berriozar,Navarra,113,81,32
2018,31907,Zizur Mayor/Zizur Nagusia,Navarra,101,123,-22
2018,32008,Barbadás,Ourense,139,143,-4
2018,32009,O Barco de Valdeorras,Ourense,232,256,-24
2018,32019,O Carballiño,Ourense,191,222,-31
2018,32054,Ourense,Ourense,1566,1871,-305
2018,32085,Verín,Ourense,247,262,-15
2018,33002,Aller,Asturias,73,52,21
2018,33004,Avilés,Asturias,563,691,-128
2018,33011,Cangas del Narcea,Asturias,67,128,-61
2018,33014,Carreño,Asturias,89,92,-3
2018,33016,Castrillón,Asturias,147,175,-28
2018,33020,Corvera de Asturias,Asturias,70,108,-38
2018,33024,Gijón,Asturias,2812,2744,68
2018,33025,Gozón,Asturias,88,83,5
2018,33031,Langreo,Asturias,232,283,-51
2018,33032,Laviana,Asturias,78,70,8
2018,33033,Lena,Asturias,52,71,-19
2018,33034,Valdés,Asturias,81,90,-9
2018,33035,Llanera,Asturias,109,99,10
2018,33036,Llanes,Asturias,167,175,-8
2018,33037,Mieres (Asturias),Asturias,259,273,-14
2018,33044,Oviedo,Asturias,2376,2771,-395
2018,33060,San Martín del Rey Aurelio,Asturias,90,106,-16
2018,33066,Siero,Asturias,385,430,-45
2018,33076,Villaviciosa,Asturias,151,111,40
2018,34120,Palencia,Palencia,1002,1291,-289
2018,35002,Agüimes,Las Palmas,327,277,50
2018,35003,Antigua,Las Palmas,316,303,13
2018,35004,Arrecife,Las Palmas,1599,1417,182
2018,35006,Arucas,Las Palmas,248,202,46
2018,35009,Gáldar,Las Palmas,131,127,4
2018,35011,Ingenio,Las Palmas,269,232,37
2018,35012,Mogán,Las Palmas,247,248,-1
2018,35014,La Oliva,Las Palmas,746,703,43
2018,35015,Pájara,Las Palmas,760,643,117
2018,35016,Las Palmas de Gran Canaria,Las Palmas,4919,4506,413
2018,35017,Puerto del Rosario,Las Palmas,1140,862,278
2018,35018,San Bartolomé,Las Palmas,443,387,56
2018,35019,San Bartolomé de Tirajana,Las Palmas,610,643,-33
2018,35021,Santa Brígida,Las Palmas,150,124,26
2018,35022,Santa Lucía de Tirajana,Las Palmas,836,854,-18
2018,35023,Santa María de Guía de Gran Canaria,Las Palmas,67,51,16
2018,35024,Teguise,Las Palmas,458,329,129
2018,35026,Telde,Las Palmas,925,792,133
2018,35027,Teror,Las Palmas,68,52,16
2018,35028,Tías,Las Palmas,442,416,26
2018,35030,Tuineje,Las Palmas,382,328,54
2018,35034,Yaiza,Las Palmas,787,639,148
2018,36003,Baiona,Pontevedra,105,104,1
2018,36004,Bueu,Pontevedra,68,96,-28
2018,36006,Cambados,Pontevedra,86,136,-50
2018,36008,Cangas,Pontevedra,220,213,7
2018,36017,A Estrada,Pontevedra,187,311,-124
2018,36021,Gondomar,Pontevedra,83,66,17
2018,36022,O Grove,Pontevedra,79,92,-13
2018,36023,A Guarda,Pontevedra,99,113,-14
2018,36024,Lalín,Pontevedra,287,320,-33
2018,36026,Marín,Pontevedra,352,272,80
2018,36029,Moaña,Pontevedra,110,143,-33
2018,36033,Mos,Pontevedra,102,93,9
2018,36035,Nigrán,Pontevedra,184,135,49
2018,36038,Pontevedra,Pontevedra,1121,1146,-25
2018,36039,O Porriño,Pontevedra,176,214,-38
2018,36041,Poio,Pontevedra,186,171,15
2018,36042,Ponteareas,Pontevedra,202,229,-27
2018,36045,Redondela,Pontevedra,218,185,33
2018,36051,Sanxenxo,Pontevedra,212,175,37
2018,36054,Tomiño,Pontevedra,116,96,20
2018,36055,Tui,Pontevedra,137,161,-24
2018,36057,Vigo,Pontevedra,3638,3306,332
2018,36060,Vilagarcía de Arousa,Pontevedra,501,520,-19
2018,36061,Vilanova de Arousa,Pontevedra,115,113,2
2018,37046,Béjar,Salamanca,179,263,-84
2018,37107,Ciudad Rodrigo,Salamanca,127,202,-75
2018,37274,Salamanca,Salamanca,2457,2714,-257
2018,37294,Santa Marta de Tormes,Salamanca,206,270,-64
2018,38001,Adeje,Santa Cruz de Tenerife,928,1022,-94
2018,38006,Arona,Santa Cruz de Tenerife,1416,1655,-239
2018,38011,Candelaria,Santa Cruz de Tenerife,399,379,20
2018,38017,Granadilla de Abona,Santa Cruz de Tenerife,989,993,-4
2018,38019,Guía de Isora,Santa Cruz de Tenerife,319,296,23
2018,38020,Güímar,Santa Cruz de Tenerife,203,183,20
2018,38022,Icod de los Vinos,Santa Cruz de Tenerife,163,166,-3
2018,38023,San Cristóbal de La Laguna,Santa Cruz de Tenerife,1820,1580,240
2018,38024,Los Llanos de Aridane,Santa Cruz de Tenerife,240,228,12
2018,38026,La Orotava,Santa Cruz de Tenerife,285,291,-6
2018,38028,Puerto de la Cruz,Santa Cruz de Tenerife,522,491,31
2018,38031,Los Realejos,Santa Cruz de Tenerife,166,171,-5
2018,38032,El Rosario,Santa Cruz de Tenerife,196,213,-17
2018,38035,San Miguel de Abona,Santa Cruz de Tenerife,301,280,21
2018,38037,Santa Cruz de la Palma,Santa Cruz de Tenerife,242,254,-12
2018,38038,Santa Cruz de Tenerife,Santa Cruz de Tenerife,2880,2476,404
2018,38039,Santa Úrsula,Santa Cruz de Tenerife,157,147,10
2018,38040,Santiago del Teide,Santa Cruz de Tenerife,174,175,-1
2018,38043,Tacoronte,Santa Cruz de Tenerife,166,141,25
2018,38046,Tegueste,Santa Cruz de Tenerife,72,72,0
2018,39008,El Astillero,Cantabria,152,164,-12
2018,39016,Camargo,Cantabria,243,297,-54
2018,39020,Castro-Urdiales,Cantabria,1436,1350,86
2018,39025,Los Corrales de Buelna,Cantabria,77,72,5
2018,39035,Laredo,Cantabria,153,190,-37
2018,39052,Piélagos,Cantabria,251,266,-15
2018,39073,Santa Cruz de Bezana,Cantabria,143,123,20
2018,39075,Santander,Cantabria,2286,2301,-15
2018,39079,Santoña,Cantabria,165,149,16
2018,39087,Torrelavega,Cantabria,490,488,2
2018,40194,Segovia,Segovia,876,1193,-317
2018,41004,Alcalá de Guadaíra,Sevilla,589,795,-206
2018,41005,Alcalá del Río,Sevilla,88,102,-14
2018,41007,La Algaba,Sevilla,136,110,26
2018,41011,Arahal,Sevilla,99,117,-18
2018,41016,Bollullos de la Mitación,Sevilla,106,89,17
2018,41017,Bormujos,Sevilla,218,234,-16
2018,41018,Brenes,Sevilla,79,128,-49
2018,41020,Las Cabezas de San Juan,Sevilla,149,129,20
2018,41021,Camas,Sevilla,257,305,-48
2018,41023,Cantillana,Sevilla,90,88,2
2018,41024,Carmona,Sevilla,171,236,-65
2018,41029,Castilleja de la Cuesta,Sevilla,147,152,-5
2018,41034,Coria del Río,Sevilla,299,296,3
2018,41038,Dos Hermanas,Sevilla,1186,1244,-58
2018,41039,Écija,Sevilla,328,435,-107
2018,41040,Espartinas,Sevilla,192,219,-27
2018,41041,Estepa,Sevilla,144,154,-10
2018,41044,Gelves,Sevilla,91,87,4
2018,41047,Gines,Sevilla,114,152,-38
2018,41049,Guillena,Sevilla,130,98,32
2018,41053,Lebrija,Sevilla,263,264,-1
2018,41055,Lora del Río,Sevilla,97,177,-80
2018,41058,Mairena del Alcor,Sevilla,178,193,-15
2018,41059,Mairena del Aljarafe,Sevilla,590,638,-48
2018,41060,Marchena,Sevilla,100,156,-56
2018,41065,Morón de la Frontera,Sevilla,258,345,-87
2018,41068,Osuna,Sevilla,128,166,-38
2018,41069,Los Palacios y Villafranca,Sevilla,202,228,-26
2018,41075,Pilas,Sevilla,135,148,-13
2018,41077,La Puebla de Cazalla,Sevilla,116,169,-53
2018,41079,La Puebla del Río,Sevilla,117,82,35
2018,41081,La Rinconada,Sevilla,202,298,-96
2018,41086,San Juan de Aznalfarache,Sevilla,279,287,-8
2018,41087,Sanlúcar la Mayor,Sevilla,121,147,-26
2018,41091,Sevilla,Sevilla,7713,7949,-236
2018,41093,Tomares,Sevilla,303,300,3
2018,41095,Utrera,Sevilla,459,472,-13
2018,41102,El Viso del Alcor,Sevilla,89,104,-15
2018,42173,Soria,Soria,723,817,-94
2018,43014,Amposta,Tarragona,305,307,-2
2018,43037,Calafell,Tarragona,1737,1125,612
2018,43038,Cambrils,Tarragona,741,669,72
2018,43051,Cunit,Tarragona,1101,633,468
2018,43092,Mont-roig del Camp,Tarragona,357,268,89
2018,43123,Reus,Tarragona,1235,1101,134
2018,43136,Sant Carles de la Ràpita,Tarragona,348,255,93
2018,43148,Tarragona,Tarragona,2261,2307,-46
2018,43153,Torredembarra,Tarragona,481,426,55
2018,43155,Tortosa,Tarragona,506,493,13
2018,43161,Valls,Tarragona,323,280,43
2018,43163,El Vendrell,Tarragona,1391,1051,340
2018,43171,Vila-seca,Tarragona,338,360,-22
2018,43901,Deltebre,Tarragona,123,155,-32
2018,43905,Salou,Tarragona,696,683,13
2018,44013,Alcañiz,Teruel,294,348,-54
2018,44216,Teruel,Teruel,714,693,21
2018,45019,Bargas,Toledo,227,175,52
2018,45053,Consuegra,Toledo,80,151,-71
2018,45066,Fuensalida,Toledo,410,259,151
2018,45081,Illescas,Toledo,1503,954,549
2018,45087,Madridejos,Toledo,117,151,-34
2018,45121,Ocaña,Toledo,882,554,328
2018,45142,Quintanar de la Orden,Toledo,196,229,-33
2018,45161,Seseña,Toledo,2662,1786,876
2018,45163,Sonseca,Toledo,150,158,-8
2018,45165,Talavera de la Reina,Toledo,1884,1923,-39
2018,45168,Toledo,Toledo,1805,2088,-283
2018,45173,Torrijos,Toledo,300,280,20
2018,45205,Yuncos,Toledo,544,430,114
2018,46005,Alaquàs,Valencia,243,210,33
2018,46007,Albal,Valencia,132,114,18
2018,46011,Alberic,Valencia,76,89,-13
2018,46013,Alboraya,Valencia,272,254,18
2018,46017,Alzira,Valencia,411,351,60
2018,46019,L'Alcúdia,Valencia,57,79,-22
2018,46021,Aldaia,Valencia,318,241,77
2018,46022,Alfafar,Valencia,237,199,38
2018,46029,Algemesí,Valencia,219,199,20
2018,46031,Alginet,Valencia,117,88,29
2018,46051,Benaguasil,Valencia,84,62,22
2018,46054,Benetússer,Valencia,122,131,-9
2018,46060,Benifaió,Valencia,114,107,7
2018,46070,Bétera,Valencia,320,288,32
2018,46078,Burjassot,Valencia,389,344,45
2018,46081,Canals,Valencia,95,83,12
2018,46083,Carcaixent,Valencia,137,142,-5
2018,46085,Carlet,Valencia,117,87,30
2018,46094,Catarroja,Valencia,248,210,38
2018,46102,Quart de Poblet,Valencia,188,153,35
2018,46105,Cullera,Valencia,317,241,76
2018,46110,Xirivella,Valencia,318,252,66
2018,46111,Chiva,Valencia,169,126,43
2018,46116,L'Eliana,Valencia,191,190,1
2018,46131,Gandia,Valencia,1314,1150,164
2018,46135,Godella,Valencia,183,102,81
2018,46145,Xátiva,Valencia,267,274,-7
2018,46147,Llíria,Valencia,231,260,-29
2018,46159,Manises,Valencia,296,237,59
2018,46164,Massamagrell,Valencia,147,135,12
2018,46166,Meliana,Valencia,94,57,37
2018,46169,Mislata,Valencia,483,380,103
2018,46171,Moncada,Valencia,157,144,13
2018,46181,Oliva,Valencia,341,302,39
2018,46184,Ontinyent,Valencia,323,310,13
2018,46186,Paiporta,Valencia,182,179,3
2018,46190,Paterna,Valencia,873,689,184
2018,46193,Picanya,Valencia,94,83,11
2018,46194,Picassent,Valencia,189,176,13
2018,46202,La Pobla de Vallbona,Valencia,232,212,20
2018,46205,Puçol,Valencia,188,217,-29
2018,46213,Requena,Valencia,225,194,31
2018,46214,Riba-roja de Túria,Valencia,198,173,25
2018,46220,Sagunto/Sagunt,Valencia,1114,844,270
2018,46223,Sedaví,Valencia,107,72,35
2018,46230,Silla,Valencia,180,132,48
2018,46235,Sueca,Valencia,191,176,15
2018,46238,Tavernes de la Valldigna,Valencia,167,140,27
2018,46244,Torrent (Valencia),Valencia,764,653,111
2018,46249,Utiel,Valencia,124,104,20
2018,46250,València,Valencia,9714,9376,338
2018,47010,Arroyo de la Encomienda,Valladolid,360,264,96
2018,47076,Laguna de Duero,Valladolid,247,264,-17
2018,47085,Medina del Campo,Valladolid,277,285,-8
2018,47186,Valladolid,Valladolid,4465,4246,219
2018,48003,Amorebieta-Etxano,Vizcaya,155,131,24
2018,48011,Arrigorriaga,Vizcaya,78,124,-46
2018,48013,Barakaldo,Vizcaya,986,1077,-91
2018,48015,Basauri,Vizcaya,332,374,-42
2018,48017,Bermeo,Vizcaya,134,102,32
2018,48020,Bilbao,Vizcaya,4745,4248,497
2018,48027,Durango,Vizcaya,267,274,-7
2018,48029,Etxebarri,Vizcaya,68,74,-6
2018,48034,Ermua,Vizcaya,226,276,-50
2018,48036,Galdakao,Vizcaya,197,212,-15
2018,48044,Getxo,Vizcaya,697,865,-168
2018,48046,Gernika-Lumo,Vizcaya,112,94,18
2018,48054,Leioa,Vizcaya,257,275,-18
2018,48069,Mungia,Vizcaya,170,169,1
2018,48078,Portugalete,Vizcaya,375,373,2
2018,48080,Valle de Trápaga-Trapagaran,Vizcaya,89,97,-8
2018,48082,Santurtzi,Vizcaya,428,423,5
2018,48084,Sestao,Vizcaya,258,277,-19
2018,48085,Sopela,Vizcaya,104,111,-7
2018,48902,Erandio,Vizcaya,179,191,-12
2018,49021,Benavente,Zamora,290,406,-116
2018,49275,Zamora,Zamora,795,1088,-293
2018,50067,Calatayud,Zaragoza,715,649,66
2018,50089,Cuarte de Huerva,Zaragoza,215,234,-19
2018,50095,Ejea de los Caballeros,Zaragoza,228,171,57
2018,50251,Tarazona,Zaragoza,165,158,7
2018,50272,Utebo,Zaragoza,221,168,53
2018,50297,Zaragoza,Zaragoza,9136,8287,849
2018,51001,Ceuta,Ceuta,2016,2732,-716
2018,52001,Melilla,Melilla,2771,3463,-692
