ano,idprov,province,inmigrations,emigrations,net_migration
1988,01,Álava,2856,2551,305
1988,02,Albacete,2613,3836,-1223
1988,03,Alicante,11662,6919,4743
1988,04,Almería,4639,3725,914
1988,05,Ávila,1608,2281,-673
1988,06,Badajoz,4170,7470,-3300
1988,07,Baleares,15272,5906,9366
1988,08,Barcelona,20677,25813,-5136
1988,09,Burgos,2497,3679,-1182
1988,10,Cáceres,3624,5625,-2001
1988,11,Cádiz,6332,8127,-1795
1988,12,Castellón,3986,2157,1829
1988,13,Ciudad Real,3664,5260,-1596
1988,14,Córdoba,4901,6958,-2057
1988,15,A Coruña,5046,6149,-1103
1988,16,Cuenca,1622,2899,-1277
1988,17,Girona,8290,4181,4109
1988,18,Granada,7105,8226,-1121
1988,19,Guadalajara,1932,2334,-402
1988,20,Guipúzcoa,2537,7182,-4645
1988,21,Huelva,3038,2674,364
1988,22,Huesca,1801,1869,-68
1988,23,Jaén,4107,7642,-3535
1988,24,León,3141,5230,-2089
1988,25,Lleida,2821,2853,-32
1988,26,La Rioja,2703,2195,508
1988,27,Lugo,1933,2284,-351
1988,28,Madrid,37311,29651,7660
1988,29,Málaga,9349,5730,3619
1988,30,Murcia,6548,5672,876
1988,31,Navarra,3686,3250,436
1988,32,Ourense,1573,2759,-1186
1988,33,Asturias,3701,4994,-1293
1988,34,Palencia,1690,2209,-519
1988,35,Las Palmas,12291,5475,6816
1988,36,Pontevedra,3866,5059,-1193
1988,37,Salamanca,2803,3908,-1105
1988,38,Santa Cruz de Tenerife,6856,3693,3163
1988,39,Cantabria,2595,2862,-267
1988,40,Segovia,1347,1491,-144
1988,41,Sevilla,9272,8335,937
1988,42,Soria,841,1238,-397
1988,43,Tarragona,7480,5046,2434
1988,44,Teruel,1153,2106,-953
1988,45,Toledo,4290,4776,-486
1988,46,Valencia,10237,10993,-756
1988,47,Valladolid,4777,4523,254
1988,48,Vizcaya,4521,11203,-6682
1988,49,Zamora,1498,2358,-860
1988,50,Zaragoza,6052,4881,1171
1988,51,Ceuta,1080,1092,-12
1988,52,Melilla,984,1049,-65
1989,01,Álava,3313,2554,759
1989,02,Albacete,3017,4316,-1299
1989,03,Alicante,13351,8697,4654
1989,04,Almería,5225,4143,1082
1989,05,Ávila,1751,3107,-1356
1989,06,Badajoz,4847,8684,-3837
1989,07,Baleares,15351,8142,7209
1989,08,Barcelona,22503,28220,-5717
1989,09,Burgos,3022,4131,-1109
1989,10,Cáceres,4066,6645,-2579
1989,11,Cádiz,7083,9077,-1994
1989,12,Castellón,4357,2520,1837
1989,13,Ciudad Real,3422,6140,-2718
1989,14,Córdoba,5186,7662,-2476
1989,15,A Coruña,6372,6298,74
1989,16,Cuenca,1876,3460,-1584
1989,17,Girona,9530,4613,4917
1989,18,Granada,8414,8811,-397
1989,19,Guadalajara,2371,2313,58
1989,20,Guipúzcoa,3241,7184,-3943
1989,21,Huelva,3062,3005,57
1989,22,Huesca,2112,2081,31
1989,23,Jaén,5309,9576,-4267
1989,24,León,3434,5912,-2478
1989,25,Lleida,3198,2786,412
1989,26,La Rioja,2455,2533,-78
1989,27,Lugo,2345,2896,-551
1989,28,Madrid,42893,34207,8686
1989,29,Málaga,11015,6150,4865
1989,30,Murcia,8568,6395,2173
1989,31,Navarra,4304,3632,672
1989,32,Ourense,1939,3303,-1364
1989,33,Asturias,4882,5692,-810
1989,34,Palencia,1629,2385,-756
1989,35,Las Palmas,11684,7680,4004
1989,36,Pontevedra,4410,5453,-1043
1989,37,Salamanca,3458,4161,-703
1989,38,Santa Cruz de Tenerife,6988,4829,2159
1989,39,Cantabria,3487,3352,135
1989,40,Segovia,1496,2158,-662
1989,41,Sevilla,11398,9165,2233
1989,42,Soria,900,1352,-452
1989,43,Tarragona,7633,4996,2637
1989,44,Teruel,1341,2012,-671
1989,45,Toledo,5448,5268,180
1989,46,Valencia,13033,11052,1981
1989,47,Valladolid,4438,5035,-597
1989,48,Vizcaya,5489,11918,-6429
1989,49,Zamora,1751,2910,-1159
1989,50,Zaragoza,5974,5077,897
1989,51,Ceuta,992,1243,-251
1989,52,Melilla,724,1156,-432
1990,01,Álava,3079,2599,480
1990,02,Albacete,3728,3717,11
1990,03,Alicante,12779,9086,3693
1990,04,Almería,5235,4060,1175
1990,05,Ávila,1882,3131,-1249
1990,06,Badajoz,5749,7881,-2132
1990,07,Baleares,11272,10036,1236
1990,08,Barcelona,23850,28513,-4663
1990,09,Burgos,3111,4150,-1039
1990,10,Cáceres,4185,6580,-2395
1990,11,Cádiz,7562,9234,-1672
1990,12,Castellón,4644,2958,1686
1990,13,Ciudad Real,3890,5943,-2053
1990,14,Córdoba,5526,7278,-1752
1990,15,A Coruña,6316,5984,332
1990,16,Cuenca,1902,2999,-1097
1990,17,Girona,8532,5112,3420
1990,18,Granada,8651,8779,-128
1990,19,Guadalajara,2896,2277,619
1990,20,Guipúzcoa,3572,6091,-2519
1990,21,Huelva,3330,3155,175
1990,22,Huesca,2318,2218,100
1990,23,Jaén,5478,8591,-3113
1990,24,León,3494,5809,-2315
1990,25,Lleida,3551,2991,560
1990,26,La Rioja,2870,2333,537
1990,27,Lugo,2392,2838,-446
1990,28,Madrid,44877,35978,8899
1990,29,Málaga,11015,6988,4027
1990,30,Murcia,8204,7027,1177
1990,31,Navarra,4433,3590,843
1990,32,Ourense,2171,3785,-1614
1990,33,Asturias,4981,5532,-551
1990,34,Palencia,1785,2565,-780
1990,35,Las Palmas,7942,9883,-1941
1990,36,Pontevedra,5583,5063,520
1990,37,Salamanca,3394,4291,-897
1990,38,Santa Cruz de Tenerife,5633,5220,413
1990,39,Cantabria,3265,3213,52
1990,40,Segovia,1594,1980,-386
1990,41,Sevilla,11565,8635,2930
1990,42,Soria,954,1365,-411
1990,43,Tarragona,7747,4809,2938
1990,44,Teruel,1515,2185,-670
1990,45,Toledo,6143,5333,810
1990,46,Valencia,12984,10726,2258
1990,47,Valladolid,4428,4941,-513
1990,48,Vizcaya,6048,10562,-4514
1990,49,Zamora,1817,2945,-1128
1990,50,Zaragoza,6400,5262,1138
1990,51,Ceuta,1030,1148,-118
1990,52,Melilla,1207,1140,67
1991,01,Álava,2013,1589,424
1991,02,Albacete,2497,2376,121
1991,03,Alicante,6713,6912,-199
1991,04,Almería,2793,2583,210
1991,05,Ávila,991,1466,-475
1991,06,Badajoz,4052,4107,-55
1991,07,Baleares,7555,7061,494
1991,08,Barcelona,13620,20713,-7093
1991,09,Burgos,1743,2521,-778
1991,10,Cáceres,2706,3527,-821
1991,11,Cádiz,5032,6160,-1128
1991,12,Castellón,2732,1787,945
1991,13,Ciudad Real,2849,2908,-59
1991,14,Córdoba,4504,4456,48
1991,15,A Coruña,3742,3142,600
1991,16,Cuenca,1320,1598,-278
1991,17,Girona,4292,3501,791
1991,18,Granada,5934,4736,1198
1991,19,Guadalajara,1874,1208,666
1991,20,Guipúzcoa,1646,3894,-2248
1991,21,Huelva,1734,1845,-111
1991,22,Huesca,1625,1356,269
1991,23,Jaén,4194,4737,-543
1991,24,León,1684,3122,-1438
1991,25,Lleida,2116,1951,165
1991,26,La Rioja,1528,1433,95
1991,27,Lugo,1469,1686,-217
1991,28,Madrid,21220,21504,-284
1991,29,Málaga,6887,5096,1791
1991,30,Murcia,5947,4334,1613
1991,31,Navarra,2840,1939,901
1991,32,Ourense,1215,1699,-484
1991,33,Asturias,2942,2883,59
1991,34,Palencia,975,1413,-438
1991,35,Las Palmas,5901,5594,307
1991,36,Pontevedra,2620,2685,-65
1991,37,Salamanca,2430,2495,-65
1991,38,Santa Cruz de Tenerife,3985,3454,531
1991,39,Cantabria,1986,1824,162
1991,40,Segovia,920,1139,-219
1991,41,Sevilla,7802,5321,2481
1991,42,Soria,605,696,-91
1991,43,Tarragona,5737,2979,2758
1991,44,Teruel,991,1447,-456
1991,45,Toledo,3957,2733,1224
1991,46,Valencia,8335,6410,1925
1991,47,Valladolid,2914,2575,339
1991,48,Vizcaya,3377,6312,-2935
1991,49,Zamora,955,1401,-446
1991,50,Zaragoza,3979,3349,630
1991,51,Ceuta,1039,981,58
1991,52,Melilla,1026,905,121
1992,01,Álava,2661,2302,359
1992,02,Albacete,3427,2824,603
1992,03,Alicante,9544,9161,383
1992,04,Almería,4224,3740,484
1992,05,Ávila,1476,2170,-694
1992,06,Badajoz,5541,5597,-56
1992,07,Baleares,9373,8755,618
1992,08,Barcelona,18205,28217,-10012
1992,09,Burgos,2725,3289,-564
1992,10,Cáceres,4079,4462,-383
1992,11,Cádiz,6155,7452,-1297
1992,12,Castellón,3723,2710,1013
1992,13,Ciudad Real,3795,4010,-215
1992,14,Córdoba,5066,5632,-566
1992,15,A Coruña,5562,4224,1338
1992,16,Cuenca,1677,2444,-767
1992,17,Girona,6404,5434,970
1992,18,Granada,6889,6282,607
1992,19,Guadalajara,3201,1668,1533
1992,20,Guipúzcoa,2908,5073,-2165
1992,21,Huelva,2024,2337,-313
1992,22,Huesca,2059,2029,30
1992,23,Jaén,5406,5570,-164
1992,24,León,3148,4819,-1671
1992,25,Lleida,3257,2776,481
1992,26,La Rioja,1999,2296,-297
1992,27,Lugo,1961,2252,-291
1992,28,Madrid,31555,32384,-829
1992,29,Málaga,7798,7044,754
1992,30,Murcia,7511,5714,1797
1992,31,Navarra,4131,3116,1015
1992,32,Ourense,1784,2406,-622
1992,33,Asturias,4433,4551,-118
1992,34,Palencia,1362,1943,-581
1992,35,Las Palmas,6590,5774,816
1992,36,Pontevedra,4006,3824,182
1992,37,Salamanca,2784,3066,-282
1992,38,Santa Cruz de Tenerife,5558,3718,1840
1992,39,Cantabria,2889,2760,129
1992,40,Segovia,1254,1658,-404
1992,41,Sevilla,9452,6516,2936
1992,42,Soria,1062,970,92
1992,43,Tarragona,8202,4166,4036
1992,44,Teruel,1338,1761,-423
1992,45,Toledo,6059,4097,1962
1992,46,Valencia,10688,8696,1992
1992,47,Valladolid,3521,3710,-189
1992,48,Vizcaya,4913,9014,-4101
1992,49,Zamora,1376,1913,-537
1992,50,Zaragoza,5574,4609,965
1992,51,Ceuta,1295,931,364
1992,52,Melilla,1290,1048,242
1993,01,Álava,3144,2450,694
1993,02,Albacete,3316,3125,191
1993,03,Alicante,11000,8868,2132
1993,04,Almería,4991,3885,1106
1993,05,Ávila,1984,2328,-344
1993,06,Badajoz,5959,5420,539
1993,07,Baleares,7660,8039,-379
1993,08,Barcelona,19609,31849,-12240
1993,09,Burgos,3069,3606,-537
1993,10,Cáceres,4785,4299,486
1993,11,Cádiz,6823,8034,-1211
1993,12,Castellón,4001,2796,1205
1993,13,Ciudad Real,3982,4195,-213
1993,14,Córdoba,5482,5292,190
1993,15,A Coruña,6085,4518,1567
1993,16,Cuenca,2104,2559,-455
1993,17,Girona,6856,5505,1351
1993,18,Granada,7680,6612,1068
1993,19,Guadalajara,3565,1846,1719
1993,20,Guipúzcoa,3295,5427,-2132
1993,21,Huelva,2305,2782,-477
1993,22,Huesca,2370,2313,57
1993,23,Jaén,5175,6039,-864
1993,24,León,3655,4884,-1229
1993,25,Lleida,3328,3095,233
1993,26,La Rioja,2236,2507,-271
1993,27,Lugo,2303,2226,77
1993,28,Madrid,31828,38190,-6362
1993,29,Málaga,8280,7320,960
1993,30,Murcia,8144,6117,2027
1993,31,Navarra,4370,3388,982
1993,32,Ourense,2138,2463,-325
1993,33,Asturias,4713,4892,-179
1993,34,Palencia,1780,1937,-157
1993,35,Las Palmas,7298,5716,1582
1993,36,Pontevedra,4049,4258,-209
1993,37,Salamanca,3060,3093,-33
1993,38,Santa Cruz de Tenerife,5052,3773,1279
1993,39,Cantabria,3331,2830,501
1993,40,Segovia,1560,1415,145
1993,41,Sevilla,10837,7332,3505
1993,42,Soria,982,1163,-181
1993,43,Tarragona,9031,4591,4440
1993,44,Teruel,1529,1942,-413
1993,45,Toledo,7190,4603,2587
1993,46,Valencia,10646,9552,1094
1993,47,Valladolid,3632,3993,-361
1993,48,Vizcaya,5266,9127,-3861
1993,49,Zamora,1621,2093,-472
1993,50,Zaragoza,5824,4932,892
1993,51,Ceuta,1137,1123,14
1993,52,Melilla,1539,1257,282
1994,01,Álava,3160,2822,338
1994,02,Albacete,3541,3405,136
1994,03,Alicante,13499,8899,4600
1994,04,Almería,5225,4104,1121
1994,05,Ávila,2270,2471,-201
1994,06,Badajoz,5930,5522,408
1994,07,Baleares,8827,6754,2073
1994,08,Barcelona,20262,33577,-13315
1994,09,Burgos,3539,3696,-157
1994,10,Cáceres,5262,4311,951
1994,11,Cádiz,7442,8540,-1098
1994,12,Castellón,4190,2880,1310
1994,13,Ciudad Real,3893,4264,-371
1994,14,Córdoba,5043,5519,-476
1994,15,A Coruña,6378,5733,645
1994,16,Cuenca,2489,2622,-133
1994,17,Girona,7405,5541,1864
1994,18,Granada,7635,7403,232
1994,19,Guadalajara,4432,2056,2376
1994,20,Guipúzcoa,3862,5758,-1896
1994,21,Huelva,2418,2912,-494
1994,22,Huesca,2693,2256,437
1994,23,Jaén,5173,6124,-951
1994,24,León,4401,4611,-210
1994,25,Lleida,3587,3485,102
1994,26,La Rioja,2810,2606,204
1994,27,Lugo,2709,2646,63
1994,28,Madrid,33316,44640,-11324
1994,29,Málaga,9371,7328,2043
1994,30,Murcia,8762,7340,1422
1994,31,Navarra,4976,3459,1517
1994,32,Ourense,2568,2451,117
1994,33,Asturias,4622,5811,-1189
1994,34,Palencia,1865,2137,-272
1994,35,Las Palmas,8909,5645,3264
1994,36,Pontevedra,4616,4689,-73
1994,37,Salamanca,3542,3464,78
1994,38,Santa Cruz de Tenerife,6107,4095,2012
1994,39,Cantabria,4077,3198,879
1994,40,Segovia,1715,1644,71
1994,41,Sevilla,10210,8260,1950
1994,42,Soria,1162,1244,-82
1994,43,Tarragona,9220,5146,4074
1994,44,Teruel,1604,1697,-93
1994,45,Toledo,8446,5118,3328
1994,46,Valencia,10144,10426,-282
1994,47,Valladolid,4200,4409,-209
1994,48,Vizcaya,5577,10418,-4841
1994,49,Zamora,2001,2282,-281
1994,50,Zaragoza,5438,5337,101
1994,51,Ceuta,1167,1167,0
1994,52,Melilla,1676,1444,232
1995,01,Álava,3442,2838,604
1995,02,Albacete,3515,3763,-248
1995,03,Alicante,14857,9369,5488
1995,04,Almería,5810,4170,1640
1995,05,Ávila,2141,2468,-327
1995,06,Badajoz,5956,6009,-53
1995,07,Baleares,11322,6573,4749
1995,08,Barcelona,22000,32439,-10439
1995,09,Burgos,3427,4079,-652
1995,10,Cáceres,4462,4856,-394
1995,11,Cádiz,7453,10296,-2843
1995,12,Castellón,4870,3290,1580
1995,13,Ciudad Real,4347,4671,-324
1995,14,Córdoba,4899,6350,-1451
1995,15,A Coruña,6904,6063,841
1995,16,Cuenca,2356,2622,-266
1995,17,Girona,7703,5375,2328
1995,18,Granada,6957,8130,-1173
1995,19,Guadalajara,5015,2178,2837
1995,20,Guipúzcoa,3980,5590,-1610
1995,21,Huelva,3138,2922,216
1995,22,Huesca,2296,2218,78
1995,23,Jaén,4584,6703,-2119
1995,24,León,4518,4954,-436
1995,25,Lleida,3794,3402,392
1995,26,La Rioja,3012,2831,181
1995,27,Lugo,2536,2650,-114
1995,28,Madrid,35316,45987,-10671
1995,29,Málaga,9973,7735,2238
1995,30,Murcia,8904,8084,820
1995,31,Navarra,4973,3673,1300
1995,32,Ourense,2570,2949,-379
1995,33,Asturias,4846,5886,-1040
1995,34,Palencia,1683,2289,-606
1995,35,Las Palmas,11279,6299,4980
1995,36,Pontevedra,4836,5583,-747
1995,37,Salamanca,3259,3605,-346
1995,38,Santa Cruz de Tenerife,6380,4478,1902
1995,39,Cantabria,4415,3649,766
1995,40,Segovia,1709,1680,29
1995,41,Sevilla,10304,9776,528
1995,42,Soria,1131,1217,-86
1995,43,Tarragona,9478,5227,4251
1995,44,Teruel,1632,1732,-100
1995,45,Toledo,8993,5575,3418
1995,46,Valencia,11241,10869,372
1995,47,Valladolid,4155,4368,-213
1995,48,Vizcaya,5568,10308,-4740
1995,49,Zamora,1876,2307,-431
1995,50,Zaragoza,5892,5580,312
1995,51,Ceuta,994,1389,-395
1995,52,Melilla,1880,1527,353
1996,01,Álava,2475,1885,590
1996,02,Albacete,2241,2649,-408
1996,03,Alicante,9608,7278,2330
1996,04,Almería,3854,3057,797
1996,05,Ávila,1149,1557,-408
1996,06,Badajoz,4679,4351,328
1996,07,Baleares,9295,5342,3953
1996,08,Barcelona,17282,22228,-4946
1996,09,Burgos,2150,2921,-771
1996,10,Cáceres,2723,3047,-324
1996,11,Cádiz,5818,7991,-2173
1996,12,Castellón,3375,2457,918
1996,13,Ciudad Real,2956,3127,-171
1996,14,Córdoba,4315,4388,-73
1996,15,A Coruña,4425,4767,-342
1996,16,Cuenca,1494,1825,-331
1996,17,Girona,5038,4047,991
1996,18,Granada,4922,5648,-726
1996,19,Guadalajara,3524,1570,1954
1996,20,Guipúzcoa,2361,4046,-1685
1996,21,Huelva,1944,2208,-264
1996,22,Huesca,1476,1643,-167
1996,23,Jaén,3051,4917,-1866
1996,24,León,2544,3441,-897
1996,25,Lleida,2610,2335,275
1996,26,La Rioja,2172,1868,304
1996,27,Lugo,1657,1552,105
1996,28,Madrid,22237,30321,-8084
1996,29,Málaga,6493,5662,831
1996,30,Murcia,7226,5994,1232
1996,31,Navarra,3021,2370,651
1996,32,Ourense,1516,1766,-250
1996,33,Asturias,3603,4033,-430
1996,34,Palencia,1208,1483,-275
1996,35,Las Palmas,10812,5605,5207
1996,36,Pontevedra,3073,4262,-1189
1996,37,Salamanca,2439,2505,-66
1996,38,Santa Cruz de Tenerife,5940,3471,2469
1996,39,Cantabria,3022,2697,325
1996,40,Segovia,1034,1162,-128
1996,41,Sevilla,7626,7469,157
1996,42,Soria,807,732,75
1996,43,Tarragona,6575,4031,2544
1996,44,Teruel,1040,1288,-248
1996,45,Toledo,4585,3801,784
1996,46,Valencia,9724,7338,2386
1996,47,Valladolid,2919,3073,-154
1996,48,Vizcaya,4109,7324,-3215
1996,49,Zamora,1342,1504,-162
1996,50,Zaragoza,3825,3757,68
1996,51,Ceuta,978,1182,-204
1996,52,Melilla,1909,1226,683
1997,01,Álava,3455,2863,592
1997,02,Albacete,3009,3377,-368
1997,03,Alicante,15052,9364,5688
1997,04,Almería,5479,4119,1360
1997,05,Ávila,1794,2172,-378
1997,06,Badajoz,5081,5456,-375
1997,07,Baleares,12572,6727,5845
1997,08,Barcelona,21409,31091,-9682
1997,09,Burgos,3118,3851,-733
1997,10,Cáceres,3815,3990,-175
1997,11,Cádiz,7573,10550,-2977
1997,12,Castellón,4694,3171,1523
1997,13,Ciudad Real,3542,4189,-647
1997,14,Córdoba,4954,6279,-1325
1997,15,A Coruña,6568,6834,-266
1997,16,Cuenca,1844,2418,-574
1997,17,Girona,7809,5238,2571
1997,18,Granada,6777,7999,-1222
1997,19,Guadalajara,4394,2184,2210
1997,20,Guipúzcoa,4118,5305,-1187
1997,21,Huelva,2556,2890,-334
1997,22,Huesca,1998,2108,-110
1997,23,Jaén,4547,5599,-1052
1997,24,León,3477,4795,-1318
1997,25,Lleida,3643,3188,455
1997,26,La Rioja,2830,2453,377
1997,27,Lugo,2396,2488,-92
1997,28,Madrid,31926,41109,-9183
1997,29,Málaga,10586,7223,3363
1997,30,Murcia,8942,7552,1390
1997,31,Navarra,4187,3446,741
1997,32,Ourense,2485,2750,-265
1997,33,Asturias,5123,6046,-923
1997,34,Palencia,1577,2033,-456
1997,35,Las Palmas,13627,7194,6433
1997,36,Pontevedra,4600,6115,-1515
1997,37,Salamanca,2989,3463,-474
1997,38,Santa Cruz de Tenerife,9071,5153,3918
1997,39,Cantabria,4629,3894,735
1997,40,Segovia,1306,1616,-310
1997,41,Sevilla,8736,10866,-2130
1997,42,Soria,1062,1023,39
1997,43,Tarragona,8849,5479,3370
1997,44,Teruel,1559,1637,-78
1997,45,Toledo,7510,5402,2108
1997,46,Valencia,10671,10493,178
1997,47,Valladolid,3991,4281,-290
1997,48,Vizcaya,6401,10096,-3695
1997,49,Zamora,1834,2086,-252
1997,50,Zaragoza,5168,5260,-92
1997,51,Ceuta,1284,1486,-202
1997,52,Melilla,1592,1808,-216
1998,01,Álava,3592,3508,84
1998,02,Albacete,3484,3764,-280
1998,03,Alicante,16967,10301,6666
1998,04,Almería,5869,4930,939
1998,05,Ávila,2100,2595,-495
1998,06,Badajoz,5351,6613,-1262
1998,07,Baleares,17425,7446,9979
1998,08,Barcelona,24562,34748,-10186
1998,09,Burgos,4094,4471,-377
1998,10,Cáceres,4403,5169,-766
1998,11,Cádiz,8753,12271,-3518
1998,12,Castellón,5368,3676,1692
1998,13,Ciudad Real,3737,5065,-1328
1998,14,Córdoba,4948,7658,-2710
1998,15,A Coruña,7154,8141,-987
1998,16,Cuenca,2528,2777,-249
1998,17,Girona,8912,6299,2613
1998,18,Granada,7656,9216,-1560
1998,19,Guadalajara,5334,2517,2817
1998,20,Guipúzcoa,4611,5437,-826
1998,21,Huelva,3186,3233,-47
1998,22,Huesca,2570,2243,327
1998,23,Jaén,5080,6737,-1657
1998,24,León,4341,5577,-1236
1998,25,Lleida,4305,3787,518
1998,26,La Rioja,3430,2857,573
1998,27,Lugo,2747,2853,-106
1998,28,Madrid,39798,47222,-7424
1998,29,Málaga,12101,8370,3731
1998,30,Murcia,10166,8233,1933
1998,31,Navarra,5166,3907,1259
1998,32,Ourense,2776,3622,-846
1998,33,Asturias,5197,7502,-2305
1998,34,Palencia,1802,2395,-593
1998,35,Las Palmas,14901,8444,6457
1998,36,Pontevedra,5447,7082,-1635
1998,37,Salamanca,3495,3969,-474
1998,38,Santa Cruz de Tenerife,8529,6041,2488
1998,39,Cantabria,5985,4710,1275
1998,40,Segovia,1895,1853,42
1998,41,Sevilla,10076,12760,-2684
1998,42,Soria,1306,1217,89
1998,43,Tarragona,10325,6166,4159
1998,44,Teruel,2002,1906,96
1998,45,Toledo,7829,6579,1250
1998,46,Valencia,12338,12332,6
1998,47,Valladolid,3833,5063,-1230
1998,48,Vizcaya,7487,11336,-3849
1998,49,Zamora,2137,2471,-334
1998,50,Zaragoza,5604,6513,-909
1998,51,Ceuta,2114,1695,419
1998,52,Melilla,2409,1948,461
1999,01,Álava,3553,3727,-174
1999,02,Albacete,3959,4187,-228
1999,03,Alicante,19367,11368,7999
1999,04,Almería,5923,5643,280
1999,05,Ávila,2421,2880,-459
1999,06,Badajoz,5866,6972,-1106
1999,07,Baleares,20267,9336,10931
1999,08,Barcelona,27045,37142,-10097
1999,09,Burgos,3934,4851,-917
1999,10,Cáceres,4847,5983,-1136
1999,11,Cádiz,9938,13552,-3614
1999,12,Castellón,6143,3781,2362
1999,13,Ciudad Real,4191,5500,-1309
1999,14,Córdoba,5879,8466,-2587
1999,15,A Coruña,7111,9068,-1957
1999,16,Cuenca,2497,3085,-588
1999,17,Girona,9703,6333,3370
1999,18,Granada,7521,10076,-2555
1999,19,Guadalajara,5773,2935,2838
1999,20,Guipúzcoa,4703,5679,-976
1999,21,Huelva,3718,3879,-161
1999,22,Huesca,2786,2600,186
1999,23,Jaén,5070,7197,-2127
1999,24,León,4918,6285,-1367
1999,25,Lleida,4722,4222,500
1999,26,La Rioja,4003,2945,1058
1999,27,Lugo,2846,3202,-356
1999,28,Madrid,44038,52458,-8420
1999,29,Málaga,14225,9134,5091
1999,30,Murcia,11089,9224,1865
1999,31,Navarra,5547,4156,1391
1999,32,Ourense,2981,4122,-1141
1999,33,Asturias,5848,7942,-2094
1999,34,Palencia,1925,2674,-749
1999,35,Las Palmas,16486,10022,6464
1999,36,Pontevedra,5952,7636,-1684
1999,37,Salamanca,3569,4641,-1072
1999,38,Santa Cruz de Tenerife,8637,6830,1807
1999,39,Cantabria,6695,5069,1626
1999,40,Segovia,2098,1925,173
1999,41,Sevilla,12401,14723,-2322
1999,42,Soria,1197,1307,-110
1999,43,Tarragona,11237,6747,4490
1999,44,Teruel,2040,1990,50
1999,45,Toledo,9381,7040,2341
1999,46,Valencia,13554,13426,128
1999,47,Valladolid,4354,5237,-883
1999,48,Vizcaya,7539,11528,-3989
1999,49,Zamora,2263,2687,-424
1999,50,Zaragoza,5935,6804,-869
1999,51,Ceuta,2449,2112,337
1999,52,Melilla,2460,2276,184
2000,01,Álava,3867,3553,314
2000,02,Albacete,3882,4188,-306
2000,03,Alicante,20823,12749,8074
2000,04,Almería,5729,7072,-1343
2000,05,Ávila,2143,2886,-743
2000,06,Badajoz,5654,6697,-1043
2000,07,Baleares,22321,11194,11127
2000,08,Barcelona,28739,38701,-9962
2000,09,Burgos,3493,4828,-1335
2000,10,Cáceres,3911,6070,-2159
2000,11,Cádiz,11741,12972,-1231
2000,12,Castellón,7113,4264,2849
2000,13,Ciudad Real,4238,5757,-1519
2000,14,Córdoba,5914,8422,-2508
2000,15,A Coruña,7613,9704,-2091
2000,16,Cuenca,2239,3452,-1213
2000,17,Girona,10336,6474,3862
2000,18,Granada,7980,10175,-2195
2000,19,Guadalajara,5488,3056,2432
2000,20,Guipúzcoa,4555,5849,-1294
2000,21,Huelva,3743,4007,-264
2000,22,Huesca,2496,2681,-185
2000,23,Jaén,5180,7508,-2328
2000,24,León,4056,6434,-2378
2000,25,Lleida,3791,4529,-738
2000,26,La Rioja,4339,3136,1203
2000,27,Lugo,2832,3442,-610
2000,28,Madrid,45831,52172,-6341
2000,29,Málaga,13802,9422,4380
2000,30,Murcia,10981,10280,701
2000,31,Navarra,5834,4719,1115
2000,32,Ourense,3160,4205,-1045
2000,33,Asturias,5988,8173,-2185
2000,34,Palencia,1871,2586,-715
2000,35,Las Palmas,16637,11759,4878
2000,36,Pontevedra,6249,8156,-1907
2000,37,Salamanca,3459,4677,-1218
2000,38,Santa Cruz de Tenerife,10069,7592,2477
2000,39,Cantabria,6710,4881,1829
2000,40,Segovia,1876,2107,-231
2000,41,Sevilla,13491,15229,-1738
2000,42,Soria,1208,1353,-145
2000,43,Tarragona,14704,6946,7758
2000,44,Teruel,1924,2294,-370
2000,45,Toledo,9340,6959,2381
2000,46,Valencia,16049,13252,2797
2000,47,Valladolid,4712,5323,-611
2000,48,Vizcaya,7867,11841,-3974
2000,49,Zamora,2139,2734,-595
2000,50,Zaragoza,6740,7005,-265
2000,51,Ceuta,1998,2528,-530
2000,52,Melilla,1723,2585,-862
2001,01,Álava,3651,3647,4
2001,02,Albacete,3808,4405,-597
2001,03,Alicante,20857,13115,7742
2001,04,Almería,5765,6483,-718
2001,05,Ávila,2192,2390,-198
2001,06,Badajoz,4670,6530,-1860
2001,07,Baleares,20765,12389,8376
2001,08,Barcelona,30431,38784,-8353
2001,09,Burgos,4038,4566,-528
2001,10,Cáceres,3879,5394,-1515
2001,11,Cádiz,10676,11084,-408
2001,12,Castellón,7290,4340,2950
2001,13,Ciudad Real,4268,5423,-1155
2001,14,Córdoba,5437,7455,-2018
2001,15,A Coruña,7432,8869,-1437
2001,16,Cuenca,2264,3413,-1149
2001,17,Girona,10256,6652,3604
2001,18,Granada,7969,8205,-236
2001,19,Guadalajara,6296,3233,3063
2001,20,Guipúzcoa,5113,5478,-365
2001,21,Huelva,3532,3870,-338
2001,22,Huesca,2866,2427,439
2001,23,Jaén,4641,6339,-1698
2001,24,León,4049,6103,-2054
2001,25,Lleida,4689,4228,461
2001,26,La Rioja,4108,3294,814
2001,27,Lugo,2957,3269,-312
2001,28,Madrid,45581,55329,-9748
2001,29,Málaga,12752,8488,4264
2001,30,Murcia,10964,11584,-620
2001,31,Navarra,5785,5327,458
2001,32,Ourense,3110,4137,-1027
2001,33,Asturias,5678,7805,-2127
2001,34,Palencia,1643,2285,-642
2001,35,Las Palmas,13650,11631,2019
2001,36,Pontevedra,6350,7803,-1453
2001,37,Salamanca,2435,4224,-1789
2001,38,Santa Cruz de Tenerife,8881,6948,1933
2001,39,Cantabria,6301,4735,1566
2001,40,Segovia,1802,2018,-216
2001,41,Sevilla,12256,13036,-780
2001,42,Soria,1189,1373,-184
2001,43,Tarragona,12837,7091,5746
2001,44,Teruel,2006,1922,84
2001,45,Toledo,10472,7214,3258
2001,46,Valencia,16384,13642,2742
2001,47,Valladolid,4609,4915,-306
2001,48,Vizcaya,7871,11376,-3505
2001,49,Zamora,1779,2497,-718
2001,50,Zaragoza,6794,7321,-527
2001,51,Ceuta,1822,2141,-319
2001,52,Melilla,1560,2183,-623
2002,01,Álava,5027,4287,740
2002,02,Albacete,5226,5794,-568
2002,03,Alicante,27280,18748,8532
2002,04,Almería,7499,9919,-2420
2002,05,Ávila,3015,3190,-175
2002,06,Badajoz,6082,7575,-1493
2002,07,Baleares,24003,18461,5542
2002,08,Barcelona,42100,54324,-12224
2002,09,Burgos,5099,5568,-469
2002,10,Cáceres,5616,7132,-1516
2002,11,Cádiz,14502,13129,1373
2002,12,Castellón,8737,6380,2357
2002,13,Ciudad Real,5996,6933,-937
2002,14,Córdoba,7407,8575,-1168
2002,15,A Coruña,9878,10088,-210
2002,16,Cuenca,3762,4323,-561
2002,17,Girona,14830,9044,5786
2002,18,Granada,11188,11098,90
2002,19,Guadalajara,9061,4469,4592
2002,20,Guipúzcoa,5550,6617,-1067
2002,21,Huelva,5011,5401,-390
2002,22,Huesca,4034,3456,578
2002,23,Jaén,6814,8111,-1297
2002,24,León,5749,7090,-1341
2002,25,Lleida,6728,5864,864
2002,26,La Rioja,4834,4586,248
2002,27,Lugo,3262,3907,-645
2002,28,Madrid,61761,79869,-18108
2002,29,Málaga,18185,11905,6280
2002,30,Murcia,16284,15451,833
2002,31,Navarra,7358,7222,136
2002,32,Ourense,3454,4749,-1295
2002,33,Asturias,7170,9507,-2337
2002,34,Palencia,2245,2975,-730
2002,35,Las Palmas,15475,15570,-95
2002,36,Pontevedra,7773,9275,-1502
2002,37,Salamanca,4323,5265,-942
2002,38,Santa Cruz de Tenerife,12142,10401,1741
2002,39,Cantabria,7768,6255,1513
2002,40,Segovia,2599,2902,-303
2002,41,Sevilla,16572,15978,594
2002,42,Soria,1458,1710,-252
2002,43,Tarragona,16808,9685,7123
2002,44,Teruel,2954,2858,96
2002,45,Toledo,15805,9354,6451
2002,46,Valencia,24133,19652,4481
2002,47,Valladolid,6006,6860,-854
2002,48,Vizcaya,9522,12744,-3222
2002,49,Zamora,2907,3075,-168
2002,50,Zaragoza,8916,10808,-1892
2002,51,Ceuta,1810,2624,-814
2002,52,Melilla,1727,2682,-955
2003,01,Álava,5038,4547,491
2003,02,Albacete,5476,6117,-641
2003,03,Alicante,29462,21074,8388
2003,04,Almería,8910,10115,-1205
2003,05,Ávila,3752,3373,379
2003,06,Badajoz,7630,7455,175
2003,07,Baleares,20894,21872,-978
2003,08,Barcelona,47491,63877,-16386
2003,09,Burgos,5508,6352,-844
2003,10,Cáceres,5728,7188,-1460
2003,11,Cádiz,16007,13378,2629
2003,12,Castellón,8735,7441,1294
2003,13,Ciudad Real,7105,6983,122
2003,14,Córdoba,8447,8735,-288
2003,15,A Coruña,10752,11333,-581
2003,16,Cuenca,4279,4458,-179
2003,17,Girona,17318,10175,7143
2003,18,Granada,13506,11713,1793
2003,19,Guadalajara,10475,5029,5446
2003,20,Guipúzcoa,6190,6424,-234
2003,21,Huelva,5477,5549,-72
2003,22,Huesca,4288,4002,286
2003,23,Jaén,7698,8686,-988
2003,24,León,6370,7518,-1148
2003,25,Lleida,8636,6916,1720
2003,26,La Rioja,5869,4892,977
2003,27,Lugo,3893,4267,-374
2003,28,Madrid,65679,93535,-27856
2003,29,Málaga,20598,13566,7032
2003,30,Murcia,17105,16914,191
2003,31,Navarra,7725,7740,-15
2003,32,Ourense,3820,5274,-1454
2003,33,Asturias,8566,9405,-839
2003,34,Palencia,2295,3023,-728
2003,35,Las Palmas,16585,16075,510
2003,36,Pontevedra,8785,10003,-1218
2003,37,Salamanca,4651,5653,-1002
2003,38,Santa Cruz de Tenerife,12641,11650,991
2003,39,Cantabria,8955,6576,2379
2003,40,Segovia,3199,3131,68
2003,41,Sevilla,17603,15834,1769
2003,42,Soria,1958,1951,7
2003,43,Tarragona,19872,11332,8540
2003,44,Teruel,3077,3134,-57
2003,45,Toledo,18010,10348,7662
2003,46,Valencia,27304,21484,5820
2003,47,Valladolid,5926,7172,-1246
2003,48,Vizcaya,10470,13649,-3179
2003,49,Zamora,2784,3287,-503
2003,50,Zaragoza,10496,11322,-826
2003,51,Ceuta,1959,2755,-796
2003,52,Melilla,1990,2705,-715
2004,01,Álava,5391,4853,538
2004,02,Albacete,5815,6535,-720
2004,03,Alicante,30524,22986,7538
2004,04,Almería,10498,11713,-1215
2004,05,Ávila,3697,3537,160
2004,06,Badajoz,8631,7834,797
2004,07,Baleares,20315,21650,-1335
2004,08,Barcelona,50022,70249,-20227
2004,09,Burgos,6129,6375,-246
2004,10,Cáceres,5936,7123,-1187
2004,11,Cádiz,16847,13396,3451
2004,12,Castellón,9344,8125,1219
2004,13,Ciudad Real,7017,7352,-335
2004,14,Córdoba,8536,9059,-523
2004,15,A Coruña,11547,11058,489
2004,16,Cuenca,4251,4818,-567
2004,17,Girona,18166,11486,6680
2004,18,Granada,12747,11495,1252
2004,19,Guadalajara,10916,5461,5455
2004,20,Guipúzcoa,6083,6796,-713
2004,21,Huelva,6103,6068,35
2004,22,Huesca,4507,4429,78
2004,23,Jaén,7975,8725,-750
2004,24,León,6000,7514,-1514
2004,25,Lleida,9490,8829,661
2004,26,La Rioja,6474,5471,1003
2004,27,Lugo,3963,4318,-355
2004,28,Madrid,66523,99854,-33331
2004,29,Málaga,23225,14578,8647
2004,30,Murcia,20621,17063,3558
2004,31,Navarra,8039,7913,126
2004,32,Ourense,3950,5158,-1208
2004,33,Asturias,9181,10001,-820
2004,34,Palencia,2428,3164,-736
2004,35,Las Palmas,16736,16857,-121
2004,36,Pontevedra,9280,10083,-803
2004,37,Salamanca,4785,5657,-872
2004,38,Santa Cruz de Tenerife,13559,12458,1101
2004,39,Cantabria,8997,7339,1658
2004,40,Segovia,3316,3308,8
2004,41,Sevilla,19107,16095,3012
2004,42,Soria,1943,2143,-200
2004,43,Tarragona,22190,12292,9898
2004,44,Teruel,2951,3320,-369
2004,45,Toledo,19568,11169,8399
2004,46,Valencia,30778,22935,7843
2004,47,Valladolid,6519,7169,-650
2004,48,Vizcaya,10437,13852,-3415
2004,49,Zamora,2937,3344,-407
2004,50,Zaragoza,11862,11110,752
2004,51,Ceuta,1632,2656,-1024
2004,52,Melilla,1973,2688,-715
2005,01,Álava,4947,5144,-197
2005,02,Albacete,5738,6716,-978
2005,03,Alicante,29826,24131,5695
2005,04,Almería,10104,10219,-115
2005,05,Ávila,3928,3640,288
2005,06,Badajoz,8058,8064,-6
2005,07,Baleares,20555,19195,1360
2005,08,Barcelona,53717,74136,-20419
2005,09,Burgos,5970,6268,-298
2005,10,Cáceres,5646,7008,-1362
2005,11,Cádiz,14981,13393,1588
2005,12,Castellón,10571,7762,2809
2005,13,Ciudad Real,8050,7280,770
2005,14,Córdoba,7938,8881,-943
2005,15,A Coruña,11722,10950,772
2005,16,Cuenca,3970,4833,-863
2005,17,Girona,16952,13282,3670
2005,18,Granada,13777,11601,2176
2005,19,Guadalajara,11847,5618,6229
2005,20,Guipúzcoa,6169,6757,-588
2005,21,Huelva,7301,5475,1826
2005,22,Huesca,4595,4387,208
2005,23,Jaén,7360,9008,-1648
2005,24,León,6223,8228,-2005
2005,25,Lleida,8360,10322,-1962
2005,26,La Rioja,5910,5868,42
2005,27,Lugo,4122,4062,60
2005,28,Madrid,68676,98670,-29994
2005,29,Málaga,21037,15482,5555
2005,30,Murcia,21906,16511,5395
2005,31,Navarra,7984,7661,323
2005,32,Ourense,4123,4935,-812
2005,33,Asturias,9353,10049,-696
2005,34,Palencia,2341,2845,-504
2005,35,Las Palmas,15933,16339,-406
2005,36,Pontevedra,10006,9933,73
2005,37,Salamanca,4797,5491,-694
2005,38,Santa Cruz de Tenerife,12874,12595,279
2005,39,Cantabria,8739,7575,1164
2005,40,Segovia,3306,3628,-322
2005,41,Sevilla,18888,15152,3736
2005,42,Soria,2051,2033,18
2005,43,Tarragona,22979,14044,8935
2005,44,Teruel,2911,3504,-593
2005,45,Toledo,21570,12110,9460
2005,46,Valencia,31507,24649,6858
2005,47,Valladolid,7110,7330,-220
2005,48,Vizcaya,10469,13391,-2922
2005,49,Zamora,3094,3512,-418
2005,50,Zaragoza,12383,11759,624
2005,51,Ceuta,1913,2490,-577
2005,52,Melilla,2037,2408,-371
2006,01,Álava,5320,5134,186
2006,02,Albacete,7037,7410,-373
2006,03,Alicante,31629,26785,4844
2006,04,Almería,10524,12873,-2349
2006,05,Ávila,4929,4587,342
2006,06,Badajoz,9613,8702,911
2006,07,Baleares,23597,19885,3712
2006,08,Barcelona,54973,80525,-25552
2006,09,Burgos,6590,6824,-234
2006,10,Cáceres,6410,7524,-1114
2006,11,Cádiz,15410,14091,1319
2006,12,Castellón,12418,8485,3933
2006,13,Ciudad Real,8519,8196,323
2006,14,Córdoba,8666,9339,-673
2006,15,A Coruña,12051,11685,366
2006,16,Cuenca,4990,5787,-797
2006,17,Girona,18260,14241,4019
2006,18,Granada,14051,12980,1071
2006,19,Guadalajara,12996,6727,6269
2006,20,Guipúzcoa,6035,6980,-945
2006,21,Huelva,6224,6765,-541
2006,22,Huesca,5026,4747,279
2006,23,Jaén,8220,9718,-1498
2006,24,León,7844,8429,-585
2006,25,Lleida,9869,9709,160
2006,26,La Rioja,6433,5829,604
2006,27,Lugo,4659,4826,-167
2006,28,Madrid,83613,107155,-23542
2006,29,Málaga,22791,17447,5344
2006,30,Murcia,21286,18745,2541
2006,31,Navarra,8490,7794,696
2006,32,Ourense,4799,5343,-544
2006,33,Asturias,10195,10903,-708
2006,34,Palencia,2823,3300,-477
2006,35,Las Palmas,16846,17200,-354
2006,36,Pontevedra,9975,11068,-1093
2006,37,Salamanca,5544,6184,-640
2006,38,Santa Cruz de Tenerife,13293,13339,-46
2006,39,Cantabria,9149,7778,1371
2006,40,Segovia,3893,4387,-494
2006,41,Sevilla,19828,16422,3406
2006,42,Soria,2019,2239,-220
2006,43,Tarragona,25206,15595,9611
2006,44,Teruel,3365,3803,-438
2006,45,Toledo,26189,13809,12380
2006,46,Valencia,31988,27373,4615
2006,47,Valladolid,8050,7755,295
2006,48,Vizcaya,10179,14263,-4084
2006,49,Zamora,3827,4209,-382
2006,50,Zaragoza,12127,12460,-333
2006,51,Ceuta,2204,2425,-221
2006,52,Melilla,2634,2827,-193
2007,01,Álava,5534,5373,161
2007,02,Albacete,7335,8287,-952
2007,03,Alicante,35317,30844,4473
2007,04,Almería,11614,15152,-3538
2007,05,Ávila,5061,5417,-356
2007,06,Badajoz,9694,9548,146
2007,07,Baleares,26587,22254,4333
2007,08,Barcelona,60482,80341,-19859
2007,09,Burgos,7262,7418,-156
2007,10,Cáceres,6623,8025,-1402
2007,11,Cádiz,15922,15264,658
2007,12,Castellón,14301,10364,3937
2007,13,Ciudad Real,9460,9281,179
2007,14,Córdoba,9462,10330,-868
2007,15,A Coruña,12878,12105,773
2007,16,Cuenca,5478,6809,-1331
2007,17,Girona,17643,15435,2208
2007,18,Granada,14846,14252,594
2007,19,Guadalajara,12933,7981,4952
2007,20,Guipúzcoa,6698,7551,-853
2007,21,Huelva,6388,7506,-1118
2007,22,Huesca,5492,5036,456
2007,23,Jaén,8623,11320,-2697
2007,24,León,8479,8892,-413
2007,25,Lleida,9976,10059,-83
2007,26,La Rioja,7356,6210,1146
2007,27,Lugo,4765,5014,-249
2007,28,Madrid,98913,115451,-16538
2007,29,Málaga,25093,20485,4608
2007,30,Murcia,22622,23196,-574
2007,31,Navarra,10082,7988,2094
2007,32,Ourense,4816,5889,-1073
2007,33,Asturias,12288,11431,857
2007,34,Palencia,2767,3480,-713
2007,35,Las Palmas,17093,18664,-1571
2007,36,Pontevedra,10615,11402,-787
2007,37,Salamanca,5872,6671,-799
2007,38,Santa Cruz de Tenerife,13728,14339,-611
2007,39,Cantabria,9966,8022,1944
2007,40,Segovia,4318,5176,-858
2007,41,Sevilla,21350,17368,3982
2007,42,Soria,2221,2547,-326
2007,43,Tarragona,24043,16950,7093
2007,44,Teruel,3125,4761,-1636
2007,45,Toledo,28960,17566,11394
2007,46,Valencia,37606,31493,6113
2007,47,Valladolid,8271,8678,-407
2007,48,Vizcaya,11378,14495,-3117
2007,49,Zamora,3571,4314,-743
2007,50,Zaragoza,14765,13074,1691
2007,51,Ceuta,2177,2556,-379
2007,52,Melilla,2867,2652,215
2008,01,Álava,6007,5000,1007
2008,02,Albacete,6600,6467,133
2008,03,Alicante,28463,31167,-2704
2008,04,Almería,10771,12983,-2212
2008,05,Ávila,3560,4612,-1052
2008,06,Badajoz,8714,8291,423
2008,07,Baleares,25108,21863,3245
2008,08,Barcelona,63812,68588,-4776
2008,09,Burgos,6418,6802,-384
2008,10,Cáceres,5854,6616,-762
2008,11,Cádiz,14913,14747,166
2008,12,Castellón,10918,10595,323
2008,13,Ciudad Real,8501,7906,595
2008,14,Córdoba,9247,9383,-136
2008,15,A Coruña,13312,10979,2333
2008,16,Cuenca,5104,5632,-528
2008,17,Girona,15447,15588,-141
2008,18,Granada,12942,14008,-1066
2008,19,Guadalajara,11729,7723,4006
2008,20,Guipúzcoa,6523,6743,-220
2008,21,Huelva,5881,6095,-214
2008,22,Huesca,5065,4713,352
2008,23,Jaén,7810,9903,-2093
2008,24,León,7693,8003,-310
2008,25,Lleida,9173,9231,-58
2008,26,La Rioja,6334,5734,600
2008,27,Lugo,4476,4707,-231
2008,28,Madrid,91770,102143,-10373
2008,29,Málaga,22043,20210,1833
2008,30,Murcia,21243,21104,139
2008,31,Navarra,9710,7691,2019
2008,32,Ourense,4845,5015,-170
2008,33,Asturias,11973,10017,1956
2008,34,Palencia,2574,3073,-499
2008,35,Las Palmas,14870,19739,-4869
2008,36,Pontevedra,10709,9561,1148
2008,37,Salamanca,5401,5985,-584
2008,38,Santa Cruz de Tenerife,12768,14058,-1290
2008,39,Cantabria,8916,7729,1187
2008,40,Segovia,3211,4105,-894
2008,41,Sevilla,20414,16248,4166
2008,42,Soria,1966,2261,-295
2008,43,Tarragona,19066,18173,893
2008,44,Teruel,2937,3964,-1027
2008,45,Toledo,25830,17499,8331
2008,46,Valencia,32742,31131,1611
2008,47,Valladolid,7301,7223,78
2008,48,Vizcaya,12046,12371,-325
2008,49,Zamora,2892,3800,-908
2008,50,Zaragoza,13466,12418,1048
2008,51,Ceuta,2527,2356,171
2008,52,Melilla,2789,2431,358
2009,01,Álava,6208,5048,1160
2009,02,Albacete,6889,6610,279
2009,03,Alicante,27118,30333,-3215
2009,04,Almería,11143,11017,126
2009,05,Ávila,3849,4458,-609
2009,06,Badajoz,9449,8119,1330
2009,07,Baleares,23091,23105,-14
2009,08,Barcelona,62524,64154,-1630
2009,09,Burgos,5860,6687,-827
2009,10,Cáceres,6422,6108,314
2009,11,Cádiz,14147,14926,-779
2009,12,Castellón,9820,10750,-930
2009,13,Ciudad Real,8414,8416,-2
2009,14,Córdoba,8504,9644,-1140
2009,15,A Coruña,13223,10678,2545
2009,16,Cuenca,4520,5610,-1090
2009,17,Girona,14428,15392,-964
2009,18,Granada,13924,13965,-41
2009,19,Guadalajara,10943,8226,2717
2009,20,Guipúzcoa,6744,6907,-163
2009,21,Huelva,6339,6143,196
2009,22,Huesca,4553,4699,-146
2009,23,Jaén,8319,9240,-921
2009,24,León,7415,7692,-277
2009,25,Lleida,8681,8905,-224
2009,26,La Rioja,5520,6057,-537
2009,27,Lugo,4871,4701,170
2009,28,Madrid,93041,95241,-2200
2009,29,Málaga,21595,19830,1765
2009,30,Murcia,20877,19408,1469
2009,31,Navarra,9255,7581,1674
2009,32,Ourense,5488,4958,530
2009,33,Asturias,11132,10604,528
2009,34,Palencia,2525,3010,-485
2009,35,Las Palmas,14288,18912,-4624
2009,36,Pontevedra,11440,9747,1693
2009,37,Salamanca,5050,5570,-520
2009,38,Santa Cruz de Tenerife,12012,14172,-2160
2009,39,Cantabria,8422,7898,524
2009,40,Segovia,3412,3854,-442
2009,41,Sevilla,19724,16780,2944
2009,42,Soria,2090,1984,106
2009,43,Tarragona,17647,17656,-9
2009,44,Teruel,2997,3807,-810
2009,45,Toledo,24081,19294,4787
2009,46,Valencia,29549,31695,-2146
2009,47,Valladolid,7274,6938,336
2009,48,Vizcaya,12884,12012,872
2009,49,Zamora,2952,3231,-279
2009,50,Zaragoza,11963,12985,-1022
2009,51,Ceuta,3151,2277,874
2009,52,Melilla,3806,2539,1267
2010,01,Álava,6635,4914,1721
2010,02,Albacete,6881,6775,106
2010,03,Alicante,28306,28367,-61
2010,04,Almería,10817,11051,-234
2010,05,Ávila,4102,4415,-313
2010,06,Badajoz,8861,8168,693
2010,07,Baleares,22178,23425,-1247
2010,08,Barcelona,61120,62413,-1293
2010,09,Burgos,6228,6603,-375
2010,10,Cáceres,6514,6650,-136
2010,11,Cádiz,15196,15201,-5
2010,12,Castellón,9560,10863,-1303
2010,13,Ciudad Real,8082,8648,-566
2010,14,Córdoba,8533,9370,-837
2010,15,A Coruña,13293,11586,1707
2010,16,Cuenca,5319,5738,-419
2010,17,Girona,14234,14683,-449
2010,18,Granada,14024,14084,-60
2010,19,Guadalajara,11287,8331,2956
2010,20,Guipúzcoa,7034,6734,300
2010,21,Huelva,5914,6698,-784
2010,22,Huesca,4760,5139,-379
2010,23,Jaén,8660,9669,-1009
2010,24,León,7870,7955,-85
2010,25,Lleida,9344,9140,204
2010,26,La Rioja,5558,5807,-249
2010,27,Lugo,4862,5031,-169
2010,28,Madrid,93736,94753,-1017
2010,29,Málaga,22395,20062,2333
2010,30,Murcia,18765,19396,-631
2010,31,Navarra,9254,7529,1725
2010,32,Ourense,5239,5184,55
2010,33,Asturias,10977,11227,-250
2010,34,Palencia,2697,3077,-380
2010,35,Las Palmas,14446,17193,-2747
2010,36,Pontevedra,10505,10159,346
2010,37,Salamanca,5573,5764,-191
2010,38,Santa Cruz de Tenerife,11753,13676,-1923
2010,39,Cantabria,8506,8196,310
2010,40,Segovia,3615,3597,18
2010,41,Sevilla,19455,17770,1685
2010,42,Soria,2041,2044,-3
2010,43,Tarragona,18135,17378,757
2010,44,Teruel,3347,3702,-355
2010,45,Toledo,24158,19474,4684
2010,46,Valencia,29284,31728,-2444
2010,47,Valladolid,7170,7412,-242
2010,48,Vizcaya,12565,12429,136
2010,49,Zamora,3368,3421,-53
2010,50,Zaragoza,12161,13076,-915
2010,51,Ceuta,2943,2600,343
2010,52,Melilla,3938,2893,1045
2011,01,Álava,6881,5074,1807
2011,02,Albacete,6576,6971,-395
2011,03,Alicante,27359,27287,72
2011,04,Almería,10328,13001,-2673
2011,05,Ávila,3884,4821,-937
2011,06,Badajoz,8734,8652,82
2011,07,Baleares,23819,23550,269
2011,08,Barcelona,61561,60322,1239
2011,09,Burgos,6042,6732,-690
2011,10,Cáceres,6133,6864,-731
2011,11,Cádiz,14406,15579,-1173
2011,12,Castellón,9125,10587,-1462
2011,13,Ciudad Real,8169,8648,-479
2011,14,Córdoba,8594,10066,-1472
2011,15,A Coruña,12958,12120,838
2011,16,Cuenca,4376,5873,-1497
2011,17,Girona,14064,14398,-334
2011,18,Granada,13625,14889,-1264
2011,19,Guadalajara,11073,9419,1654
2011,20,Guipúzcoa,7664,6767,897
2011,21,Huelva,5730,6698,-968
2011,22,Huesca,4496,5436,-940
2011,23,Jaén,10040,9782,258
2011,24,León,7246,8002,-756
2011,25,Lleida,8725,9175,-450
2011,26,La Rioja,5332,5751,-419
2011,27,Lugo,4830,4913,-83
2011,28,Madrid,99129,90752,8377
2011,29,Málaga,23190,19290,3900
2011,30,Murcia,18544,19359,-815
2011,31,Navarra,8857,7935,922
2011,32,Ourense,5071,5200,-129
2011,33,Asturias,11173,11016,157
2011,34,Palencia,2465,2932,-467
2011,35,Las Palmas,16476,16968,-492
2011,36,Pontevedra,10196,10544,-348
2011,37,Salamanca,5098,6097,-999
2011,38,Santa Cruz de Tenerife,12449,13166,-717
2011,39,Cantabria,8571,8394,177
2011,40,Segovia,3299,4026,-727
2011,41,Sevilla,19104,18578,526
2011,42,Soria,1855,2168,-313
2011,43,Tarragona,16554,17191,-637
2011,44,Teruel,2821,3595,-774
2011,45,Toledo,22093,21228,865
2011,46,Valencia,28327,30477,-2150
2011,47,Valladolid,7393,7483,-90
2011,48,Vizcaya,13943,11867,2076
2011,49,Zamora,2934,3611,-677
2011,50,Zaragoza,13776,13079,697
2011,51,Ceuta,2768,2543,225
2011,52,Melilla,4147,3127,1020
2012,01,Álava,5869,4954,915
2012,02,Albacete,5776,6884,-1108
2012,03,Alicante,27309,26087,1222
2012,04,Almería,10867,10379,488
2012,05,Ávila,3339,4765,-1426
2012,06,Badajoz,8255,8836,-581
2012,07,Baleares,25947,21863,4084
2012,08,Barcelona,57587,59025,-1438
2012,09,Burgos,5469,6444,-975
2012,10,Cáceres,5990,6812,-822
2012,11,Cádiz,14317,15513,-1196
2012,12,Castellón,9067,9591,-524
2012,13,Ciudad Real,6918,8937,-2019
2012,14,Córdoba,8091,10119,-2028
2012,15,A Coruña,12357,11768,589
2012,16,Cuenca,3858,5929,-2071
2012,17,Girona,13000,13692,-692
2012,18,Granada,12770,14668,-1898
2012,19,Guadalajara,9848,10559,-711
2012,20,Guipúzcoa,8114,6149,1965
2012,21,Huelva,5937,6038,-101
2012,22,Huesca,4263,4657,-394
2012,23,Jaén,7262,11496,-4234
2012,24,León,5998,7455,-1457
2012,25,Lleida,8019,8849,-830
2012,26,La Rioja,5112,5333,-221
2012,27,Lugo,4523,4567,-44
2012,28,Madrid,100791,85405,15386
2012,29,Málaga,22830,18840,3990
2012,30,Murcia,18368,17884,484
2012,31,Navarra,8660,7872,788
2012,32,Ourense,5003,4850,153
2012,33,Asturias,9356,10334,-978
2012,34,Palencia,2172,2823,-651
2012,35,Las Palmas,18358,16198,2160
2012,36,Pontevedra,9887,9771,116
2012,37,Salamanca,4788,5581,-793
2012,38,Santa Cruz de Tenerife,14474,12793,1681
2012,39,Cantabria,7443,7972,-529
2012,40,Segovia,2945,3715,-770
2012,41,Sevilla,17655,19103,-1448
2012,42,Soria,1531,1941,-410
2012,43,Tarragona,16096,16791,-695
2012,44,Teruel,2666,3265,-599
2012,45,Toledo,20171,22465,-2294
2012,46,Valencia,27779,29459,-1680
2012,47,Valladolid,6477,7245,-768
2012,48,Vizcaya,12279,11183,1096
2012,49,Zamora,2636,3381,-745
2012,50,Zaragoza,12518,12004,514
2012,51,Ceuta,2396,2554,-158
2012,52,Melilla,4452,2795,1657
2013,01,Álava,5937,4966,971
2013,02,Albacete,5314,6635,-1321
2013,03,Alicante,26757,24900,1857
2013,04,Almería,11483,9798,1685
2013,05,Ávila,3370,4304,-934
2013,06,Badajoz,8370,8858,-488
2013,07,Baleares,25589,20048,5541
2013,08,Barcelona,56013,55291,722
2013,09,Burgos,4913,6184,-1271
2013,10,Cáceres,6101,6709,-608
2013,11,Cádiz,13884,15931,-2047
2013,12,Castellón,8033,9060,-1027
2013,13,Ciudad Real,6403,8686,-2283
2013,14,Córdoba,7716,10091,-2375
2013,15,A Coruña,11500,11582,-82
2013,16,Cuenca,3443,5149,-1706
2013,17,Girona,13167,13334,-167
2013,18,Granada,12614,13816,-1202
2013,19,Guadalajara,8263,9673,-1410
2013,20,Guipúzcoa,8838,6432,2406
2013,21,Huelva,5733,6105,-372
2013,22,Huesca,4250,4525,-275
2013,23,Jaén,6648,10186,-3538
2013,24,León,6123,7618,-1495
2013,25,Lleida,8050,8417,-367
2013,26,La Rioja,4732,5047,-315
2013,27,Lugo,4349,4354,-5
2013,28,Madrid,95045,80042,15003
2013,29,Málaga,22547,19619,2928
2013,30,Murcia,18114,16628,1486
2013,31,Navarra,7841,8064,-223
2013,32,Ourense,4634,4755,-121
2013,33,Asturias,9345,10135,-790
2013,34,Palencia,2299,2726,-427
2013,35,Las Palmas,17613,15900,1713
2013,36,Pontevedra,9402,9556,-154
2013,37,Salamanca,4457,5569,-1112
2013,38,Santa Cruz de Tenerife,13366,12184,1182
2013,39,Cantabria,7347,7705,-358
2013,40,Segovia,2720,3626,-906
2013,41,Sevilla,17367,19404,-2037
2013,42,Soria,1468,1857,-389
2013,43,Tarragona,14865,15750,-885
2013,44,Teruel,2627,3069,-442
2013,45,Toledo,18371,22013,-3642
2013,46,Valencia,26062,26906,-844
2013,47,Valladolid,6050,7085,-1035
2013,48,Vizcaya,11491,11176,315
2013,49,Zamora,2418,3204,-786
2013,50,Zaragoza,12743,12240,503
2013,51,Ceuta,2994,2498,496
2013,52,Melilla,3725,3094,631
2014,01,Álava,6347,4698,1649
2014,02,Albacete,5603,6896,-1293
2014,03,Alicante,26394,26271,123
2014,04,Almería,10990,9942,1048
2014,05,Ávila,3758,4299,-541
2014,06,Badajoz,7623,9085,-1462
2014,07,Baleares,25118,21462,3656
2014,08,Barcelona,58032,52626,5406
2014,09,Burgos,5570,6320,-750
2014,10,Cáceres,5816,6929,-1113
2014,11,Cádiz,14298,16306,-2008
2014,12,Castellón,8359,9377,-1018
2014,13,Ciudad Real,6244,8498,-2254
2014,14,Córdoba,8104,10129,-2025
2014,15,A Coruña,10915,11835,-920
2014,16,Cuenca,3943,5122,-1179
2014,17,Girona,12747,13656,-909
2014,18,Granada,13417,14654,-1237
2014,19,Guadalajara,8051,9001,-950
2014,20,Guipúzcoa,8898,6794,2104
2014,21,Huelva,6053,6215,-162
2014,22,Huesca,4268,4501,-233
2014,23,Jaén,6810,10087,-3277
2014,24,León,6410,7826,-1416
2014,25,Lleida,8383,8399,-16
2014,26,La Rioja,4991,5232,-241
2014,27,Lugo,4160,4500,-340
2014,28,Madrid,94189,78576,15613
2014,29,Málaga,23675,19072,4603
2014,30,Murcia,17723,17802,-79
2014,31,Navarra,8153,7491,662
2014,32,Ourense,4606,5053,-447
2014,33,Asturias,8809,10307,-1498
2014,34,Palencia,2203,2715,-512
2014,35,Las Palmas,17078,15925,1153
2014,36,Pontevedra,9153,9810,-657
2014,37,Salamanca,4525,5522,-997
2014,38,Santa Cruz de Tenerife,13115,12311,804
2014,39,Cantabria,7361,7835,-474
2014,40,Segovia,2989,3511,-522
2014,41,Sevilla,17575,19762,-2187
2014,42,Soria,1587,1934,-347
2014,43,Tarragona,14639,15707,-1068
2014,44,Teruel,2653,3138,-485
2014,45,Toledo,17848,20950,-3102
2014,46,Valencia,26924,27428,-504
2014,47,Valladolid,6589,7281,-692
2014,48,Vizcaya,11731,11043,688
2014,49,Zamora,2722,3211,-489
2014,50,Zaragoza,13052,12760,292
2014,51,Ceuta,2194,2792,-598
2014,52,Melilla,3208,3007,201
2015,01,Álava,5908,4797,1111
2015,02,Albacete,5436,6942,-1506
2015,03,Alicante,26051,25670,381
2015,04,Almería,11425,10375,1050
2015,05,Ávila,3066,4371,-1305
2015,06,Badajoz,7274,8966,-1692
2015,07,Baleares,24977,21298,3679
2015,08,Barcelona,58482,51270,7212
2015,09,Burgos,5065,6350,-1285
2015,10,Cáceres,5294,6823,-1529
2015,11,Cádiz,14713,16729,-2016
2015,12,Castellón,7946,9079,-1133
2015,13,Ciudad Real,5977,8890,-2913
2015,14,Córdoba,7932,10400,-2468
2015,15,A Coruña,11578,11928,-350
2015,16,Cuenca,3838,5553,-1715
2015,17,Girona,13032,13180,-148
2015,18,Granada,13893,14899,-1006
2015,19,Guadalajara,7896,8342,-446
2015,20,Guipúzcoa,7952,7051,901
2015,21,Huelva,5847,6912,-1065
2015,22,Huesca,4138,4521,-383
2015,23,Jaén,6427,10505,-4078
2015,24,León,6015,7783,-1768
2015,25,Lleida,8176,8638,-462
2015,26,La Rioja,4949,5083,-134
2015,27,Lugo,4462,4674,-212
2015,28,Madrid,98874,75086,23788
2015,29,Málaga,24030,19971,4059
2015,30,Murcia,17723,18291,-568
2015,31,Navarra,8418,7160,1258
2015,32,Ourense,4304,5000,-696
2015,33,Asturias,8932,10099,-1167
2015,34,Palencia,2237,2633,-396
2015,35,Las Palmas,16148,15992,156
2015,36,Pontevedra,9326,10222,-896
2015,37,Salamanca,4187,5679,-1492
2015,38,Santa Cruz de Tenerife,11979,13005,-1026
2015,39,Cantabria,7174,7559,-385
2015,40,Segovia,2819,3705,-886
2015,41,Sevilla,18447,19806,-1359
2015,42,Soria,1483,1874,-391
2015,43,Tarragona,14456,15955,-1499
2015,44,Teruel,2581,3140,-559
2015,45,Toledo,17536,20558,-3022
2015,46,Valencia,27049,26366,683
2015,47,Valladolid,6515,6955,-440
2015,48,Vizcaya,12014,11253,761
2015,49,Zamora,2282,3344,-1062
2015,50,Zaragoza,12436,12777,-341
2015,51,Ceuta,2066,2749,-683
2015,52,Melilla,2681,3238,-557
2016,01,Álava,5854,4726,1128
2016,02,Albacete,4979,6503,-1524
2016,03,Alicante,25394,24278,1116
2016,04,Almería,10307,9760,547
2016,05,Ávila,2920,4131,-1211
2016,06,Badajoz,6637,8945,-2308
2016,07,Baleares,24393,19178,5215
2016,08,Barcelona,52884,49725,3159
2016,09,Burgos,5072,6035,-963
2016,10,Cáceres,4692,6782,-2090
2016,11,Cádiz,13922,15905,-1983
2016,12,Castellón,7932,8486,-554
2016,13,Ciudad Real,5753,8450,-2697
2016,14,Córdoba,7373,10243,-2870
2016,15,A Coruña,11003,11317,-314
2016,16,Cuenca,3489,4722,-1233
2016,17,Girona,12359,11801,558
2016,18,Granada,12437,14184,-1747
2016,19,Guadalajara,8005,7683,322
2016,20,Guipúzcoa,7572,6950,622
2016,21,Huelva,5494,6279,-785
2016,22,Huesca,4016,4422,-406
2016,23,Jaén,6044,9597,-3553
2016,24,León,5749,7484,-1735
2016,25,Lleida,7663,7889,-226
2016,26,La Rioja,4649,4923,-274
2016,27,Lugo,4185,4551,-366
2016,28,Madrid,91026,74369,16657
2016,29,Málaga,21794,19431,2363
2016,30,Murcia,17989,16986,1003
2016,31,Navarra,8230,6872,1358
2016,32,Ourense,4179,4892,-713
2016,33,Asturias,8495,9611,-1116
2016,34,Palencia,2287,2623,-336
2016,35,Las Palmas,15424,14628,796
2016,36,Pontevedra,9041,9572,-531
2016,37,Salamanca,4068,5027,-959
2016,38,Santa Cruz de Tenerife,12002,11506,496
2016,39,Cantabria,7552,7333,219
2016,40,Segovia,2648,3298,-650
2016,41,Sevilla,16872,19397,-2525
2016,42,Soria,1427,1683,-256
2016,43,Tarragona,14457,14059,398
2016,44,Teruel,2273,3029,-756
2016,45,Toledo,17758,18629,-871
2016,46,Valencia,25165,24808,357
2016,47,Valladolid,6167,6665,-498
2016,48,Vizcaya,11903,10764,1139
2016,49,Zamora,2251,3195,-944
2016,50,Zaragoza,12336,12046,290
2016,51,Ceuta,2175,2485,-310
2016,52,Melilla,2596,3035,-439
2017,01,Álava,5715,4636,1079
2017,02,Albacete,4825,6379,-1554
2017,03,Alicante,24714,24484,230
2017,04,Almería,9688,10134,-446
2017,05,Ávila,3067,4110,-1043
2017,06,Badajoz,6495,8730,-2235
2017,07,Baleares,25022,19900,5122
2017,08,Barcelona,53918,52292,1626
2017,09,Burgos,5275,5806,-531
2017,10,Cáceres,4639,7029,-2390
2017,11,Cádiz,13513,16644,-3131
2017,12,Castellón,8573,8138,435
2017,13,Ciudad Real,6019,8557,-2538
2017,14,Córdoba,7398,10427,-3029
2017,15,A Coruña,11513,11094,419
2017,16,Cuenca,3476,4631,-1155
2017,17,Girona,12851,11824,1027
2017,18,Granada,12618,14409,-1791
2017,19,Guadalajara,7918,7592,326
2017,20,Guipúzcoa,7238,7008,230
2017,21,Huelva,5334,6317,-983
2017,22,Huesca,4319,4491,-172
2017,23,Jaén,5896,9937,-4041
2017,24,León,5597,7305,-1708
2017,25,Lleida,7412,7658,-246
2017,26,La Rioja,4690,4547,143
2017,27,Lugo,4358,4488,-130
2017,28,Madrid,93735,77694,16041
2017,29,Málaga,22031,19585,2446
2017,30,Murcia,17080,17247,-167
2017,31,Navarra,8550,7275,1275
2017,32,Ourense,4127,4776,-649
2017,33,Asturias,8498,9683,-1185
2017,34,Palencia,2092,2684,-592
2017,35,Las Palmas,15462,14536,926
2017,36,Pontevedra,9187,9353,-166
2017,37,Salamanca,4137,5120,-983
2017,38,Santa Cruz de Tenerife,12264,11912,352
2017,39,Cantabria,7980,7337,643
2017,40,Segovia,2837,3319,-482
2017,41,Sevilla,16989,19990,-3001
2017,42,Soria,1684,1721,-37
2017,43,Tarragona,15453,13644,1809
2017,44,Teruel,2602,3073,-471
2017,45,Toledo,19134,18813,321
2017,46,Valencia,26207,24764,1443
2017,47,Valladolid,6540,6779,-239
2017,48,Vizcaya,11393,10963,430
2017,49,Zamora,2133,3137,-1004
2017,50,Zaragoza,12674,11685,989
2017,51,Ceuta,1966,2312,-346
2017,52,Melilla,2318,3185,-867
2018,01,Álava,5897,4964,933
2018,02,Albacete,5585,6670,-1085
2018,03,Alicante,25261,24824,437
2018,04,Almería,10293,10662,-369
2018,05,Ávila,3606,4285,-679
2018,06,Badajoz,7112,8792,-1680
2018,07,Baleares,26105,20142,5963
2018,08,Barcelona,52100,58536,-6436
2018,09,Burgos,5890,6176,-286
2018,10,Cáceres,5285,6959,-1674
2018,11,Cádiz,15030,16880,-1850
2018,12,Castellón,9360,7692,1668
2018,13,Ciudad Real,6348,8842,-2494
2018,14,Córdoba,7936,10368,-2432
2018,15,A Coruña,12189,11954,235
2018,16,Cuenca,4181,4881,-700
2018,17,Girona,13602,12430,1172
2018,18,Granada,14077,14700,-623
2018,19,Guadalajara,9356,7782,1574
2018,20,Guipúzcoa,7502,7491,11
2018,21,Huelva,5737,6288,-551
2018,22,Huesca,4645,4391,254
2018,23,Jaén,6418,9681,-3263
2018,24,León,6341,7522,-1181
2018,25,Lleida,7964,7739,225
2018,26,La Rioja,5041,4858,183
2018,27,Lugo,4617,5008,-391
2018,28,Madrid,91910,89229,2681
2018,29,Málaga,23327,19722,3605
2018,30,Murcia,17491,17839,-348
2018,31,Navarra,8867,7699,1168
2018,32,Ourense,4380,4914,-534
2018,33,Asturias,9079,9831,-752
2018,34,Palencia,2340,2766,-426
2018,35,Las Palmas,16303,14509,1794
2018,36,Pontevedra,10095,10029,66
2018,37,Salamanca,4781,5536,-755
2018,38,Santa Cruz de Tenerife,13209,12637,572
2018,39,Cantabria,8043,7736,307
2018,40,Segovia,3185,3597,-412
2018,41,Sevilla,18595,20222,-1627
2018,42,Soria,1933,1913,20
2018,43,Tarragona,16677,14327,2350
2018,44,Teruel,2997,3120,-123
2018,45,Toledo,22396,19066,3330
2018,46,Valencia,27635,25052,2583
2018,47,Valladolid,7295,7112,183
2018,48,Vizcaya,11762,11685,77
2018,49,Zamora,2453,3266,-813
2018,50,Zaragoza,13800,12299,1501
2018,51,Ceuta,2016,2732,-716
2018,52,Melilla,2771,3463,-692
